x0,x1,y0,y1,length,height,total_area,nuclei_area,cyto_area,c2t_area_ratio,orig_comX,orig_comY,ndimage_comX,ndimage_comY,orig_cellID,ndimage_cellID
0,17152,0,17152,17152,17152,114911591,40677,114870914,0.9996460148219513,7865.12,8160.49,7865.56,8160.76,1,1
8333,8935,1293,1979,602,686,222903,1456,221447,0.9934680107490702,8635.46,1576.65,8635.18,1577.03,2,2
8893,9151,1317,1598,258,281,42604,0,42604,1.0,9013.47,1470.26,9013.07,1469.69,3,3
10790,11221,1337,1591,431,254,77463,0,77463,1.0,10999.04,1460.48,10998.62,1459.99,4,4
7740,8048,1362,1823,308,461,86041,1006,85035,0.9883078997222254,7894.78,1596.06,7894.19,1595.83,5,5
10626,11069,1402,1795,443,393,83098,0,83098,1.0,10851.82,1620.64,10851.06,1619.83,6,6
9665,10236,1424,1901,571,477,122815,1284,121531,0.9895452509872572,9941.38,1629.5,9940.79,1629.24,7,7
10219,10533,1428,1678,314,250,48809,26,48783,0.9994673113565121,10375.45,1552.76,10375.14,1552.37,8,8
9620,9858,1491,1647,238,156,26661,0,26661,1.0,9743.95,1567.11,9743.4,1566.62,9,9
10058,10377,1507,2124,319,617,98117,4344,93773,0.9557263267323706,10210.46,1826.51,10209.79,1825.92,11,10
9381,9799,1509,2157,418,648,144110,1133,142977,0.9921379501769482,9581.81,1817.09,9581.29,1816.57,10,11
9137,9414,1533,1673,277,140,29659,1008,28651,0.9660136889308473,9285.66,1597.62,9285.06,1597.15,12,12
10471,11202,1534,2102,731,568,173916,1186,172730,0.9931806159295292,10803.71,1832.66,10803.1,1832.16,13,13
8806,9006,1547,1733,200,186,24197,1723,22474,0.9287928255568872,8909.91,1635.44,8909.34,1634.98,14,14
8791,9139,1558,1965,348,407,54346,2436,51910,0.9551760939167556,8990.51,1740.33,8989.18,1740.56,15,15
10976,11449,1587,1903,473,316,88361,616,87745,0.9930285985898756,11202.38,1759.47,11202.17,1759.09,16,16
9109,9294,1594,1805,185,211,23366,0,23366,1.0,9202.45,1708.44,9201.84,1707.82,17,17
8539,8704,1638,1763,165,125,12077,0,12077,1.0,8626.56,1700.53,8625.93,1700.1,18,18
10157,10581,1657,2212,424,555,104329,1161,103168,0.9888717422768358,10386.97,1921.44,10386.45,1921.39,19,19
9280,9442,1670,1803,162,133,16814,0,16814,1.0,9350.61,1733.47,9350.34,1733.13,20,20
6210,6545,1681,2089,335,408,70767,0,70767,1.0,6400.11,1847.49,6399.57,1847.33,21,21
9719,10140,1697,2169,421,472,123996,1998,121998,0.9838865769863544,9929.68,1922.22,9929.06,1921.94,22,22
8402,8769,1728,1982,367,254,50622,0,50622,1.0,8600.91,1851.67,8600.23,1851.22,23,23
9000,9308,1745,1935,308,190,33362,0,33362,1.0,9149.35,1840.09,9149.17,1839.71,24,24
9298,9507,1784,1998,209,214,30392,0,30392,1.0,9401.72,1878.81,9401.27,1878.43,25,25
6121,6394,1802,2129,273,327,49346,0,49346,1.0,6277.24,1950.38,6276.58,1949.92,26,26
7832,8002,1802,1976,170,174,12461,0,12461,1.0,7925.82,1869.09,7924.67,1868.8,27,27
5766,6113,1809,2152,347,343,71340,0,71340,1.0,5927.89,1959.72,5927.53,1959.54,28,28
11124,11559,1834,2236,435,402,76521,0,76521,1.0,11315.31,2027.04,11315.07,2026.33,29,29
11245,11423,1835,1950,178,115,11462,0,11462,1.0,11333.07,1893.33,11332.58,1892.87,30,30
8602,9729,1863,2459,1127,596,389895,0,389895,1.0,9145.05,2148.08,9144.69,2147.57,31,31
5546,5862,1867,2256,316,389,69433,0,69433,1.0,5701.39,2043.84,5701.0,2043.56,32,32
8320,8725,1869,2125,405,256,55872,0,55872,1.0,8509.84,1997.89,8509.51,1997.68,33,33
11813,12071,1873,2056,258,183,25163,0,25163,1.0,11949.4,1961.62,11948.63,1961.03,34,34
5997,6212,1875,2109,215,234,21618,0,21618,1.0,6116.84,1970.34,6115.2,1970.95,35,35
5328,5592,1900,2035,264,135,23762,0,23762,1.0,5470.04,1970.55,5469.35,1970.07,36,36
10553,10798,1923,2056,245,133,23437,90,23347,0.9961599180782523,10672.7,1987.62,10672.32,1987.13,37,37
6603,7369,1924,2551,766,627,314533,0,314533,1.0,6968.32,2227.63,6967.79,2227.07,38,38
11320,11617,1952,2333,297,381,51169,0,51169,1.0,11452.41,2128.86,11452.13,2128.37,39,39
11519,12392,1954,2584,873,630,203238,0,203238,1.0,11950.86,2247.53,11949.91,2246.87,40,40
10734,11002,1968,2226,268,258,36022,0,36022,1.0,10864.71,2070.55,10863.77,2070.62,41,41
12026,12454,1980,2274,428,294,75008,0,75008,1.0,12262.6,2133.49,12261.89,2132.91,42,42
5253,5720,1997,2298,467,301,67584,0,67584,1.0,5470.47,2134.83,5470.23,2134.56,43,43
10217,10631,2003,2265,414,262,59566,0,59566,1.0,10450.19,2141.28,10449.28,2141.01,44,44
8162,8409,2028,2356,247,328,63347,0,63347,1.0,8273.94,2196.52,8273.54,2195.99,45,45
5997,6319,2032,2239,322,207,39654,0,39654,1.0,6171.17,2120.87,6170.6,2120.47,46,46
10585,10801,2040,2184,216,144,20515,1191,19324,0.9419449183524251,10694.72,2104.97,10693.98,2104.64,47,47
7705,7906,2054,2246,201,192,28308,0,28308,1.0,7805.0,2145.71,7804.53,2145.24,48,48
7836,8172,2057,2394,336,337,88156,0,88156,1.0,8023.2,2224.8,8022.6,2224.34,49,49
8387,8627,2057,2276,240,219,37853,0,37853,1.0,8498.83,2168.59,8498.44,2168.02,50,50
9729,10249,2067,2501,520,434,163095,0,163095,1.0,9991.74,2282.72,9991.24,2282.2,51,51
6272,6693,2075,2357,421,282,80190,0,80190,1.0,6479.86,2227.91,6479.34,2227.35,52,52
7061,7541,2076,2901,480,825,158923,3375,155548,0.9787633004662636,7328.54,2559.77,7327.8,2558.93,53,53
7380,7854,2083,2597,474,514,164871,4636,160235,0.9718810463938473,7610.88,2337.44,7610.4,2336.91,55,54
10992,11206,2083,2304,214,221,26414,0,26414,1.0,11093.62,2174.2,11093.09,2173.98,54,55
10780,11056,2098,2335,276,237,42693,0,42693,1.0,10924.33,2226.4,10923.82,2225.88,56,56
5741,6308,2104,2563,567,459,178958,0,178958,1.0,6034.48,2336.76,6033.87,2336.2,57,57
12422,12785,2104,2348,363,244,46799,284,46515,0.9939314942626979,12586.66,2248.58,12586.03,2247.76,58,58
5141,5341,2113,2301,200,188,20217,0,20217,1.0,5242.46,2213.09,5241.97,2212.47,59,59
10548,10814,2168,2413,266,245,51323,0,51323,1.0,10674.44,2290.16,10673.99,2289.67,60,60
9475,9770,2171,2474,295,303,45481,0,45481,1.0,9643.95,2334.9,9643.27,2334.36,61,61
5001,5193,2175,2386,192,211,24837,0,24837,1.0,5088.64,2286.64,5088.16,2286.03,62,62
5262,5494,2183,2456,232,273,37385,0,37385,1.0,5388.71,2313.68,5388.13,2313.21,63,63
11056,11475,2184,2524,419,340,65504,0,65504,1.0,11266.87,2339.37,11266.58,2339.03,64,64
8427,8734,2187,2447,307,260,38068,0,38068,1.0,8591.67,2323.0,8591.11,2322.16,65,65
11390,11975,2194,2563,585,369,128760,0,128760,1.0,11697.48,2361.21,11696.9,2360.67,66,66
10203,10641,2214,2629,438,415,113589,0,113589,1.0,10431.8,2408.47,10431.28,2408.06,67,67
5443,5970,2223,2724,527,501,185950,0,185950,1.0,5673.96,2501.12,5673.58,2500.54,68,68
8686,8881,2245,2458,195,213,24579,29,24550,0.9988201310061434,8777.02,2338.52,8776.97,2338.53,69,69
8273,8658,2263,2611,385,348,63920,0,63920,1.0,8472.72,2453.21,8472.02,2452.49,70,70
12291,13229,2269,2762,938,493,252928,5716,247212,0.9774006831983806,12695.1,2527.79,12694.88,2527.34,71,71
8841,9037,2272,2458,196,186,23662,1982,21680,0.9162370044797565,8928.86,2371.37,8928.23,2370.7,72,72
4998,5454,2293,2757,456,464,114140,0,114140,1.0,5237.5,2527.21,5236.84,2526.81,73,73
10630,11384,2301,2806,754,505,178435,0,178435,1.0,11046.79,2512.66,11046.26,2512.31,74,74
6275,6716,2302,2554,441,252,71209,0,71209,1.0,6469.29,2434.0,6469.02,2433.48,75,75
7740,8089,2304,2720,349,416,81966,161,81805,0.9980357709294098,7902.84,2518.6,7902.32,2517.96,77,76
4702,4981,2305,2639,279,334,46700,1226,45474,0.9737473233404711,4833.77,2485.62,4833.35,2485.05,76,77
8071,8477,2337,2667,406,330,72507,0,72507,1.0,8272.22,2511.07,8271.72,2510.49,78,78
9617,9887,2338,2585,270,247,31995,0,31995,1.0,9753.28,2475.46,9752.78,2474.8,79,79
8628,8881,2365,2598,253,233,36510,1500,35010,0.9589153656532456,8746.2,2492.83,8745.69,2492.15,81,80
4915,5126,2366,2640,211,274,35132,1487,33645,0.9576739155186155,5026.25,2483.3,5025.56,2483.19,80,81
9118,9585,2370,2586,467,216,67609,0,67609,1.0,9353.25,2480.83,9352.78,2480.29,82,82
11934,12415,2382,2681,481,299,72678,0,72678,1.0,12191.41,2523.43,12190.64,2523.04,83,83
7021,7296,2384,2709,275,325,48924,3098,45826,0.9366772953969422,7162.74,2590.96,7162.24,2589.99,88,84
10048,10399,2387,2664,351,277,55336,0,55336,1.0,10218.29,2550.09,10217.88,2549.45,84,85
8867,9172,2410,2589,305,179,31446,0,31446,1.0,9016.14,2502.46,9015.89,2502.0,85,86
7977,8197,2413,2658,220,245,29369,0,29369,1.0,8099.85,2570.31,8099.12,2569.32,86,87
11344,11914,2420,2866,570,446,171940,0,171940,1.0,11608.97,2642.04,11608.48,2641.58,87,88
13375,13804,2446,2746,429,300,67550,0,67550,1.0,13588.56,2607.9,13588.01,2607.31,89,89
6592,6904,2456,2658,312,202,43832,0,43832,1.0,6727.43,2557.34,6727.17,2556.82,90,90
9480,9651,2466,2588,171,122,11419,0,11419,1.0,9575.02,2533.81,9574.3,2533.32,91,91
6163,6373,2472,2652,210,180,23081,0,23081,1.0,6276.06,2573.23,6275.45,2572.54,92,92
9789,10053,2474,2648,264,174,31435,0,31435,1.0,9932.75,2563.06,9932.07,2562.54,93,93
6818,7043,2516,2707,225,191,27952,0,27952,1.0,6942.09,2622.35,6941.55,2621.74,94,94
9597,9749,2519,2636,152,117,9932,0,9932,1.0,9670.02,2581.04,9669.54,2580.44,95,95
10529,10675,2526,2690,146,164,11903,0,11903,1.0,10614.36,2592.68,10613.87,2592.68,96,96
6352,6598,2529,2688,246,159,29504,0,29504,1.0,6476.9,2604.73,6476.36,2604.27,97,97
8756,9085,2531,2705,329,174,37106,906,36200,0.975583463590794,8922.44,2619.04,8921.85,2618.54,98,98
9067,9340,2533,2687,273,154,26985,0,26985,1.0,9197.67,2616.07,9197.22,2615.5,99,99
5836,6386,2549,3001,550,452,134873,2593,132280,0.9807745063874904,6102.95,2753.19,6102.51,2752.72,100,100
10648,11018,2554,2767,370,213,56093,0,56093,1.0,10824.01,2645.69,10823.56,2645.18,101,101
13247,13463,2554,2740,216,186,22963,41,22922,0.9982145190088403,13360.04,2650.53,13359.45,2649.99,102,102
8462,8889,2565,2840,427,275,76538,865,75673,0.9886984243121064,8669.28,2703.56,8668.85,2703.07,103,103
5187,5520,2568,2816,333,248,39460,2848,36612,0.9278256462240243,5362.83,2712.96,5362.33,2712.29,104,104
9981,10395,2570,2861,414,291,54156,1885,52271,0.9651931457271585,10136.7,2713.68,10136.97,2712.94,106,105
9463,9718,2572,2828,255,256,36711,1624,35087,0.9557625779739043,9603.78,2711.06,9602.86,2710.05,105,106
7336,7653,2574,2994,317,420,64133,3543,60590,0.9447554301217782,7510.36,2790.44,7509.98,2790.15,108,107
10967,11199,2574,2780,232,206,30671,2615,28056,0.9147403084346777,11075.94,2681.84,11075.56,2681.44,107,108
9304,9548,2575,2759,244,184,31468,0,31468,1.0,9414.36,2666.83,9413.78,2666.15,109,109
11790,12135,2579,2977,345,398,80752,3533,77219,0.9562487616405786,11970.33,2808.08,11969.76,2807.38,111,110
9669,10000,2580,2874,331,294,57060,0,57060,1.0,9821.56,2716.63,9821.16,2716.21,110,111
6413,6875,2585,2983,462,398,81183,0,81183,1.0,6654.93,2791.74,6654.6,2791.06,118,112
7575,7773,2588,2709,198,121,15706,1665,14041,0.8939895581306507,7681.14,2646.55,7680.35,2645.89,112,113
10449,10658,2589,2765,209,176,18716,0,18716,1.0,10554.69,2683.85,10554.05,2683.21,113,114
12075,12545,2593,2993,470,400,130753,0,130753,1.0,12313.31,2798.75,12312.8,2798.18,114,115
10306,10560,2595,2872,254,277,39488,2745,36743,0.9304852106969206,10439.05,2746.69,10438.6,2745.83,115,116
12658,13152,2598,3145,494,547,147088,0,147088,1.0,12946.55,2847.37,12945.81,2846.91,116,117
7888,8182,2604,2950,294,346,55216,3552,51664,0.9356708200521588,8022.22,2784.26,8022.02,2783.64,117,118
4638,5127,2636,2971,489,335,121172,0,121172,1.0,4889.81,2801.35,4889.27,2800.87,119,119
6318,6600,2638,2855,282,217,31497,1510,29987,0.9520589262469441,6452.91,2743.59,6452.32,2742.61,120,120
8084,8301,2639,2765,217,126,17126,0,17126,1.0,8182.47,2699.72,8182.18,2699.17,121,121
8258,8516,2639,2804,258,165,26899,5044,21855,0.8124837354548496,8388.7,2725.0,8388.34,2724.48,122,122
8849,9120,2645,2870,271,225,33947,0,33947,1.0,8996.58,2764.94,8996.17,2764.33,123,123
13126,13384,2645,2968,258,323,51783,3070,48713,0.9407141339821949,13244.42,2811.04,13243.9,2810.51,124,124
9079,9346,2646,2822,267,176,33384,0,33384,1.0,9209.3,2745.66,9208.59,2744.85,125,125
13305,13603,2660,2934,298,274,40054,3569,36485,0.9108952913566685,13446.27,2797.9,13445.92,2797.42,126,126
9289,9557,2667,2934,268,267,32946,0,32946,1.0,9433.67,2818.02,9433.51,2817.02,128,127
4103,4487,2669,3023,384,354,72725,2133,70592,0.9706703334479202,4262.56,2828.0,4262.29,2827.56,127,128
7596,7775,2679,2907,179,228,21965,1387,20578,0.9368540860459822,7677.96,2780.12,7677.67,2779.97,130,129
13507,14034,2679,3043,527,364,93495,303,93192,0.9967591849831542,13813.84,2837.28,13812.87,2836.81,129,130
6902,7092,2681,2822,190,141,15963,1314,14649,0.9176846457432813,6996.15,2742.49,6996.29,2742.42,131,131
7677,7933,2681,2905,256,224,32942,1881,31061,0.9428996417946695,7815.74,2810.17,7815.19,2809.53,132,132
6680,6938,2690,2989,258,299,42030,1337,40693,0.968189388532001,6824.35,2867.44,6823.87,2866.56,133,133
10546,10842,2693,2914,296,221,42493,0,42493,1.0,10693.46,2815.88,10692.97,2815.32,134,134
5754,5975,2696,2959,221,263,32478,730,31748,0.9775232465053267,5864.04,2859.26,5863.34,2857.95,135,135
9876,10115,2697,2966,239,269,30466,235,30231,0.9922864832928511,9996.56,2854.56,9996.02,2853.51,136,136
5529,5852,2702,2857,323,155,35340,0,35340,1.0,5692.12,2779.15,5691.67,2778.56,137,137
5304,5597,2705,2960,293,255,41344,0,41344,1.0,5450.22,2853.93,5449.91,2853.16,138,138
10817,11041,2705,2892,224,187,30786,0,30786,1.0,10936.54,2801.88,10935.97,2801.32,139,139
8136,8406,2725,2913,270,188,29536,1380,28156,0.9532773564463706,8266.6,2823.55,8266.19,2823.02,140,140
11275,11615,2738,3045,340,307,53429,0,53429,1.0,11439.8,2881.98,11439.08,2881.48,142,141
10181,10317,2739,2833,136,94,9197,0,9197,1.0,10246.48,2780.68,10246.07,2780.24,141,142
5105,5346,2748,2914,241,166,24114,450,23664,0.9813386414530978,5212.74,2834.06,5212.49,2833.48,143,143
12482,12977,2749,3212,495,463,144170,0,144170,1.0,12711.12,3008.04,12710.67,3007.46,144,144
8287,8593,2751,3055,306,304,47022,3203,43819,0.9318829484071286,8457.61,2905.07,8456.82,2904.65,145,145
11020,11291,2754,2981,271,227,45092,1704,43388,0.9622105916792336,11154.57,2866.32,11154.09,2865.83,146,146
6901,7109,2760,2988,208,228,29294,1127,28167,0.9615279579436062,7012.49,2883.42,7011.54,2882.54,147,147
5484,5786,2763,3052,302,289,38934,0,38934,1.0,5646.6,2938.79,5645.3,2937.38,148,148
10254,10437,2769,2960,183,191,18991,106,18885,0.9944184087199199,10343.67,2867.63,10343.48,2867.22,149,149
6119,6697,2780,3312,578,532,172472,5708,166764,0.9669047729486525,6416.52,3051.02,6415.98,3050.5,150,150
8553,8820,2782,3058,267,276,25171,1917,23254,0.9238409280521235,8707.67,2914.44,8706.52,2913.63,151,151
8754,8967,2784,2960,213,176,23797,951,22846,0.9600369794511914,8851.21,2874.62,8850.88,2874.0,152,152
10115,10284,2784,2967,169,183,20419,0,20419,1.0,10193.64,2887.64,10193.21,2886.97,153,153
9487,9816,2786,2958,329,172,30490,2740,27750,0.9101344703181371,9652.53,2879.95,9652.28,2879.36,154,154
8998,9284,2811,3185,286,374,54247,483,53764,0.9910962818220362,9135.91,3026.69,9135.41,3025.9,156,155
7091,7281,2812,3024,190,212,26929,0,26929,1.0,7174.82,2919.81,7174.53,2919.54,155,156
9142,9589,2815,3246,447,431,110614,5706,104908,0.948415209647965,9374.06,3047.75,9373.25,3047.1,157,157
8508,8748,2824,3053,240,229,24018,0,24018,1.0,8602.36,2965.36,8602.28,2964.93,159,158
4149,4651,2825,3143,502,318,100872,0,100872,1.0,4410.51,2995.29,4409.92,2994.79,158,159
4996,5385,2831,3146,389,315,60408,3764,56644,0.9376903721361409,5188.84,2987.61,5188.31,2986.95,160,160
11598,11851,2833,3018,253,185,33751,0,33751,1.0,11727.65,2917.52,11727.15,2917.11,161,161
8890,9105,2836,3047,215,211,24982,0,24982,1.0,9003.36,2934.58,9002.71,2934.19,162,162
13529,13744,2837,3140,215,303,31331,2364,28967,0.9245475726915834,13632.86,2970.34,13632.2,2969.95,163,163
10493,10643,2851,3006,150,155,15310,0,15310,1.0,10564.45,2928.41,10564.01,2927.96,164,164
10769,11107,2852,3089,338,237,40451,0,40451,1.0,10947.04,2962.58,10946.25,2962.08,165,165
13345,13615,2854,3252,270,398,60907,606,60301,0.9900504047153857,13480.13,3034.04,13479.58,3033.64,166,166
9761,9948,2857,2976,187,119,15212,1884,13328,0.8761504075729687,9858.66,2918.64,9858.06,2918.13,167,167
10411,10516,2861,2968,105,107,8075,24,8051,0.9970278637770897,10462.39,2912.61,10461.99,2912.15,168,168
7546,8030,2873,3274,484,401,109932,3402,106530,0.9690535967689117,7789.81,3044.15,7789.38,3043.66,169,169
11025,11379,2876,3172,354,296,62130,611,61519,0.9901657814260422,11219.25,3052.18,11218.73,3051.4,170,170
8038,8385,2877,3037,347,160,36484,1862,34622,0.9489639293937069,8210.41,2960.6,8209.96,2960.11,171,171
11788,12495,2879,3483,707,604,202987,5330,197657,0.9737421608280333,12156.71,3143.98,12156.14,3143.42,172,172
7249,7473,2887,3014,224,127,19985,0,19985,1.0,7350.8,2949.71,7350.43,2949.32,173,173
9438,9736,2898,3325,298,427,54747,5012,49735,0.9084516046541363,9618.77,3092.09,9617.83,3091.71,175,174
7465,7638,2899,3064,173,165,14949,1125,13824,0.9247441300421433,7550.16,2978.66,7549.77,2978.06,174,175
10588,10824,2900,3041,236,141,22916,0,22916,1.0,10704.87,2973.28,10704.38,2972.79,176,176
4598,4918,2906,3184,320,278,46799,0,46799,1.0,4751.03,3029.54,4750.56,3029.18,177,177
5915,6080,2912,3079,165,167,16710,186,16524,0.9888689407540395,5989.75,3005.7,5989.22,3005.03,178,178
9896,10083,2917,3159,187,242,27056,0,27056,1.0,9992.24,3045.57,9991.76,3044.87,179,179
10235,10439,2919,3108,204,189,22127,1143,20984,0.9483436525511818,10335.15,3006.24,10334.65,3005.63,180,180
9675,10017,2921,3253,342,332,63738,1983,61755,0.9688882613197778,9839.16,3095.68,9838.79,3095.0,181,181
13621,13989,2923,3157,368,234,42611,127,42484,0.9970195489427612,13792.64,3039.49,13792.44,3039.44,182,182
13077,13442,2928,3248,365,320,53105,0,53105,1.0,13264.3,3060.95,13264.23,3060.99,183,183
11560,12069,2933,3416,509,483,121224,8877,112347,0.9267719263512176,11801.45,3193.39,11800.47,3193.01,184,184
10041,10288,2934,3105,247,171,25750,2264,23486,0.9120776699029126,10165.7,3016.16,10165.25,3015.73,185,185
4815,5111,2936,3199,296,263,43274,0,43274,1.0,4961.74,3078.38,4961.27,3077.82,186,186
6719,6992,2942,3118,273,176,28366,1062,27304,0.9625608122400057,6872.44,3024.61,6871.53,3024.03,187,187
7823,8444,2945,3685,621,740,236885,0,236885,1.0,8140.63,3270.25,8140.11,3270.17,188,188
11378,11585,2948,3100,207,152,19734,0,19734,1.0,11494.95,3028.73,11494.41,3028.08,189,189
5682,5987,2951,3174,305,223,38696,804,37892,0.9792226586727311,5838.46,3052.71,5838.05,3052.37,190,190
8749,9030,2951,3136,281,185,26049,0,26049,1.0,8890.89,3036.36,8890.63,3036.1,191,191
6629,6829,2954,3242,200,288,26473,683,25790,0.9742001284327428,6732.08,3095.83,6731.39,3095.09,193,192
5305,5560,2955,3129,255,174,31424,2766,28658,0.9119781059063137,5439.65,3038.22,5439.04,3037.78,192,193
6978,7140,2958,3081,162,123,13536,50,13486,0.996306146572104,7061.73,3024.61,7061.24,3024.07,194,194
3726,4089,2960,3209,363,249,43263,225,43038,0.9947992510921573,3877.52,3070.54,3877.48,3070.38,195,195
10398,10622,2962,3152,224,190,29016,1574,27442,0.9457540667218086,10510.14,3055.26,10509.62,3054.77,196,196
10745,10927,2968,3113,182,145,16015,1960,14055,0.8776147361848268,10842.08,3050.37,10841.43,3049.73,197,197
5938,6154,2983,3167,216,184,17437,1141,16296,0.9345644319550381,6069.37,3085.06,6068.43,3084.42,198,198
7234,7567,2994,3402,333,408,102388,0,102388,1.0,7409.51,3189.6,7409.04,3189.21,199,199
7124,7272,2999,3159,148,160,14720,375,14345,0.9745244565217391,7196.42,3070.23,7196.1,3069.8,200,200
5449,5694,3001,3291,245,290,31607,0,31607,1.0,5555.38,3139.31,5554.93,3138.8,201,201
10554,10819,3009,3298,265,289,34913,1277,33636,0.9634233666542549,10677.48,3136.42,10676.5,3136.23,203,202
3518,3856,3012,3373,338,361,66760,2008,64752,0.9699221090473338,3684.89,3178.56,3684.44,3178.22,202,203
10014,10227,3012,3312,213,300,35112,0,35112,1.0,10123.29,3179.52,10122.62,3178.74,213,204
12364,12612,3013,3286,248,273,31039,0,31039,1.0,12486.65,3155.77,12486.53,3155.38,208,205
4429,4750,3017,3299,321,282,49860,2031,47829,0.959265944645006,4590.81,3172.27,4590.29,3171.58,204,206
13983,14264,3018,3332,281,314,47551,828,46723,0.982587116990179,14125.19,3151.31,14124.66,3151.32,205,207
8337,8518,3023,3222,181,199,23586,0,23586,1.0,8428.96,3111.06,8428.43,3110.67,207,208
8633,8941,3024,3292,308,268,42671,0,42671,1.0,8798.83,3143.15,8798.15,3142.66,209,209
8476,8662,3034,3206,186,172,20232,0,20232,1.0,8567.66,3120.91,8567.1,3120.46,210,210
11330,11485,3047,3228,155,181,15215,0,15215,1.0,11402.52,3132.41,11402.09,3131.99,211,211
11402,11654,3047,3351,252,304,43727,2249,41478,0.948567246781165,11533.4,3218.44,11532.92,3217.51,212,212
10340,10492,3055,3214,152,159,13788,0,13788,1.0,10416.08,3143.29,10415.54,3142.55,215,213
5266,5468,3056,3292,202,236,32674,779,31895,0.9761584134173961,5363.5,3184.37,5362.9,3183.91,214,214
5591,5861,3057,3299,270,242,32127,1218,30909,0.962087963395275,5730.24,3177.18,5729.78,3176.67,219,215
6630,7361,3058,3869,731,811,310047,9890,300157,0.9681016104010037,6931.08,3420.62,6930.92,3420.05,216,216
7531,7651,3060,3219,120,159,10009,964,9045,0.9036866819862124,7581.46,3128.24,7581.1,3128.14,217,217
10923,11086,3060,3174,163,114,10295,2247,8048,0.7817387081107333,10992.37,3112.86,10992.5,3112.63,218,218
10140,10628,3066,3490,488,424,88229,1780,86449,0.9798252275328974,10409.74,3266.78,10408.75,3266.13,220,219
4996,5199,3077,3249,203,172,20731,0,20731,1.0,5096.24,3166.04,5095.73,3165.5,221,220
13712,14111,3092,3432,399,340,67831,0,67831,1.0,13927.04,3228.37,13926.47,3228.13,222,221
8896,9107,3095,3303,211,208,27817,0,27817,1.0,8994.75,3209.57,8994.1,3208.78,223,222
10769,11047,3099,3298,278,199,33560,4308,29252,0.8716328963051252,10905.86,3205.69,10905.37,3205.15,224,223
6094,6532,3110,3429,438,319,79031,0,79031,1.0,6297.68,3275.99,6297.28,3275.46,225,224
5152,5283,3111,3278,131,167,11985,783,11202,0.9346683354192741,5224.49,3204.18,5223.62,3203.06,226,225
12939,13444,3114,3456,505,342,108890,0,108890,1.0,13165.52,3262.4,13165.21,3262.0,227,226
5826,6141,3123,3504,315,381,74991,0,74991,1.0,5987.6,3290.28,5987.13,3290.01,228,227
13293,14076,3126,3769,783,643,265326,0,265326,1.0,13685.03,3436.38,13684.79,3436.14,229,228
4139,4497,3128,3375,358,247,61585,322,61263,0.9947714540878461,4333.34,3238.98,4332.67,3238.44,230,229
3730,4139,3131,3474,409,343,73712,201,73511,0.9972731712611244,3937.01,3279.38,3936.36,3279.13,231,230
4685,4852,3132,3329,167,197,15102,0,15102,1.0,4784.25,3226.1,4783.49,3225.73,233,231
10999,11108,3132,3273,109,141,10682,466,10216,0.9563752106347126,11060.29,3204.56,11059.67,3203.97,232,232
8463,8898,3142,3490,435,348,89384,1108,88276,0.9876040454667502,8697.72,3315.05,8697.11,3314.48,234,233
11102,11427,3149,3332,325,183,39408,1577,37831,0.9599827446203817,11246.02,3237.29,11245.95,3236.75,235,234
8871,9334,3152,3701,463,549,142872,6404,136468,0.9551766616271907,9124.86,3405.09,9124.13,3404.81,236,235
7558,8023,3155,3652,465,497,131025,7141,123884,0.94549895058195,7778.17,3415.52,7777.69,3414.96,237,236
12550,12726,3165,3303,176,138,15345,0,15345,1.0,12632.69,3237.11,12632.27,3236.52,238,237
4815,5044,3182,3320,229,138,23309,609,22700,0.9738727530138573,4924.39,3251.08,4923.91,3250.64,239,238
10588,10875,3184,3528,287,344,58474,2579,55895,0.9558949276601566,10722.51,3338.12,10721.99,3338.01,240,239
9662,9933,3190,3386,271,196,36428,0,36428,1.0,9804.08,3285.59,9803.52,3285.09,241,240
4040,4309,3194,3477,269,283,44749,2120,42629,0.9526246396567521,4165.81,3360.83,4165.38,3360.06,242,241
12678,12964,3200,3393,286,193,34177,0,34177,1.0,12832.51,3283.48,12831.77,3282.99,243,242
8376,8596,3205,3527,220,322,37872,0,37872,1.0,8473.29,3379.18,8472.9,3378.49,244,243
5507,5655,3206,3344,148,138,12469,0,12469,1.0,5593.62,3273.83,5592.94,3273.36,245,244
5025,5222,3208,3347,197,139,15267,813,14454,0.9467478876007074,5119.59,3279.2,5119.19,3278.67,246,245
9308,9467,3218,3349,159,131,15098,0,15098,1.0,9384.8,3281.11,9384.3,3280.62,247,246
12341,12582,3218,3360,241,142,20808,1951,18857,0.9062379853902345,12460.76,3287.85,12460.25,3287.33,248,247
3383,3735,3225,3508,352,283,49877,1131,48746,0.9773242175752351,3540.5,3351.97,3540.17,3351.69,249,248
9435,9690,3228,3439,255,211,32072,1798,30274,0.9439386380643552,9550.46,3335.87,9550.14,3335.34,250,249
5646,5828,3229,3391,182,162,19682,1234,18448,0.9373031196016665,5726.44,3306.25,5726.1,3305.78,251,250
9906,10120,3231,3430,214,199,24654,0,24654,1.0,9998.54,3322.22,9998.18,3321.85,252,251
4563,4803,3238,3486,240,248,31739,0,31739,1.0,4663.2,3356.18,4662.93,3355.72,253,252
5018,5344,3246,3540,326,294,37653,0,37653,1.0,5164.73,3382.22,5164.27,3381.85,254,253
6529,6708,3260,3443,179,183,20112,0,20112,1.0,6617.84,3343.26,6617.43,3342.88,255,254
4795,5083,3263,3642,288,379,53551,2681,50870,0.9499355754327651,4945.29,3430.48,4944.94,3430.13,258,255
5396,5848,3264,3707,452,443,111129,0,111129,1.0,5623.2,3491.47,5622.65,3490.89,256,256
11031,11363,3266,3499,332,233,37669,2571,35098,0.9317475908572035,11178.93,3383.48,11178.78,3383.22,257,257
12219,12762,3273,3682,543,409,121861,13104,108757,0.8924676475656691,12487.61,3485.51,12487.2,3484.75,260,258
11237,11458,3274,3450,221,176,22558,0,22558,1.0,11362.19,3356.98,11361.46,3356.5,259,259
10827,11155,3279,3558,328,279,43824,2617,41207,0.9402838627236217,11002.55,3405.96,11001.95,3405.46,262,260
5145,5561,3280,3726,416,446,92740,0,92740,1.0,5353.36,3516.46,5353.01,3515.73,261,261
12772,13031,3287,3498,259,211,27101,0,27101,1.0,12912.0,3410.67,12911.42,3409.95,263,262
10218,10392,3289,3526,174,237,23596,0,23596,1.0,10316.46,3400.39,10315.86,3399.89,264,263
12617,12807,3290,3450,190,160,21321,1384,19937,0.9350874724450072,12707.23,3369.68,12706.82,3369.19,265,264
4405,4590,3292,3464,185,172,22921,0,22921,1.0,4505.93,3379.72,4505.34,3379.13,266,265
11531,11906,3294,3538,375,244,48083,3030,45053,0.9369839652267953,11739.5,3401.63,11738.44,3400.98,267,266
9914,10273,3306,3720,359,414,87532,8220,79312,0.9060914865420646,10084.46,3500.53,10083.92,3500.25,268,267
11444,11587,3309,3439,143,130,11358,1926,9432,0.8304278922345484,11514.55,3369.87,11514.17,3369.47,269,268
5747,6004,3314,3532,257,218,30813,1276,29537,0.958588907279395,5867.26,3434.46,5866.78,3433.87,270,269
4611,4938,3325,3694,327,369,65290,830,64460,0.9872874865982539,4771.04,3531.03,4770.62,3530.26,272,270
9607,9942,3327,3723,335,396,95272,0,95272,1.0,9777.48,3520.06,9776.91,3519.55,271,271
6005,6504,3329,3709,499,380,106784,0,106784,1.0,6262.35,3522.75,6261.7,3522.21,273,272
6419,6695,3330,3708,276,378,52446,0,52446,1.0,6572.92,3519.86,6572.29,3519.28,275,273
7002,7340,3331,4028,338,697,142927,0,142927,1.0,7178.59,3669.85,7178.07,3669.57,274,274
13989,14266,3335,3737,277,402,57747,0,57747,1.0,14117.04,3486.11,14116.57,3486.16,276,275
9174,9490,3341,3931,316,590,120463,6729,113734,0.9441405244763953,9343.31,3642.94,9342.85,3642.34,277,276
3832,4063,3347,3605,231,258,30807,1,30806,0.9999675398448404,3950.7,3458.34,3950.06,3458.11,278,277
11898,12184,3347,3736,286,389,64995,1758,63237,0.9729517655204246,12032.63,3560.57,12032.22,3559.79,279,278
13115,13438,3354,3653,323,299,40435,0,40435,1.0,13277.02,3508.92,13276.59,3508.4,280,279
10380,10574,3361,3520,194,159,19627,671,18956,0.9658124012839456,10462.25,3440.43,10462.06,3440.09,281,280
4217,4454,3371,3577,237,206,34032,2442,31590,0.9282440056417489,4340.08,3476.68,4339.55,3476.16,282,281
7271,7746,3371,3880,475,509,134144,0,134144,1.0,7470.9,3623.71,7470.75,3623.55,283,282
11729,11959,3371,3652,230,281,30034,3428,26606,0.8858626889525205,11847.48,3541.07,11847.27,3539.84,284,283
7504,7720,3380,3658,216,278,26148,905,25243,0.9653893223191066,7610.44,3513.84,7609.94,3513.36,285,284
11385,11564,3382,3511,179,129,12967,1537,11430,0.8814683427161255,11470.23,3452.1,11469.82,3451.45,286,285
3482,3900,3387,3845,418,458,129982,0,129982,1.0,3699.68,3606.17,3699.13,3605.72,287,286
12645,13033,3393,3704,388,311,43433,1604,41829,0.9630695554071789,12788.51,3570.63,12789.78,3569.08,297,287
12725,13200,3394,3794,475,400,100699,1780,98919,0.9823235583272922,13007.98,3627.02,13007.21,3626.62,288,288
10854,11042,3402,3571,188,169,16308,0,16308,1.0,10929.63,3480.77,10929.62,3480.61,289,289
9335,9758,3413,4082,423,669,149003,905,148098,0.9939262967859708,9553.94,3772.0,9553.24,3771.78,290,290
8788,9036,3418,3779,248,361,58158,0,58158,1.0,8910.37,3605.68,8909.87,3605.15,291,291
10676,10909,3421,3584,233,163,23526,0,23526,1.0,10790.07,3507.35,10789.73,3506.85,292,292
8510,8816,3422,3653,306,231,50851,2739,48112,0.9461367524729111,8670.98,3543.0,8670.37,3542.41,293,293
8192,8511,3426,3668,319,242,42104,1169,40935,0.9722354170625119,8341.29,3537.62,8340.96,3537.1,294,294
11315,11607,3437,3635,292,198,32032,2734,29298,0.9146478521478522,11469.68,3537.54,11469.27,3536.76,295,295
12113,12335,3439,3749,222,310,38451,763,37688,0.9801565628982342,12218.18,3595.92,12217.71,3595.45,296,296
11580,11744,3442,3554,164,112,10517,0,10517,1.0,11657.5,3503.22,11657.04,3502.62,298,297
3815,4231,3446,3902,416,456,101027,2645,98382,0.9738188801013591,4026.27,3664.56,4025.7,3664.15,299,298
11052,11406,3457,3687,354,230,44846,2315,42531,0.9483788966685992,11242.75,3578.82,11241.9,3578.42,300,299
4389,4612,3462,3628,223,166,25976,2077,23899,0.9200415768401602,4510.29,3541.46,4509.57,3541.04,301,300
10064,10339,3471,3936,275,465,71585,3354,68231,0.9531466089264511,10204.26,3695.63,10203.78,3695.24,302,301
4958,5328,3482,3819,370,337,70471,0,70471,1.0,5148.05,3656.26,5147.49,3655.69,303,302
7884,8127,3483,3764,243,281,35943,1181,34762,0.967142419942687,8018.91,3647.33,8018.27,3646.58,304,303
10282,10515,3488,3902,233,414,68198,0,68198,1.0,10402.61,3689.51,10402.08,3689.1,305,304
10479,10745,3489,3878,266,389,84913,6085,78828,0.9283384169679554,10611.01,3700.06,10610.51,3699.48,306,305
5824,6282,3503,4007,458,504,124284,6719,117565,0.9459383347816291,6073.74,3736.42,6073.2,3736.02,307,306
11550,11839,3509,3822,289,313,48336,4744,43592,0.9018536908308508,11694.41,3672.01,11693.79,3671.36,308,307
10904,11129,3518,3745,225,227,30692,0,30692,1.0,11021.45,3625.71,11020.91,3625.28,309,308
4538,4753,3533,3796,215,263,28360,1045,27315,0.9631523272214386,4641.6,3668.37,4641.12,3667.86,310,309
8413,8609,3536,3773,196,237,27184,1378,25806,0.9493084167157151,8518.74,3660.66,8518.12,3660.07,311,310
14066,14421,3544,4138,355,594,154212,0,154212,1.0,14249.83,3848.44,14249.32,3847.89,312,311
4096,4401,3546,3826,305,280,45051,2023,43028,0.9550953363965283,4246.23,3677.58,4245.61,3677.23,313,312
13546,13981,3550,3852,435,302,65400,0,65400,1.0,13739.33,3700.65,13739.33,3700.15,314,313
10717,11135,3559,3969,418,410,100994,2737,98257,0.9728993801611977,10894.59,3769.75,10894.52,3769.41,315,314
7667,7885,3566,3764,218,198,24922,0,24922,1.0,7758.53,3668.34,7758.28,3667.76,316,315
12283,12528,3567,3822,245,255,30210,4634,25576,0.8466070837471036,12391.73,3696.51,12391.26,3695.7,318,316
4358,4637,3569,3895,279,326,51223,1646,49577,0.9678659976963473,4499.13,3749.38,4498.41,3748.57,317,317
13168,13396,3575,3779,228,204,33916,0,33916,1.0,13277.6,3676.23,13277.15,3675.7,319,318
3000,3500,3581,4066,500,485,152633,0,152633,1.0,3225.83,3814.42,3225.48,3813.85,320,319
6252,6639,3590,4314,387,724,193645,6795,186850,0.9649100157504712,6454.41,3926.44,6453.9,3926.17,321,320
8170,8397,3591,3749,227,158,21735,0,21735,1.0,8293.8,3667.88,8293.11,3667.42,322,321
11330,11641,3606,3816,311,210,35796,2022,33774,0.9435132417029836,11484.17,3704.57,11483.25,3704.52,323,322
13392,13611,3607,3845,219,238,29352,0,29352,1.0,13497.65,3715.96,13497.27,3715.66,324,323
4901,5133,3619,3983,232,364,56275,0,56275,1.0,5011.89,3826.29,5011.27,3825.43,325,324
5427,5746,3624,3924,319,300,55912,4695,51217,0.9160287594791816,5591.12,3767.99,5590.54,3767.49,326,325
5712,6130,3629,4152,418,523,129771,9807,119964,0.9244284162100932,5906.19,3915.98,5905.61,3915.37,327,326
11176,11375,3637,3795,199,158,19855,0,19855,1.0,11274.26,3716.6,11273.74,3716.07,328,327
9057,9188,3639,3773,131,134,11632,0,11632,1.0,9135.03,3707.84,9134.25,3707.25,329,328
3284,3664,3640,4119,380,479,107783,0,107783,1.0,3475.77,3909.32,3475.28,3908.64,330,329
11780,12058,3642,3963,278,321,51411,24,51387,0.9995331738343934,11917.62,3790.59,11917.16,3790.16,332,330
8537,8917,3643,3981,380,338,70039,3953,66086,0.943560016562201,8744.0,3784.37,8743.61,3784.29,331,331
4598,4934,3645,3893,336,248,42467,1245,41222,0.9706831186568394,4797.19,3771.8,4795.97,3771.59,333,332
9638,9968,3645,4079,330,434,83290,1032,82258,0.9876095569696242,9814.34,3872.37,9813.78,3871.92,334,333
12450,12673,3648,3885,223,237,29571,0,29571,1.0,12552.05,3748.58,12551.71,3748.45,335,334
7779,8043,3658,3897,264,239,34804,1556,33248,0.955292495115504,7912.54,3800.82,7912.09,3799.88,336,335
8259,8519,3668,3927,260,259,39516,1472,38044,0.9627492661200526,8384.64,3801.45,8384.25,3800.86,337,336
4179,4418,3670,3868,239,198,23826,1342,22484,0.9436749769159741,4307.38,3792.16,4306.93,3791.29,344,337
6601,6748,3673,3887,147,214,17968,1058,16910,0.9411175422974176,6673.68,3770.64,6673.08,3770.29,338,338
9952,10069,3674,3886,117,212,18837,1722,17115,0.9085841694537347,10006.3,3781.25,10005.78,3780.75,339,339
11047,11260,3679,3888,213,209,28666,0,28666,1.0,11148.87,3788.93,11148.43,3788.38,340,340
8016,8399,3683,4252,383,569,132621,1532,131089,0.9884482849624117,8193.01,3972.99,8192.59,3972.66,341,341
12567,12807,3684,3911,240,227,25932,1078,24854,0.9584297393182168,12678.32,3802.36,12677.92,3801.56,342,342
8909,9276,3691,4080,367,389,92392,2894,89498,0.9686769417265564,9068.69,3889.7,9068.29,3889.14,343,343
5109,5653,3701,4124,544,423,122642,5383,117259,0.9561080217217592,5390.47,3926.57,5389.55,3926.18,345,344
12107,12463,3705,3993,356,288,49239,3557,45682,0.9277605150388919,12265.26,3828.42,12264.8,3828.1,346,345
13633,14089,3709,4055,456,346,82724,0,82724,1.0,13865.04,3882.68,13864.52,3882.17,347,346
12735,13188,3726,4140,453,414,101219,10541,90678,0.8958594730238394,12943.95,3932.47,12943.5,3932.02,348,347
13308,13546,3728,3934,238,206,26958,0,26958,1.0,13430.16,3828.58,13429.72,3828.14,349,348
11988,12201,3729,3934,213,205,23857,3076,20781,0.8710650961981808,12071.48,3829.08,12071.77,3829.17,350,349
13099,13305,3735,4031,206,296,27525,3168,24357,0.8849046321525885,13194.64,3895.61,13194.24,3894.93,351,350
7311,7459,3739,3908,148,169,16114,0,16114,1.0,7380.04,3817.55,7379.55,3817.11,352,351
11194,11537,3748,3973,343,225,46550,1674,44876,0.9640386680988184,11373.9,3863.75,11373.3,3863.28,353,352
12657,12834,3749,4012,177,263,22583,597,21986,0.9735641854492317,12750.42,3895.71,12750.12,3894.71,354,353
13198,13346,3749,3921,148,172,15295,2093,13202,0.8631578947368421,13269.02,3837.66,13268.44,3837.07,355,354
11509,11644,3754,3912,135,158,14019,0,14019,1.0,11579.47,3834.3,11579.03,3833.64,356,355
6883,7206,3758,4133,323,375,65224,0,65224,1.0,7028.1,3950.5,7027.73,3950.03,357,356
7664,7891,3759,4025,227,266,37934,0,37934,1.0,7769.87,3898.08,7769.44,3897.53,358,357
11625,11932,3764,4007,307,243,33744,1329,32415,0.9606152204836416,11768.42,3887.55,11768.04,3887.09,359,358
8262,8715,3771,4543,453,772,175084,7608,167476,0.9565465719311873,8523.71,4163.44,8522.95,4163.11,360,359
3653,3974,3783,4114,321,331,61594,0,61594,1.0,3819.59,3949.38,3818.92,3948.83,361,360
13532,13690,3786,3936,158,150,16400,0,16400,1.0,13606.26,3866.66,13605.83,3866.08,362,361
3969,4120,3801,3998,151,197,18372,1713,16659,0.9067602873938603,4044.1,3903.63,4043.6,3903.1,363,362
4096,4480,3801,4168,384,367,66155,300,65855,0.9954651953744993,4256.99,3956.92,4256.33,3956.43,364,363
7396,7767,3803,4458,371,655,148744,0,148744,1.0,7591.09,4112.13,7590.32,4111.63,365,364
10195,10371,3809,4021,176,212,23397,0,23397,1.0,10276.3,3921.42,10275.88,3920.8,366,365
6607,7131,3814,4527,524,713,215410,5759,209651,0.9732649366324683,6864.81,4170.33,6864.35,4169.82,367,366
9935,10225,3824,4185,290,361,60665,1242,59423,0.9795269100799473,10081.16,4004.51,10080.38,4004.12,368,367
12256,12615,3825,4171,359,346,76439,2096,74343,0.9725794424312196,12453.4,3995.81,12452.8,3995.28,369,368
4571,4969,3831,4222,398,391,104164,3035,101129,0.970863254099305,4788.98,4013.55,4788.52,4013.11,370,369
13844,14183,3850,4242,339,392,67646,0,67646,1.0,14020.62,4059.21,14020.17,4058.67,371,370
2781,3078,3853,4212,297,359,53194,0,53194,1.0,2932.47,4011.42,2932.12,4011.23,372,371
10223,10583,3858,4369,360,511,96397,0,96397,1.0,10421.89,4110.49,10421.16,4110.03,373,372
10485,10730,3861,4176,245,315,52870,4020,48850,0.923964441081899,10616.21,4006.75,10615.6,4006.11,374,373
5558,5750,3863,4027,192,164,19713,1366,18347,0.9307056257292142,5668.43,3950.83,5667.55,3950.14,375,374
8639,8928,3865,4166,289,301,53781,2048,51733,0.9619196370465406,8778.44,4013.88,8777.78,4013.08,376,375
4365,4596,3866,4040,231,174,24336,1807,22529,0.9257478632478633,4487.48,3955.14,4486.92,3954.74,377,376
10693,11130,3866,4182,437,316,82134,814,81320,0.9900893661577422,10881.53,4025.33,10881.49,4024.71,378,377
13293,13544,3866,4055,251,189,30234,0,30234,1.0,13407.64,3961.13,13407.27,3960.6,379,378
11558,11849,3873,4089,291,216,28857,771,28086,0.9732820459507225,11696.05,3976.25,11695.81,3975.86,380,379
7866,8076,3881,4078,210,197,27515,431,27084,0.9843358168271852,7971.55,3982.45,7971.1,3981.89,381,380
9817,9996,3884,4166,179,282,30505,0,30505,1.0,9915.07,4034.89,9914.65,4034.0,382,381
11988,12206,3886,4061,218,175,20868,909,19959,0.9564404830362278,12110.58,3967.18,12109.91,3966.7,383,382
10939,11330,3887,4504,391,617,137652,5831,131821,0.9576395548193997,11168.96,4217.38,11168.12,4216.8,384,383
3601,3847,3893,4229,246,336,33797,2037,31760,0.9397283782584253,3721.99,4093.7,3721.13,4092.39,386,384
9083,9490,3895,4490,407,595,127261,0,127261,1.0,9302.02,4204.28,9301.48,4203.65,388,385
11470,11627,3895,4195,157,300,29061,0,29061,1.0,11545.08,4033.1,11544.65,4032.79,385,386
7205,7505,3896,4364,300,468,92792,0,92792,1.0,7357.34,4135.5,7356.89,4135.0,387,387
12577,12770,3896,4106,193,210,22003,550,21453,0.9750034086260965,12669.26,4007.79,12668.74,4007.18,389,388
8303,8438,3902,4124,135,222,23833,2623,21210,0.889942516678555,8368.37,4005.18,8367.88,4004.81,390,389
5112,5284,3911,4079,172,168,16659,1275,15384,0.9234647938051503,5206.89,3991.26,5206.25,3990.79,391,390
4002,4168,3913,4075,166,162,11308,1834,9474,0.8378139370357269,4089.91,3997.17,4089.23,3996.61,392,391
13451,13756,3929,4256,305,327,63157,0,63157,1.0,13608.53,4096.65,13608.03,4096.13,393,392
11264,11588,3933,4366,324,433,86794,0,86794,1.0,11404.74,4158.3,11404.41,4157.68,394,393
13041,13202,3943,4083,161,140,13746,0,13746,1.0,13114.9,4014.15,13114.66,4013.62,395,394
11758,12172,3948,4477,414,529,118193,4962,113231,0.9580178183141134,11960.3,4179.54,11959.51,4179.48,396,395
14229,14913,3954,4718,684,764,351757,0,351757,1.0,14578.64,4364.97,14578.03,4364.44,397,396
12133,12489,3957,4335,356,378,71634,0,71634,1.0,12289.82,4154.82,12289.52,4154.31,398,397
4931,5240,3970,4215,309,245,54390,0,54390,1.0,5075.98,4091.76,5075.45,4091.4,399,398
3402,3708,3979,4271,306,292,41809,3365,38444,0.9195149369752924,3573.12,4134.56,3572.39,4133.9,400,399
6110,6390,3989,4352,280,363,48114,0,48114,1.0,6261.79,4136.92,6261.47,4136.96,401,400
7729,8025,3989,4481,296,492,102150,0,102150,1.0,7875.14,4242.53,7874.58,4242.01,402,401
13083,13363,3990,4483,280,493,62790,1698,61092,0.9729574773053034,13213.53,4202.52,13213.16,4202.66,403,402
3833,4060,3992,4211,227,219,29805,1315,28490,0.9558798859251804,3958.79,4103.94,3958.2,4103.55,404,403
9379,9695,3997,4376,316,379,67086,3049,64037,0.9545508749962734,9536.67,4164.53,9536.18,4164.03,405,404
5588,5925,3999,4438,337,439,84244,1558,82686,0.9815061013247234,5769.24,4209.72,5768.68,4209.2,406,405
8824,9196,4000,4469,372,469,111526,3334,108192,0.9701056255940319,9008.34,4246.58,9007.79,4245.94,408,406
4365,4711,4001,4334,346,333,69239,0,69239,1.0,4538.38,4147.75,4537.69,4147.24,407,407
13683,13851,4003,4137,168,134,12977,0,12977,1.0,13765.14,4067.18,13764.61,4066.7,409,408
2655,3006,4012,4267,351,255,50141,0,50141,1.0,2833.93,4143.53,2833.35,4142.97,410,409
4253,4395,4012,4127,142,115,9497,0,9497,1.0,4331.89,4068.49,4331.22,4068.16,411,410
4049,4169,4019,4166,120,147,9537,449,9088,0.9529202055153613,4107.69,4082.11,4107.53,4082.18,412,411
7061,7222,4022,4230,161,208,20686,979,19707,0.9526733056173258,7151.07,4131.99,7150.51,4131.48,413,412
10151,10322,4026,4304,171,278,26219,0,26219,1.0,10249.17,4157.3,10248.61,4156.89,414,413
13342,13474,4026,4174,132,148,13375,0,13375,1.0,13401.63,4105.51,13401.13,4104.88,415,414
11585,11820,4030,4220,235,190,31202,1163,30039,0.9627267482853663,11704.73,4121.76,11704.0,4121.5,416,415
12487,12733,4037,4226,246,189,23143,1389,21754,0.9399818519638767,12623.7,4144.87,12622.91,4144.28,417,416
2984,3319,4058,4309,335,251,62074,0,62074,1.0,3168.87,4178.54,3168.19,4178.14,418,417
14762,14980,4060,4381,218,321,41500,0,41500,1.0,14869.15,4213.09,14868.64,4212.66,419,418
7965,8191,4063,4306,226,243,31774,0,31774,1.0,8059.69,4186.12,8059.42,4185.63,420,419
5271,5732,4070,4628,461,558,155164,9989,145175,0.9356229537779381,5508.16,4334.98,5507.4,4334.31,421,420
4926,5391,4071,4586,465,515,142519,8599,133920,0.9396641851261937,5175.41,4355.44,5174.95,4354.64,422,421
9659,9974,4072,4378,315,306,62018,0,62018,1.0,9803.16,4220.28,9802.79,4219.67,423,422
12921,13139,4072,4369,218,297,42634,0,42634,1.0,13039.42,4206.02,13038.75,4205.92,424,423
12676,12998,4085,4611,322,526,94274,151,94123,0.9983982858476356,12838.83,4352.25,12838.3,4350.85,425,424
13740,14190,4088,4350,450,262,47329,0,47329,1.0,13901.22,4225.32,13903.02,4224.33,426,425
5841,6346,4096,4538,505,442,140544,7838,132706,0.9442309881602914,6077.11,4317.17,6076.61,4316.68,427,426
10791,11054,4097,4356,263,259,49331,0,49331,1.0,10917.86,4226.27,10917.27,4225.91,428,427
4100,4695,4106,4658,595,552,196334,7123,189211,0.963719987368464,4375.13,4397.9,4374.75,4397.42,429,428
3201,3518,4111,4458,317,347,61531,143,61388,0.9976759682111456,3365.87,4285.83,3365.26,4285.41,430,429
2512,2772,4115,4341,260,226,37844,1483,36361,0.9608128104851495,2627.52,4219.75,2627.17,4219.29,431,430
13343,13679,4120,4421,336,301,51236,3720,47516,0.9273948005308768,13493.74,4275.27,13493.62,4274.76,433,431
14032,14305,4121,4456,273,335,55257,1495,53762,0.9729446043035271,14168.43,4287.98,14168.06,4287.36,432,432
10446,10805,4129,4614,359,485,115206,3105,112101,0.9730482787354825,10626.97,4370.95,10626.52,4370.37,434,433
9853,10296,4137,4541,443,404,106166,1759,104407,0.9834316071058531,10078.13,4330.27,10077.59,4329.86,435,434
3985,4144,4139,4330,159,191,20406,1771,18635,0.9132118004508478,4066.79,4228.51,4066.29,4228.1,436,435
13206,13401,4143,4385,195,242,27758,946,26812,0.9659197348512141,13299.56,4256.33,13299.43,4256.15,437,436
8494,9014,4150,4631,520,481,133531,2088,131443,0.9843631815833027,8751.63,4430.65,8751.22,4430.18,438,437
6495,6737,4153,4361,242,208,25724,0,25724,1.0,6628.21,4263.85,6627.55,4263.28,439,438
4547,5091,4160,4655,544,495,158153,6077,152076,0.9615751835248145,4812.1,4414.8,4811.7,4414.29,440,439
11682,11818,4170,4404,136,234,20199,0,20199,1.0,11746.11,4288.51,11745.74,4287.9,441,440
3724,3992,4171,4386,268,215,31243,749,30494,0.9760266299651121,3855.8,4263.17,3855.22,4262.67,442,441
11241,11708,4174,4775,467,601,145594,6858,138736,0.9528964105663695,11481.12,4480.56,11480.75,4479.9,443,442
12291,12723,4188,4578,432,390,117805,5044,112761,0.9571834811765205,12532.14,4390.06,12531.44,4389.49,444,443
3311,3811,4189,4687,500,498,137183,9459,127724,0.9310483077349234,3562.19,4452.91,3561.75,4452.28,445,444
12636,12786,4189,4378,150,189,13039,0,13039,1.0,12730.97,4272.74,12729.79,4272.04,446,445
2570,2965,4205,4516,395,311,44390,22,44368,0.9995043928812796,2728.28,4345.58,2728.36,4345.01,447,446
7097,7611,4207,4855,514,648,209471,4881,204590,0.9766984451308296,7345.47,4544.21,7344.93,4543.64,448,447
13687,14006,4220,4481,319,261,38492,1320,37172,0.965707159929336,13824.67,4356.87,13824.58,4356.55,449,448
8091,8275,4225,4477,184,252,31485,2445,29040,0.9223439733206289,8191.87,4343.7,8191.33,4343.27,450,449
13603,13757,4227,4509,154,282,19453,1457,17996,0.9251015267567985,13673.62,4384.95,13673.44,4383.56,451,450
12109,12287,4236,4456,178,220,19766,1462,18304,0.9260346048770616,12181.39,4333.78,12181.15,4333.54,452,451
9455,9685,4245,4562,230,317,33404,0,33404,1.0,9573.18,4389.05,9572.64,4388.8,453,452
3748,4177,4256,4589,429,333,85946,0,85946,1.0,3966.14,4436.77,3965.66,4436.23,454,453
2951,3241,4259,4670,290,411,72237,0,72237,1.0,3079.26,4434.39,3078.86,4434.07,455,454
6299,6859,4266,4602,560,336,108667,1376,107291,0.987337462155024,6556.49,4430.96,6556.35,4430.36,456,455
8253,8433,4268,4520,180,252,24356,451,23905,0.9814830021349975,8336.37,4421.77,8335.7,4420.78,457,456
2634,3046,4275,4768,412,493,127891,730,127161,0.9942920142934217,2844.2,4563.08,2843.72,4562.45,458,457
13944,14085,4281,4481,141,200,13662,1686,11976,0.8765920070267896,14009.9,4390.66,14009.67,4389.81,459,458
2267,2597,4286,4772,330,486,78268,0,78268,1.0,2421.44,4511.61,2421.02,4511.19,460,459
12913,13080,4290,4440,167,150,14955,0,14955,1.0,12980.26,4360.56,12980.06,4360.14,461,460
10256,10462,4299,4603,206,304,40725,0,40725,1.0,10364.98,4431.2,10364.48,4431.01,462,461
7969,8176,4304,4474,207,170,15106,0,15106,1.0,8060.98,4384.15,8060.57,4384.53,463,462
11796,12226,4306,4715,430,409,104287,6267,98020,0.9399062203342698,12031.3,4492.41,12030.79,4492.18,464,463
9564,9887,4313,4760,323,447,104997,8030,96967,0.9235216244273646,9729.16,4547.32,9728.61,4546.78,465,464
9071,9322,4318,4595,251,277,39909,0,39909,1.0,9196.02,4471.94,9195.44,4471.28,466,465
12179,12418,4328,4717,239,389,54043,1316,52727,0.975649020224636,12291.99,4522.66,12291.53,4522.15,467,466
10759,10995,4330,4613,236,283,46750,0,46750,1.0,10875.24,4461.85,10874.76,4461.44,468,467
7529,8057,4334,5001,528,667,196660,7552,189108,0.961598698260958,7815.99,4670.39,7815.25,4669.82,469,468
13214,13544,4352,4703,330,351,70857,1444,69413,0.979620926655094,13389.58,4518.59,13389.06,4518.19,470,469
13427,13670,4360,4528,243,168,19294,1242,18052,0.9356276562661967,13556.88,4442.68,13556.11,4442.06,471,470
12929,13327,4369,4748,398,379,81285,0,81285,1.0,13083.98,4551.77,13083.98,4551.44,472,471
9837,9987,4373,4614,150,241,16625,0,16625,1.0,9908.45,4493.49,9907.76,4492.74,473,472
14160,14337,4386,4576,177,190,19714,0,19714,1.0,14258.58,4483.92,14257.92,4483.32,474,473
11616,11798,4390,4608,182,218,24961,0,24961,1.0,11704.43,4493.17,11703.86,4492.82,475,474
10094,10378,4393,4869,284,476,92291,7130,85161,0.9227443629389648,10231.47,4643.92,10230.98,4643.26,476,475
10970,11259,4396,4635,289,239,35870,896,34974,0.9750209088374686,11112.88,4521.21,11112.32,4520.69,477,476
13667,13931,4400,4633,264,233,30601,531,30070,0.9826476258945787,13789.64,4514.41,13789.24,4513.8,478,477
3117,3338,4405,4658,221,253,32950,2837,30113,0.9138998482549318,3237.17,4533.07,3236.51,4532.66,479,478
2346,2696,4419,4936,350,517,89569,0,89569,1.0,2533.35,4692.6,2532.84,4691.92,480,479
6007,6382,4429,4867,375,438,103008,7029,95979,0.9317625815470643,6192.62,4620.18,6192.16,4619.8,481,480
7969,8250,4429,4701,281,272,37376,1304,36072,0.965111301369863,8109.0,4528.54,8108.99,4528.53,482,481
5561,6159,4431,5006,598,575,201722,9026,192696,0.9552552522778874,5867.48,4711.37,5867.0,4710.92,483,482
14006,14219,4432,4619,213,187,26166,2818,23348,0.8923029886111749,14114.44,4523.61,14113.92,4523.12,484,483
6735,7041,4440,4934,306,494,96636,9,96627,0.9999068670060847,6894.14,4670.62,6893.77,4670.33,485,484
8934,9114,4462,4683,180,221,26199,0,26199,1.0,9024.12,4574.21,9023.61,4573.72,486,485
10577,10883,4463,4768,306,305,46428,1408,45020,0.9696734729042819,10746.94,4632.47,10746.23,4631.78,487,486
13887,14054,4466,4612,167,146,14387,2015,12372,0.8599430041009244,13961.58,4538.05,13961.4,4537.72,488,487
8179,8398,4467,4713,219,246,29881,962,28919,0.9678056289950135,8272.18,4583.26,8271.99,4582.77,489,488
9293,9566,4471,4633,273,162,30930,1506,29424,0.9513094083414161,9416.28,4549.92,9416.01,4549.44,490,489
3578,4037,4483,4881,459,398,127165,7498,119667,0.9410372350882712,3799.17,4704.91,3798.65,4704.33,491,490
6986,7169,4484,4673,183,189,23273,2237,21036,0.9038800326558674,7077.11,4584.84,7076.62,4584.26,492,491
11688,12067,4485,4827,379,342,72364,1189,71175,0.9835691780443314,11850.78,4666.1,11850.5,4665.46,493,492
6394,6780,4486,4866,386,380,84334,0,84334,1.0,6616.72,4694.43,6616.0,4693.7,494,493
3992,4392,4497,4805,400,308,87280,0,87280,1.0,4195.89,4668.73,4195.33,4668.09,495,494
13492,13815,4508,4840,323,332,74893,0,74893,1.0,13647.96,4681.67,13647.49,4681.26,496,495
7960,8204,4512,4855,244,343,39742,0,39742,1.0,8083.86,4701.27,8083.3,4700.52,498,496
9874,10117,4512,4817,243,305,53912,0,53912,1.0,10004.41,4671.18,10003.85,4670.62,497,497
8302,8755,4516,5031,453,515,121338,5506,115832,0.9546226244045559,8524.44,4775.08,8524.01,4774.64,499,498
6324,6462,4517,4739,138,222,20856,1637,19219,0.9215093977752206,6389.82,4631.44,6389.29,4630.93,500,499
10837,11142,4528,5071,305,543,116029,3468,112561,0.9701109205457257,10989.12,4792.97,10988.67,4792.48,501,500
12591,12939,4531,4899,348,368,80898,399,80499,0.995067863235185,12740.04,4711.2,12739.66,4710.52,502,501
5094,5674,4539,4938,580,399,146480,4568,141912,0.968814855270344,5398.78,4735.38,5398.16,4734.84,503,502
10321,10653,4547,5041,332,494,118225,7589,110636,0.9358088390780291,10479.85,4797.47,10479.39,4796.93,504,503
9029,9353,4551,4885,324,334,76091,0,76091,1.0,9196.62,4713.59,9196.0,4713.19,507,504
13818,14068,4551,4786,250,235,28585,110,28475,0.9961518278817562,13938.44,4648.76,13938.36,4648.21,505,505
14175,14503,4551,4914,328,363,61326,2515,58811,0.95898966180739,14335.8,4732.14,14335.31,4731.65,506,506
11374,11700,4554,5234,326,680,106155,0,106155,1.0,11533.26,4920.01,11532.78,4918.86,508,507
12335,12641,4560,4885,306,325,71242,0,71242,1.0,12495.4,4710.44,12494.85,4710.01,509,508
4917,5176,4562,4832,259,270,38068,0,38068,1.0,5052.63,4698.49,5052.15,4697.99,510,509
13110,13328,4568,4830,218,262,30123,0,30123,1.0,13224.79,4699.36,13224.21,4698.88,511,510
11103,11403,4573,4934,300,361,68232,2447,65785,0.9641370617891898,11235.44,4762.56,11234.99,4761.87,512,511
8589,9039,4575,4977,450,402,121578,0,121578,1.0,8837.18,4766.32,8836.55,4765.76,513,512
9439,9731,4575,5070,292,495,66954,0,66954,1.0,9567.02,4833.65,9566.77,4833.13,514,513
3065,3492,4580,5054,427,474,99750,6405,93345,0.9357894736842105,3302.72,4797.91,3301.83,4798.27,515,514
14032,14246,4581,4775,214,194,21683,1941,19742,0.9104828667619794,14134.61,4681.12,14134.2,4680.69,516,515
4443,4912,4600,5025,469,425,127625,7355,120270,0.9423702252693438,4695.3,4805.92,4694.69,4805.46,517,516
12904,13051,4607,4821,147,214,15625,0,15625,1.0,12962.8,4720.61,12962.44,4720.02,520,517
4362,4520,4608,4807,158,199,18567,1019,17548,0.9451176819087629,4436.15,4711.64,4435.52,4710.71,518,518
3027,3223,4613,4832,196,219,26745,2233,24512,0.9165077584595251,3129.88,4721.82,3129.34,4721.21,519,519
9326,9522,4614,4787,196,173,24303,73,24230,0.9969962556063038,9429.91,4698.17,9429.25,4697.87,521,520
13779,13887,4620,4739,108,119,8007,514,7493,0.9358061696015986,13824.15,4681.98,13823.82,4681.47,522,521
4801,5231,4624,5116,430,492,67100,537,66563,0.9919970193740686,5036.52,4880.28,5035.57,4879.25,523,522
13174,13600,4639,5317,426,678,174401,8604,165797,0.9506654204964421,13378.97,4968.61,13378.41,4968.2,524,523
14810,15116,4640,5081,306,441,97233,0,97233,1.0,14952.35,4861.7,14951.86,4861.17,525,524
12043,12293,4642,4908,250,266,39622,755,38867,0.9809449295845742,12171.5,4779.51,12171.03,4778.71,526,525
7580,7742,4646,4870,162,224,22048,0,22048,1.0,7666.12,4761.59,7665.58,4761.08,527,526
14010,14239,4651,4910,229,259,28388,2125,26263,0.9251444272227702,14092.04,4795.32,14091.75,4794.8,530,527
3459,3596,4653,4829,137,176,15630,0,15630,1.0,3528.67,4747.3,3528.27,4746.59,529,528
7007,7416,4653,5003,409,350,81235,2155,79080,0.973472025604727,7192.97,4828.09,7192.81,4827.61,528,529
14457,14838,4660,4818,381,158,23066,0,23066,1.0,14598.65,4725.85,14599.5,4724.91,531,530
2943,3093,4681,5014,150,333,30068,0,30068,1.0,3015.96,4860.22,3015.47,4859.36,534,531
12228,12436,4681,4916,208,235,26074,954,25120,0.963411827874511,12328.51,4835.16,12327.79,4833.92,533,532
15265,15811,4682,5176,546,494,151909,1229,150680,0.9919096301074986,15559.32,4886.04,15558.69,4885.66,532,533
8181,8420,4684,4927,239,243,28720,0,28720,1.0,8280.05,4795.39,8279.99,4795.28,535,534
9719,10053,4687,4998,334,311,60927,1687,59240,0.97231112642999,9876.99,4850.92,9876.64,4850.37,536,535
14567,14825,4692,4965,258,273,40917,0,40917,1.0,14700.54,4809.24,14699.91,4808.92,537,536
11899,12137,4699,5010,238,311,46251,142,46109,0.9969297961125165,11998.44,4858.61,11998.15,4858.07,538,537
2050,2299,4707,4995,249,288,40560,0,40560,1.0,2164.21,4839.58,2163.85,4839.18,539,538
13792,14032,4712,4936,240,224,38798,0,38798,1.0,13909.73,4828.98,13909.08,4828.27,540,539
10578,10892,4718,5144,314,426,95337,0,95337,1.0,10743.0,4934.62,10742.44,4934.15,541,540
6197,6612,4732,5133,415,401,88145,0,88145,1.0,6415.89,4911.92,6415.44,4911.53,542,541
12983,13255,4735,5110,272,375,72886,0,72886,1.0,13112.36,4928.1,13111.91,4927.5,543,542
2537,2970,4738,5011,433,273,70445,2494,67951,0.9645964937185038,2760.99,4853.72,2760.38,4853.34,544,543
12798,13028,4742,5183,230,441,63596,0,63596,1.0,12909.97,4959.38,12909.43,4959.09,545,544
11590,11862,4747,5182,272,435,81469,0,81469,1.0,11703.03,4979.5,11702.66,4978.98,546,545
3891,4187,4760,5113,296,353,73433,0,73433,1.0,4035.79,4940.89,4035.37,4940.38,547,546
5096,5378,4762,5107,282,345,42799,0,42799,1.0,5254.36,4932.66,5253.7,4932.12,548,547
10024,10195,4763,4977,171,214,16690,0,16690,1.0,10107.09,4863.83,10106.49,4863.83,549,548
9181,9476,4770,5109,295,339,68180,0,68180,1.0,9341.23,4935.56,9340.7,4935.07,550,549
11222,11482,4770,5082,260,312,46919,4412,42507,0.9059656002898613,11350.42,4933.23,11350.03,4932.58,551,550
14125,14410,4773,5092,285,319,46200,0,46200,1.0,14267.91,4933.71,14267.37,4933.18,552,551
9592,9782,4785,5038,190,253,25629,0,25629,1.0,9689.58,4928.96,9689.15,4928.09,553,552
11777,11938,4788,5077,161,289,26332,0,26332,1.0,11859.14,4929.84,11858.62,4929.15,554,553
5648,5837,4789,4950,189,161,17253,1519,15734,0.9119573407523329,5733.51,4878.4,5733.09,4877.87,556,554
2171,2455,4790,5194,284,404,65786,0,65786,1.0,2302.26,4982.88,2301.86,4982.44,555,555
7378,7770,4790,5429,392,639,183275,7351,175924,0.9598908743691175,7579.61,5093.92,7579.06,5093.48,557,556
8967,9180,4792,5047,213,255,23898,2291,21607,0.904134237174659,9061.24,4915.26,9060.78,4914.9,558,557
6586,6966,4793,5052,380,259,64753,0,64753,1.0,6793.68,4926.94,6793.0,4926.34,559,558
3453,3899,4794,5110,446,316,67796,2905,64891,0.9571508643577792,3711.45,4937.7,3710.52,4937.15,560,559
4151,4694,4797,5226,543,429,149378,7509,141869,0.9497315535085488,4405.3,4995.79,4404.94,4995.36,561,560
8010,8298,4806,5263,288,457,95817,0,95817,1.0,8161.45,5035.63,8160.92,5035.03,562,561
14496,14633,4807,4975,137,168,13044,0,13044,1.0,14562.91,4884.48,14562.55,4884.25,563,562
13593,13717,4814,4970,124,156,13605,740,12865,0.9456082322675486,13656.4,4888.17,13655.92,4887.78,564,563
14595,14855,4817,5117,260,300,40909,498,40411,0.9878266396147547,14730.52,4989.11,14730.11,4988.36,565,564
15007,15533,4820,5333,526,513,161505,0,161505,1.0,15277.15,5081.08,15276.57,5080.6,566,565
13697,13850,4824,4982,153,158,15687,0,15687,1.0,13767.4,4898.01,13767.01,4897.65,567,566
10208,10343,4837,4989,135,152,11833,1162,10671,0.9018000507056537,10287.44,4917.01,10286.72,4916.21,568,567
14357,14623,4849,5097,266,248,34899,768,34131,0.9779936387862116,14493.75,4982.21,14493.12,4981.38,569,568
8278,8625,4854,5349,347,495,117524,0,117524,1.0,8424.8,5095.87,8424.39,5095.39,570,569
6078,6331,4857,5096,253,239,34144,1388,32756,0.959348641049672,6201.01,4981.9,6200.53,4981.36,571,570
12310,12675,4858,5243,365,385,85985,0,85985,1.0,12522.66,5038.73,12521.95,5038.2,572,571
10105,10281,4861,5060,176,199,17132,0,17132,1.0,10185.26,4960.06,10184.97,4959.64,573,572
2734,2978,4869,5132,244,263,36919,419,36500,0.9886508301958341,2864.63,5009.27,2864.15,5008.67,575,573
12600,12847,4869,5166,247,297,51006,0,51006,1.0,12743.22,5015.92,12742.41,5015.11,574,574
4722,5207,4871,5355,485,484,123221,7161,116060,0.9418849059819349,4967.82,5119.52,4967.35,5119.16,576,575
6534,6716,4887,5190,182,303,30022,2667,27355,0.9111651455599227,6612.05,5037.49,6611.62,5037.03,577,576
8982,9374,4888,5520,392,632,147878,2705,145173,0.9817078943453387,9162.32,5221.43,9161.94,5220.75,578,577
14000,14242,4889,5093,242,204,32102,0,32102,1.0,14114.73,4992.81,14114.33,4992.35,579,578
5339,5652,4891,5272,313,381,72329,970,71359,0.9865890583306834,5508.02,5060.49,5507.49,5060.11,580,579
6950,7199,4892,5136,249,244,38676,0,38676,1.0,7055.32,5013.0,7055.03,5012.43,581,580
3286,3779,4895,5369,493,474,130105,0,130105,1.0,3567.03,5125.54,3566.32,5124.99,582,581
12003,12357,4898,5282,354,384,103560,4795,98765,0.9536983391270761,12185.1,5083.67,12184.6,5083.2,583,582
5567,5994,4899,5309,427,410,108795,3,108792,0.9999724252033642,5774.17,5103.78,5773.42,5103.24,584,583
13552,13711,4908,5069,159,161,11712,0,11712,1.0,13625.13,4997.78,13624.84,4996.92,585,584
2330,2750,4911,5359,420,448,131078,0,131078,1.0,2535.42,5128.65,2534.95,5128.17,586,585
13797,14037,4911,5185,240,274,41842,1344,40498,0.9678791644758855,13920.18,5037.62,13919.74,5037.2,587,586
11029,11248,4914,5108,219,194,26147,1484,24663,0.9432439668030749,11149.82,5016.04,11149.18,5015.56,589,587
3185,3352,4915,5061,167,146,15104,719,14385,0.952396716101695,3265.06,4984.25,3264.69,4983.79,588,588
9890,10195,4919,5431,305,512,101470,0,101470,1.0,10057.6,5165.36,10057.07,5164.92,590,589
7755,8035,4934,5237,280,303,60949,0,60949,1.0,7891.68,5092.38,7891.45,5091.66,591,590
3008,3188,4946,5187,180,241,30495,1996,28499,0.9345466469913101,3094.96,5060.23,3094.37,5059.74,592,591
8680,9012,4949,5335,332,386,92819,0,92819,1.0,8843.35,5126.87,8842.86,5126.35,593,592
9758,9929,4950,5122,171,172,15144,0,15144,1.0,9854.48,5009.77,9854.01,5009.87,594,593
7121,7407,4953,5229,286,276,60264,0,60264,1.0,7272.64,5090.55,7272.11,5090.09,595,594
13624,13903,4953,5441,279,488,78832,684,78148,0.9913233204789933,13744.46,5193.81,13744.0,5193.42,596,595
10176,10439,4970,5114,263,144,20304,1229,19075,0.9394700551615445,10308.03,5039.16,10307.35,5038.66,597,596
11860,12081,4987,5361,221,374,41601,2469,39132,0.9406504651330497,11966.79,5166.95,11966.31,5166.62,598,597
9370,9633,4991,5338,263,347,68994,3930,65064,0.9430385250891382,9503.85,5171.1,9503.32,5170.52,599,598
5938,6212,4992,5258,274,266,37194,0,37194,1.0,6078.74,5109.87,6078.36,5109.6,600,599
2877,3030,4998,5201,153,203,17197,294,16903,0.9829039948828284,2959.78,5105.33,2959.28,5104.71,601,600
14615,14947,5000,5353,332,353,53209,963,52246,0.9819015580071041,14775.02,5175.34,14774.71,5174.65,602,601
10461,10734,5002,5296,273,294,37490,0,37490,1.0,10609.75,5130.01,10609.16,5129.68,603,602
6174,6460,5005,5248,286,243,31738,2260,29478,0.9287919843720461,6299.7,5110.15,6299.25,5109.99,604,603
14242,14483,5006,5326,241,320,39245,0,39245,1.0,14381.93,5147.04,14381.33,5146.8,605,604
3140,3301,5008,5183,161,175,16600,1428,15172,0.9139759036144578,3219.74,5106.5,3219.14,5105.82,606,605
9618,9934,5009,5439,316,430,96068,7062,89006,0.926489569887996,9762.27,5214.37,9761.77,5213.9,607,606
8576,8717,5013,5230,141,217,17745,0,17745,1.0,8648.77,5128.32,8648.21,5127.43,608,607
4631,4768,5017,5155,137,138,13549,0,13549,1.0,4703.72,5092.86,4703.1,5092.36,609,608
10851,11028,5020,5210,177,190,17322,0,17322,1.0,10928.7,5112.32,10928.37,5111.78,610,609
12328,12451,5020,5221,123,201,18387,0,18387,1.0,12385.27,5129.68,12384.82,5129.09,611,610
6612,7009,5027,5434,397,407,96082,4422,91660,0.953976811473533,6792.22,5202.63,6791.73,5202.41,612,611
10164,10627,5027,5495,463,468,138712,2413,136299,0.9826042447661342,10391.07,5258.14,10390.62,5257.7,613,612
13339,13661,5032,5421,322,389,81746,0,81746,1.0,13523.68,5243.6,13523.05,5243.06,614,613
12982,13181,5033,5241,199,208,20297,2131,18166,0.8950091146474849,13064.35,5150.0,13063.9,5149.02,615,614
4001,4438,5040,5451,437,411,127828,8565,119263,0.9329959007416215,4210.43,5250.63,4209.98,5250.11,616,615
3851,4013,5041,5249,162,208,23790,0,23790,1.0,3926.63,5155.26,3926.1,5154.57,617,616
3746,3860,5044,5310,114,266,16723,0,16723,1.0,3802.72,5185.1,3801.76,5184.25,618,617
11166,11448,5050,5386,282,336,61519,4007,57512,0.9348656512622117,11291.22,5211.73,11290.79,5211.22,620,618
13950,14380,5050,5406,430,356,98384,5243,93141,0.9467088144413726,14170.52,5236.68,14169.92,5236.1,619,619
5188,5373,5052,5219,185,167,18703,0,18703,1.0,5272.86,5126.62,5272.54,5126.22,621,620
14442,14623,5056,5323,181,267,24499,0,24499,1.0,14523.16,5189.12,14523.07,5188.38,622,621
14575,14674,5056,5178,99,122,5593,0,5593,1.0,14617.26,5121.56,14616.87,5120.75,623,622
1880,2334,5063,5406,454,343,92128,303,91825,0.9967110976033345,2065.44,5228.22,2065.34,5227.74,624,623
14786,15600,5065,5813,814,748,349144,3808,345336,0.989093325390097,15133.47,5486.24,15133.04,5485.69,625,624
10939,11204,5069,5489,265,420,71046,0,71046,1.0,11068.73,5255.44,11068.27,5255.24,626,625
3140,3495,5074,5503,355,429,92286,2011,90275,0.9782090457924278,3322.82,5303.73,3322.35,5302.98,627,626
11516,11981,5086,5514,465,428,114137,0,114137,1.0,11767.82,5310.79,11767.17,5310.04,628,627
2716,2878,5089,5219,162,130,14075,2736,11339,0.8056127886323268,2797.27,5154.82,2796.72,5154.35,629,628
6740,7401,5097,5694,661,597,195779,6551,189228,0.9665388014036235,7096.29,5426.24,7095.57,5425.59,630,629
5305,5514,5108,5294,209,186,21286,0,21286,1.0,5399.15,5194.28,5398.81,5194.01,631,630
10720,10925,5121,5283,205,162,19154,0,19154,1.0,10812.53,5199.49,10812.31,5198.99,632,631
6174,6682,5124,5528,508,404,145434,4967,140467,0.965847050895939,6436.83,5323.11,6436.3,5322.62,633,632
12862,13207,5127,5426,345,299,54435,0,54435,1.0,13025.55,5281.96,13025.44,5280.94,634,633
12645,12902,5129,5342,257,213,32665,1132,31533,0.965345170671973,12776.78,5228.87,12776.23,5228.21,635,634
3040,3196,5138,5297,156,159,12386,1612,10774,0.8698530599063459,3112.01,5216.52,3111.55,5216.07,636,635
4623,4878,5141,5343,255,202,25424,1217,24207,0.9521318439269981,4739.05,5230.79,4738.84,5230.56,637,636
7986,8089,5141,5231,103,90,5181,0,5181,1.0,8035.9,5191.5,8035.47,5190.9,638,637
2799,2992,5151,5381,193,230,23353,2250,21103,0.9036526356356785,2880.16,5277.79,2879.9,5277.33,640,638
4435,4772,5151,5456,337,305,54970,0,54970,1.0,4586.24,5310.62,4586.11,5310.07,639,639
5151,5374,5152,5380,223,228,27653,0,27653,1.0,5261.69,5280.23,5261.06,5279.45,641,640
2937,3066,5156,5331,129,175,14844,0,14844,1.0,2998.88,5237.94,2998.43,5237.49,642,641
5734,6239,5162,5604,505,442,133571,0,133571,1.0,6000.24,5372.67,5999.76,5372.16,643,642
7705,7920,5166,5461,215,295,35999,966,35033,0.973165921275591,7809.2,5334.96,7808.63,5334.18,644,643
8354,9002,5179,5676,648,497,167079,8601,158478,0.9485213581599123,8696.85,5443.33,8696.18,5442.78,645,644
14512,14756,5180,5453,244,273,36239,0,36239,1.0,14620.93,5332.16,14620.59,5331.47,647,645
13765,14112,5181,5574,347,393,91443,6920,84523,0.9243244425489102,13938.03,5389.42,13937.56,5388.85,646,646
2618,2821,5189,5391,203,202,26748,852,25896,0.968147151188874,2727.53,5290.17,2726.93,5289.63,648,647
7856,8018,5195,5369,162,174,15844,0,15844,1.0,7942.57,5272.42,7941.99,5272.03,649,648
7917,8294,5200,5666,377,466,103597,44,103553,0.999575277276369,8109.77,5432.34,8109.07,5431.66,655,649
12545,12724,5200,5385,179,185,19685,439,19246,0.9776987553975108,12638.3,5294.15,12637.76,5293.59,650,650
12265,12408,5201,5338,143,137,9307,0,9307,1.0,12329.47,5264.6,12329.23,5264.0,651,651
12325,12665,5201,5445,340,244,42530,766,41764,0.9819891841053374,12479.88,5325.64,12479.71,5325.41,652,652
7203,7607,5207,5597,404,390,90184,0,90184,1.0,7392.85,5389.07,7392.49,5388.69,653,653
10738,11053,5208,5499,315,291,43341,0,43341,1.0,10904.34,5372.58,10903.45,5371.52,654,654
13096,13349,5212,5477,253,265,40492,0,40492,1.0,13211.1,5363.18,13210.69,5362.47,658,655
8183,8367,5213,5439,184,226,17487,0,17487,1.0,8286.46,5330.47,8285.62,5329.66,656,656
10614,10806,5214,5484,192,270,37119,0,37119,1.0,10716.04,5356.83,10715.59,5356.28,657,657
9296,9460,5216,5386,164,170,19666,2276,17390,0.884267263297061,9365.56,5307.39,9365.27,5306.89,659,658
2138,2367,5217,5506,229,289,43301,0,43301,1.0,2247.48,5353.68,2247.01,5353.22,660,659
3926,4061,5221,5378,135,157,10782,257,10525,0.9761639769987015,3978.58,5297.27,3978.76,5297.25,661,660
8833,9067,5228,5532,234,304,38448,0,38448,1.0,8964.31,5380.86,8963.7,5380.33,662,661
11269,11630,5231,5619,361,388,98378,8171,90207,0.9169428124174104,11459.29,5431.9,11458.59,5431.55,664,662
3715,3931,5232,5429,216,197,28466,0,28466,1.0,3836.71,5333.53,3836.04,5333.03,665,663
5369,5580,5232,5404,211,172,23034,0,23034,1.0,5483.98,5307.93,5483.54,5307.62,663,664
4770,5279,5237,5640,509,403,109037,0,109037,1.0,5024.65,5448.01,5024.17,5447.49,666,665
11977,12328,5251,5549,351,298,81647,0,81647,1.0,12151.79,5401.79,12151.27,5401.26,667,666
2317,2456,5262,5461,139,199,18585,0,18585,1.0,2385.69,5372.74,2385.18,5372.05,668,667
3420,3616,5266,5473,196,207,19465,0,19465,1.0,3514.4,5352.82,3513.55,5352.95,669,668
12646,12991,5268,5821,345,553,119566,0,119566,1.0,12822.67,5546.22,12822.29,5545.59,671,669
2896,3252,5269,5643,356,374,81870,58,81812,0.9992915597899108,3093.39,5461.42,3092.6,5460.98,670,670
9735,10105,5272,5741,370,469,101370,5216,96154,0.9485449343987373,9918.36,5492.37,9917.82,5491.99,672,671
14352,14560,5273,5579,208,306,31787,4277,27510,0.8654481391763928,14445.43,5410.93,14444.99,5410.67,673,672
5572,5860,5287,5579,288,292,47263,2390,44873,0.9494319023337494,5726.68,5420.65,5726.01,5420.11,674,673
15302,15718,5296,5679,416,383,55230,1529,53701,0.9723157704146297,15528.08,5470.14,15527.46,5469.68,675,674
9438,9747,5297,5548,309,251,39871,0,39871,1.0,9597.73,5419.75,9597.2,5419.22,676,675
2401,2820,5298,5897,419,599,109337,0,109337,1.0,2613.22,5618.91,2612.6,5617.99,678,676
5125,5674,5299,5862,549,563,169003,3099,165904,0.9816630474015254,5441.44,5575.09,5440.54,5574.32,677,677
2616,2901,5306,5638,285,332,28338,0,28338,1.0,2798.26,5466.49,2796.47,5465.6,681,678
2839,2977,5332,5495,138,163,13960,1284,12676,0.9080229226361032,2906.81,5404.8,2906.35,5404.41,679,679
10967,11315,5341,5785,348,444,86386,2519,83867,0.9708401824369689,11139.06,5555.72,11138.5,5555.33,680,680
4255,4713,5346,5785,458,439,135647,6378,129269,0.9529808989509536,4486.27,5574.57,4485.75,5574.02,682,681
2411,2589,5350,5565,178,215,23128,0,23128,1.0,2509.43,5450.17,2508.78,5449.8,684,682
3812,4149,5350,5671,337,321,76503,661,75842,0.9913598159549298,3986.49,5507.94,3985.93,5507.58,683,683
3583,3834,5352,5644,251,292,39907,1217,38690,0.9695040970255845,3726.16,5487.76,3725.41,5487.08,685,684
4621,4878,5353,5567,257,214,30923,2214,28709,0.9284028069721566,4752.23,5462.7,4751.68,5462.19,686,685
14476,14858,5353,5703,382,350,86698,4559,82139,0.9474151652863965,14678.79,5541.23,14678.25,5540.49,687,686
13262,13533,5355,5624,271,269,42049,0,42049,1.0,13410.9,5489.5,13410.15,5488.98,688,687
1777,2187,5366,5676,410,310,82014,0,82014,1.0,1971.92,5515.7,1971.47,5515.24,689,688
13439,13821,5371,5716,382,345,56669,0,56669,1.0,13617.54,5531.43,13617.17,5531.22,690,689
10323,10527,5374,5600,204,226,21279,924,20355,0.9565769068095306,10421.37,5470.97,10420.59,5470.97,691,690
9209,9697,5377,5889,488,512,145967,1975,143992,0.9864695444860825,9467.28,5614.79,9466.82,5614.41,692,691
7843,7977,5379,5535,134,156,14077,1019,13058,0.9276124174184841,7909.82,5466.31,7909.33,5465.64,694,692
14090,14397,5380,5655,307,275,57112,862,56250,0.9849068496988374,14240.56,5497.92,14240.06,5497.59,693,693
7633,8063,5383,5730,430,347,56259,1158,55101,0.9794166266730656,7841.97,5553.3,7841.56,5552.97,695,694
12301,12692,5387,5617,391,230,58843,2655,56188,0.9548799347416005,12479.61,5492.11,12479.42,5491.75,696,695
10058,10363,5398,5675,305,277,57639,0,57639,1.0,10203.83,5533.43,10203.3,5533.02,697,696
8261,8743,5399,5862,482,463,114982,0,114982,1.0,8503.61,5629.7,8503.05,5629.12,698,697
6183,6361,5400,5647,178,247,20986,2139,18847,0.8980749070809111,6267.63,5530.88,6267.07,5530.05,699,698
4110,4293,5408,5610,183,202,19532,708,18824,0.9637517919311899,4191.09,5496.92,4190.47,5496.45,703,699
5583,5768,5408,5631,185,223,20781,1651,19130,0.9205524276983783,5669.07,5531.03,5668.47,5530.25,700,700
6582,6832,5410,5774,250,364,54823,0,54823,1.0,6698.64,5578.36,6698.16,5578.11,701,701
3410,3754,5411,5716,344,305,59819,0,59819,1.0,3579.27,5559.59,3578.86,5559.21,702,702
6284,6675,5412,5851,391,439,93180,568,92612,0.9939042713028546,6468.42,5666.48,6468.64,5665.34,705,703
12933,13186,5412,5632,253,220,39093,0,39093,1.0,13044.58,5520.15,13044.23,5519.61,704,704
10462,10822,5424,5827,360,403,104812,0,104812,1.0,10634.12,5622.34,10633.8,5621.78,706,705
7467,7740,5427,5742,273,315,46836,0,46836,1.0,7622.39,5595.93,7621.77,5595.35,707,706
2038,2523,5433,5818,485,385,94964,0,94964,1.0,2286.21,5612.61,2285.47,5612.51,709,707
11596,12071,5433,5899,475,466,130364,0,130364,1.0,11842.62,5669.78,11842.13,5669.24,708,708
13120,13393,5451,5808,273,357,44157,0,44157,1.0,13244.84,5599.68,13244.62,5599.82,710,709
6789,6980,5453,5659,191,206,24498,0,24498,1.0,6869.28,5559.31,6868.95,5558.74,711,710
11522,11769,5457,5712,247,255,32626,0,32626,1.0,11641.28,5576.72,11640.77,5576.32,712,711
9635,9773,5461,5673,138,212,12980,0,12980,1.0,9704.12,5570.78,9703.81,5570.21,713,712
10778,11039,5464,5727,261,263,45222,0,45222,1.0,10886.8,5581.51,10886.57,5580.91,714,713
8973,9127,5473,5691,154,218,17545,776,16769,0.955770874893132,9041.4,5572.49,9040.81,5572.19,715,714
3174,3622,5491,5961,448,470,122749,2560,120189,0.9791444329485373,3396.96,5712.61,3396.37,5712.19,716,715
4709,4995,5492,5790,286,298,53549,0,53549,1.0,4849.37,5640.35,4848.93,5639.82,717,716
11983,12365,5495,5879,382,384,73815,0,73815,1.0,12180.19,5692.93,12179.69,5692.31,718,717
5999,6310,5500,5861,311,361,67463,0,67463,1.0,6147.65,5676.1,6147.2,5675.66,719,718
8995,9255,5507,5735,260,228,33098,2170,30928,0.934437126110339,9148.95,5633.49,9147.94,5633.16,720,719
13654,14050,5508,5914,396,406,104566,1397,103169,0.9866400168314748,13852.36,5688.94,13851.89,5688.56,721,720
14022,14254,5517,5828,232,311,37697,442,37255,0.9882749290394461,14128.59,5679.31,14128.09,5678.71,722,721
10115,10484,5518,5936,369,418,92391,1741,90650,0.9811561732203353,10317.74,5745.23,10317.21,5744.47,724,722
2773,3084,5521,5716,311,195,32235,0,32235,1.0,2937.42,5624.7,2936.72,5624.24,723,723
14365,14557,5531,5749,192,218,23810,2004,21806,0.9158336833263335,14469.36,5645.96,14468.61,5645.67,725,724
12046,12187,5534,5645,141,111,8693,0,8693,1.0,12098.44,5582.05,12098.34,5581.56,726,725
8110,8370,5535,5884,260,349,55208,0,55208,1.0,8249.11,5698.21,8248.6,5697.85,727,726
4077,4413,5539,5889,336,350,72988,755,72233,0.989655833835699,4233.51,5738.05,4233.12,5737.36,728,727
5765,6151,5542,6048,386,506,103272,0,103272,1.0,5964.32,5793.01,5963.72,5792.45,729,728
12429,12747,5542,5904,318,362,81574,0,81574,1.0,12592.01,5733.33,12591.5,5732.79,730,729
14225,14416,5544,5723,191,179,21514,0,21514,1.0,14336.05,5637.63,14335.39,5637.1,731,730
12251,12479,5545,5891,228,346,45696,0,45696,1.0,12370.84,5726.15,12370.33,5725.56,732,731
15793,16392,5550,6261,599,711,224878,1001,223877,0.9955486975159864,16115.36,5875.85,16114.87,5875.62,733,732
6888,7161,5575,5836,273,261,39717,0,39717,1.0,7019.59,5705.78,7019.13,5705.22,734,733
5645,5805,5581,5762,160,181,16759,2386,14373,0.8576287367981383,5725.6,5678.81,5725.14,5678.09,735,734
3757,4078,5582,5815,321,233,40678,1416,39262,0.9651900290083092,3919.22,5697.48,3918.66,5696.86,736,735
16216,16734,5584,6261,518,677,160170,0,160170,1.0,16473.64,5921.85,16473.06,5921.4,737,736
7316,7744,5593,5988,428,395,95206,0,95206,1.0,7520.64,5791.94,7520.18,5791.32,738,737
11081,11604,5593,5973,523,380,134995,5523,129472,0.9590873736064298,11354.17,5769.13,11353.61,5768.68,739,738
7733,8003,5597,5848,270,251,36471,0,36471,1.0,7858.96,5706.53,7858.73,5706.36,740,739
9679,9878,5602,5829,199,227,24847,0,24847,1.0,9763.14,5713.48,9762.7,5713.12,741,740
1563,2104,5605,6099,541,494,149771,698,149073,0.9953395517156192,1844.58,5853.13,1844.17,5852.47,742,741
9875,10161,5605,5890,286,285,56547,3415,53132,0.9396077599165296,10025.41,5754.44,10024.85,5753.88,743,742
4928,5440,5609,6027,512,418,150588,5959,144629,0.9604284537944591,5187.17,5809.31,5186.64,5808.83,744,743
13263,13701,5611,5851,438,240,72201,0,72201,1.0,13471.42,5740.31,13471.02,5739.8,745,744
12918,13294,5617,5931,376,314,69190,3953,65237,0.9428674663968781,13084.54,5769.03,13084.29,5768.64,746,745
2938,3299,5638,5972,361,334,83095,6889,76206,0.9170948913893736,3112.33,5802.83,3111.88,5802.36,747,746
6691,7089,5642,6114,398,472,109186,0,109186,1.0,6899.26,5880.49,6898.72,5879.95,748,747
3604,3880,5644,5964,276,320,58275,0,58275,1.0,3742.95,5819.14,3742.37,5818.4,749,748
15520,15832,5647,6009,312,362,83239,0,83239,1.0,15684.29,5836.0,15683.75,5835.43,750,749
8658,9040,5657,6056,382,399,106911,4254,102657,0.9602098942110727,8848.08,5836.42,8847.56,5836.07,751,750
2536,2961,5660,6098,425,438,129645,5129,124516,0.9604381194801188,2756.48,5890.29,2755.99,5889.75,752,751
8002,8277,5661,5948,275,287,33095,0,33095,1.0,8126.52,5810.26,8126.15,5809.68,753,752
14477,14859,5669,5856,382,187,43858,1644,42214,0.9625153905786857,14660.7,5750.7,14660.26,5750.12,754,753
10777,11087,5674,5853,310,179,25998,0,25998,1.0,10924.5,5767.98,10924.28,5767.5,756,754
2102,2401,5675,5860,299,185,31083,0,31083,1.0,2272.0,5776.88,2271.2,5776.39,755,755
9155,9547,5681,6103,392,422,103097,3411,99686,0.9669146531906845,9342.02,5866.7,9341.52,5866.35,757,756
14188,14377,5687,5832,189,145,16914,0,16914,1.0,14281.59,5767.74,14281.07,5767.14,758,757
7045,7485,5690,6292,440,602,177573,5613,171960,0.9683904647666031,7244.03,5988.73,7243.63,5988.28,759,758
4556,5093,5693,6133,537,440,139503,0,139503,1.0,4804.69,5911.63,4804.48,5911.25,760,759
3862,4136,5695,5945,274,250,33313,0,33313,1.0,3999.49,5845.39,3999.1,5844.57,761,760
8992,9187,5713,5963,195,250,35057,2004,33053,0.9428359528767436,9090.46,5844.11,9089.95,5843.65,762,761
15125,15532,5718,6009,407,291,63221,2602,60619,0.9588427895794119,15287.15,5835.44,15287.07,5835.06,763,762
14301,14867,5719,6124,566,405,132097,59,132038,0.9995533585168475,14561.2,5933.78,14561.15,5932.62,764,763
10395,10623,5721,5987,228,266,33300,1392,31908,0.9581981981981982,10522.23,5868.14,10521.48,5867.44,765,764
8282,8455,5726,5983,173,257,25014,0,25014,1.0,8382.26,5851.11,8381.73,5850.76,766,765
14855,15204,5732,6240,349,508,126484,8833,117651,0.9301650801682426,15021.39,5985.7,15020.83,5984.92,767,766
5647,5982,5736,6003,335,267,42211,1470,40741,0.9651749543957736,5786.36,5864.88,5786.52,5864.87,768,767
7911,8152,5737,6075,241,338,39651,0,39651,1.0,8037.6,5910.88,8036.98,5910.21,769,768
13934,14205,5742,5980,271,238,43946,0,43946,1.0,14063.55,5864.23,14063.09,5863.7,770,769
7625,8031,5744,6191,406,447,113601,0,113601,1.0,7833.09,5979.71,7832.53,5979.14,772,770
9693,10001,5744,6034,308,290,44600,0,44600,1.0,9868.89,5887.61,9868.2,5886.98,771,771
14744,14885,5751,5990,141,239,20447,2007,18440,0.9018437912652223,14825.24,5896.87,14824.84,5895.82,773,772
4341,4580,5756,5962,239,206,35570,0,35570,1.0,4462.67,5869.17,4462.12,5868.61,774,773
2339,2569,5761,6073,230,312,46161,2114,44047,0.9542037650830788,2442.07,5929.2,2441.44,5928.63,776,774
8433,8755,5761,6112,322,351,63251,0,63251,1.0,8579.57,5953.2,8579.09,5952.6,775,775
10603,10847,5762,6026,244,264,39824,212,39612,0.9946765769385295,10717.13,5893.24,10716.78,5892.68,777,776
6512,6875,5763,6188,363,425,94480,0,94480,1.0,6671.91,5995.79,6671.53,5995.11,778,777
6148,6559,5765,6152,411,387,118334,7894,110440,0.9332905166731456,6344.78,5962.26,6344.58,5961.76,779,778
11805,12116,5765,6131,311,366,72677,0,72677,1.0,11968.58,5942.77,11968.04,5942.32,780,779
12676,12819,5766,5928,143,162,13341,1224,12117,0.908252754666067,12748.32,5855.92,12747.84,5855.19,781,780
13666,13840,5771,5972,174,201,18164,1956,16208,0.8923144681788152,13748.63,5866.63,13748.23,5866.32,782,781
11041,11289,5791,6106,248,315,42236,0,42236,1.0,11140.12,5953.8,11139.71,5953.19,783,782
11404,11822,5793,6215,418,422,94405,3895,90510,0.9587415920766909,11632.74,5992.43,11632.1,5991.98,784,783
12753,13181,5799,6223,428,424,122440,0,122440,1.0,12958.35,6020.55,12957.93,6020.04,785,784
15300,15687,5800,6188,387,388,83180,0,83180,1.0,15479.28,6010.21,15478.92,6009.58,786,785
10684,11085,5807,6216,401,409,106150,0,106150,1.0,10912.85,6020.27,10912.11,6019.77,787,786
5365,5572,5813,6054,207,241,26818,2291,24527,0.9145723021850996,5479.55,5936.68,5478.83,5936.2,788,787
13123,13421,5816,6179,298,363,65340,0,65340,1.0,13265.33,6010.97,13264.84,6010.37,789,788
1955,2371,5819,6207,416,388,106772,27,106745,0.9997471247143446,2168.05,5991.01,2167.51,5990.63,790,789
13296,13763,5819,6182,467,363,106225,7723,98502,0.9272958343139562,13548.36,5974.08,13547.65,5973.58,791,790
12238,12382,5828,5995,144,167,14368,0,14368,1.0,12295.92,5900.09,12295.58,5899.77,792,791
14125,14386,5828,6017,261,189,27141,1018,26123,0.9624921705169301,14256.61,5925.3,14256.15,5925.06,793,792
9476,9870,5834,6228,394,394,105656,1033,104623,0.9902229878094949,9690.91,6040.35,9690.14,6039.53,794,793
12097,12276,5838,6019,179,181,17717,0,17717,1.0,12179.52,5920.91,12179.12,5920.99,795,794
5503,5774,5847,6195,271,348,51611,2419,49192,0.9531301466741586,5644.54,6013.36,5644.1,6013.03,796,795
9989,10254,5849,6032,265,183,30237,1228,29009,0.9593875053742104,10122.04,5941.7,10121.66,5941.2,797,796
3333,3682,5855,6308,349,453,115458,6125,109333,0.9469504062083182,3516.74,6080.41,3516.2,6079.91,798,797
3982,4393,5856,6303,411,447,100638,0,100638,1.0,4171.67,6034.72,4171.28,6034.51,799,798
12277,12583,5864,6206,306,342,60674,0,60674,1.0,12419.15,6018.46,12418.67,6018.06,800,799
3123,3373,5865,6134,250,269,45601,3045,42556,0.9332251485713032,3258.96,6013.82,3258.41,6013.14,801,800
15576,16040,5868,6441,464,573,159550,0,159550,1.0,15819.61,6162.49,15819.14,6162.09,802,801
12523,12764,5871,6051,241,180,22433,1157,21276,0.9484241964962332,12661.55,5950.54,12660.84,5950.13,803,802
1472,1936,5883,6312,464,429,111087,474,110613,0.9957330740770747,1666.14,6129.15,1665.71,6128.54,804,803
8075,8462,5884,6312,387,428,90188,0,90188,1.0,8284.76,6071.53,8284.16,6071.35,805,804
10211,10562,5888,6209,351,321,76996,4702,72294,0.9389318925658475,10380.08,6050.07,10379.63,6049.59,806,805
3750,4019,5899,6278,269,379,52133,1434,50699,0.9724934302648994,3891.14,6066.71,3890.56,6066.31,807,806
2837,3144,5905,6194,307,289,53674,0,53674,1.0,2998.77,6047.63,2998.16,6047.16,808,807
13705,14056,5909,6166,351,257,57143,0,57143,1.0,13883.65,6034.07,13883.01,6033.73,809,808
5745,5919,5933,6102,174,169,18531,1125,17406,0.939290917921321,5818.35,6015.17,5818.08,6014.66,810,809
8972,9309,5933,6244,337,311,75300,4469,70831,0.9406507304116866,9143.99,6088.94,9143.47,6088.48,811,810
4264,4779,5941,6299,515,358,114209,4646,109563,0.9593201936800078,4494.44,6111.89,4494.15,6111.42,812,811
8812,9032,5949,6106,220,157,18764,2132,16632,0.886378170965679,8933.22,6030.63,8932.58,6030.06,813,812
11082,11528,5953,6347,446,394,105462,4841,100621,0.9540972103696118,11284.88,6143.81,11284.54,6143.3,814,813
3590,3842,5959,6361,252,402,60078,0,60078,1.0,3723.65,6168.3,3723.04,6167.9,815,814
9944,10298,5962,6517,354,555,128994,2235,126759,0.9826736127261733,10128.99,6246.94,10128.27,6246.21,816,815
10484,10857,5965,6552,373,587,133304,55,133249,0.9995874092300306,10662.88,6260.18,10662.32,6259.68,817,816
13980,14314,5969,6366,334,397,105302,5563,99739,0.9471709939032497,14153.97,6170.1,14153.47,6169.49,818,817
4946,5359,5971,6531,413,560,132529,4158,128371,0.9686257347448483,5150.16,6252.82,5149.66,6252.28,819,818
7378,7721,5978,6304,343,326,82033,0,82033,1.0,7544.41,6128.77,7543.9,6128.38,820,819
11960,12332,5978,6336,372,358,93448,0,93448,1.0,12148.84,6162.93,12148.29,6162.5,821,820
15065,15339,5980,6329,274,349,51170,1046,50124,0.9795583349618917,15216.14,6166.42,15215.73,6165.69,822,821
5828,6126,5986,6312,298,326,52823,1123,51700,0.9787403214508832,5998.56,6128.82,5998.04,6128.56,823,822
8446,8747,5986,6221,301,235,25402,0,25402,1.0,8566.28,6114.26,8566.68,6113.22,824,823
5219,5692,5989,6372,473,383,116444,582,115862,0.9950018893201883,5445.44,6181.8,5444.97,6181.3,825,824
14737,14936,5989,6285,199,296,26017,87,25930,0.9966560325940731,14837.45,6129.8,14836.97,6129.56,826,825
11668,11983,5997,6366,315,369,67873,0,67873,1.0,11843.23,6194.04,11842.61,6193.45,827,826
14277,14421,5998,6191,144,193,19320,0,19320,1.0,14356.46,6097.74,14355.68,6096.83,829,827
12371,12797,5999,6351,426,352,98470,6870,91600,0.9302325581395349,12594.18,6175.72,12593.56,6175.25,828,828
6083,6308,6009,6356,225,347,39728,0,39728,1.0,6180.54,6186.15,6179.9,6185.44,830,829
9864,10007,6014,6182,143,168,17944,1876,16068,0.8954525189478377,9928.0,6096.2,9927.57,6095.73,831,830
2351,2536,6017,6138,185,121,10974,0,10974,1.0,2448.21,6075.02,2447.54,6074.43,832,831
9294,9600,6017,6323,306,306,66272,0,66272,1.0,9448.25,6173.73,9447.76,6173.2,833,832
8676,8881,6037,6279,205,242,35892,0,35892,1.0,8783.12,6167.54,8782.68,6167.0,834,833
2476,2593,6041,6181,117,140,8937,0,8937,1.0,2529.34,6112.3,2528.95,6111.74,835,834
6846,7060,6042,6225,214,183,22684,1102,21582,0.951419502733204,6944.63,6146.94,6944.07,6146.19,836,835
15261,15391,6049,6187,130,138,10423,0,10423,1.0,15323.06,6121.98,15322.63,6121.41,837,836
4571,5022,6053,6509,451,456,133931,2973,130958,0.9778020025236875,4806.97,6299.24,4806.49,6298.58,838,837
13278,13608,6059,6330,330,271,49555,0,49555,1.0,13458.31,6199.5,13457.65,6198.94,839,838
14229,14830,6060,6471,601,411,149596,7740,141856,0.948260648680446,14529.92,6276.77,14529.38,6276.11,840,839
2288,2536,6068,6401,248,333,47632,2132,45500,0.9552401746724891,2402.02,6229.98,2401.56,6229.48,841,840
7931,8241,6068,6578,310,510,74322,518,73804,0.993030327493878,8069.86,6279.38,8069.23,6279.44,842,841
2502,2984,6072,6388,482,316,109351,4036,105315,0.9630913297546433,2756.93,6224.83,2756.33,6224.36,843,842
1884,2201,6074,6383,317,309,55442,3016,52426,0.9456008080516576,2051.46,6218.29,2050.95,6217.91,844,843
1339,1508,6075,6300,169,225,22488,221,22267,0.9901725364638918,1435.88,6212.26,1435.32,6211.38,845,844
2967,3439,6077,6482,472,405,127658,7209,120449,0.9435288035219102,3189.01,6287.89,3188.55,6287.36,846,845
3859,4090,6085,6356,231,271,30507,1469,29038,0.951847117055102,3993.48,6219.87,3992.52,6219.63,847,846
5688,5923,6086,6214,235,128,19356,0,19356,1.0,5800.49,6162.82,5800.04,6162.3,848,847
15847,16331,6086,6918,484,832,218616,949,217667,0.9956590551469243,16103.1,6538.06,16102.43,6537.23,851,848
8863,9022,6087,6316,159,229,20697,2150,18547,0.8961202106585495,8928.15,6182.97,8927.7,6182.93,849,849
13890,14006,6088,6212,116,124,7687,1129,6558,0.8531286587745545,13955.92,6148.46,13955.36,6147.97,850,850
7673,7841,6090,6240,168,150,13962,0,13962,1.0,7749.9,6185.02,7749.43,6184.12,852,851
11276,11683,6102,6518,407,416,102915,5289,97626,0.9486080746246903,11493.71,6321.56,11493.13,6320.97,853,852
6256,6769,6109,6571,513,462,157936,122,157814,0.9992275352041333,6504.94,6317.28,6504.5,6316.94,854,853
10815,11110,6114,6432,295,318,46301,904,45397,0.9804755836806981,10961.76,6280.33,10961.6,6279.68,855,854
6710,6906,6118,6329,196,211,22472,1159,21313,0.9484247063011748,6817.05,6218.66,6816.31,6218.17,856,855
13615,13812,6119,6266,197,147,14953,0,14953,1.0,13715.69,6183.42,13715.16,6183.0,857,856
8297,8755,6120,6777,458,657,162703,0,162703,1.0,8549.36,6409.92,8548.83,6409.7,858,857
15266,15476,6135,6555,210,420,51022,1442,49580,0.9717376817843283,15374.3,6343.9,15373.88,6343.39,859,858
12940,13367,6136,6497,427,361,102803,3345,99458,0.9674620390455532,13146.43,6329.28,13146.03,6328.71,860,859
2178,2301,6141,6317,123,176,15436,0,15436,1.0,2244.48,6238.31,2244.02,6237.55,861,860
13671,14032,6154,6499,361,345,85983,0,85983,1.0,13862.88,6335.27,13862.27,6334.72,863,861
12699,12991,6155,6517,292,362,61169,0,61169,1.0,12864.99,6310.76,12864.44,6310.6,862,862
9801,10000,6156,6356,199,200,27160,1243,25917,0.9542341678939618,9911.38,6259.69,9910.72,6259.09,864,863
4189,4394,6161,6389,205,228,25161,297,24864,0.9881960176463574,4275.52,6284.5,4275.17,6283.9,866,864
6861,7261,6161,6510,400,349,61676,0,61676,1.0,7077.78,6316.75,7077.18,6316.36,865,865
9198,9382,6164,6413,184,249,21155,0,21155,1.0,9295.73,6288.74,9295.12,6288.17,867,866
9579,9872,6174,6418,293,244,37945,0,37945,1.0,9725.22,6302.66,9724.53,6302.02,871,867
10279,10518,6174,6461,239,287,55646,6096,49550,0.8904503468353521,10395.25,6316.94,10394.79,6316.44,869,868
13566,13721,6174,6347,155,173,13401,0,13401,1.0,13641.81,6264.57,13641.37,6264.08,870,869
15430,15680,6174,6423,250,249,23164,0,23164,1.0,15550.44,6273.73,15550.36,6273.94,868,870
7828,7993,6184,6343,165,159,16999,0,16999,1.0,7909.95,6260.33,7909.49,6259.89,872,871
1734,1953,6197,6589,219,392,53309,0,53309,1.0,1842.64,6392.02,1842.1,6391.57,873,872
12189,12463,6198,6545,274,347,63334,4804,58530,0.9241481668614014,12321.76,6379.13,12321.3,6378.53,874,873
8913,9295,6201,6552,382,351,86474,0,86474,1.0,9109.57,6369.17,9109.0,6368.69,875,874
7639,7871,6203,6394,232,191,25362,0,25362,1.0,7765.68,6303.58,7765.18,6302.84,876,875
14886,15199,6207,6484,313,277,35564,2045,33519,0.9424980317174672,15062.75,6330.16,15062.19,6329.68,877,876
5552,6125,6209,6508,573,299,121722,0,121722,1.0,5828.98,6355.38,5828.52,6354.94,878,877
7253,7469,6210,6361,216,151,18362,2139,16223,0.8835094216316305,7370.34,6299.86,7369.77,6299.23,879,878
12434,12805,6212,6557,371,345,64364,0,64364,1.0,12604.4,6427.52,12604.45,6426.54,900,879
7432,7748,6236,6508,316,272,45762,0,45762,1.0,7595.52,6379.16,7595.13,6378.34,881,880
3968,4201,6237,6417,233,180,21003,1660,19343,0.9209636718564015,4104.45,6319.52,4103.29,6319.21,880,881
11585,11878,6246,6557,293,311,47431,3979,43452,0.9161097172735131,11729.04,6407.56,11728.48,6407.02,882,882
9500,9779,6250,6655,279,405,61282,0,61282,1.0,9654.32,6477.32,9653.46,6476.23,884,883
1921,2284,6251,6646,363,395,65963,914,65049,0.9861437472522475,2116.24,6426.72,2115.7,6426.47,883,884
3669,3927,6258,6464,258,206,36426,2543,33883,0.9301872289024323,3801.71,6365.25,3801.15,6364.75,886,885
4418,4584,6258,6376,166,118,13560,0,13560,1.0,4508.0,6316.43,4507.4,6315.94,885,886
8092,8546,6260,6790,454,530,134725,0,134725,1.0,8300.16,6531.88,8300.02,6531.7,887,887
1270,1773,6261,6670,503,409,146056,3644,142412,0.9750506654981651,1534.11,6454.95,1533.64,6454.48,888,888
8702,9100,6266,6817,398,551,138277,0,138277,1.0,8886.47,6535.0,8886.01,6534.54,889,889
13200,13719,6266,6753,519,487,143180,0,143180,1.0,13452.06,6502.08,13451.52,6501.51,890,890
2182,2443,6267,6858,261,591,87496,1872,85624,0.9786047362165128,2315.97,6605.23,2315.57,6603.68,891,891
6125,6382,6267,6598,257,331,37825,1133,36692,0.9700462656972901,6253.75,6435.53,6253.31,6434.94,893,892
14812,15127,6268,6662,315,394,73621,3666,69955,0.950204425367762,14976.03,6471.02,14975.28,6470.31,892,893
10970,11396,6283,6675,426,392,113369,8020,105349,0.9292575571805344,11190.04,6489.36,11189.48,6488.79,895,894
15142,15304,6283,6513,162,230,19391,0,19391,1.0,15231.36,6388.61,15230.78,6388.18,894,895
2403,2753,6285,6722,350,437,105706,5546,100160,0.9475337256163321,2558.15,6494.78,2557.67,6494.34,896,896
14569,14882,6287,6561,313,274,53419,0,53419,1.0,14751.5,6435.8,14750.74,6435.18,897,897
15422,15859,6289,6706,437,417,83695,0,83695,1.0,15602.74,6529.3,15602.41,6528.74,898,898
3387,3631,6290,6478,244,188,27357,0,27357,1.0,3501.61,6377.76,3501.44,6377.42,899,899
4261,4835,6298,6687,574,389,119548,4483,115065,0.962500418242045,4527.73,6499.93,4527.35,6499.39,901,900
6562,7127,6299,6739,565,440,161006,6428,154578,0.960076022011602,6863.46,6524.49,6862.74,6524.12,902,901
7810,8011,6305,6660,201,355,42751,0,42751,1.0,7917.62,6475.58,7917.08,6475.13,903,902
9293,9573,6307,6570,280,263,49842,0,49842,1.0,9452.75,6439.5,9452.03,6438.94,904,903
11732,12226,6312,6753,494,441,164884,6818,158066,0.9586497173770651,11992.35,6538.92,11991.78,6538.4,905,904
3890,4093,6324,6543,203,219,25339,0,25339,1.0,3994.83,6422.4,3994.34,6422.08,906,905
14012,14263,6324,6612,251,288,49347,0,49347,1.0,14133.66,6470.61,14133.09,6470.02,907,906
15642,15893,6329,6635,251,306,53397,0,53397,1.0,15780.68,6475.85,15780.12,6475.37,908,907
4007,4340,6334,6675,333,341,62295,1421,60874,0.9771891805120796,4173.58,6518.78,4173.13,6518.16,909,908
7121,7593,6342,6777,472,435,139877,6704,133173,0.9520721776989783,7348.55,6549.98,7348.06,6549.52,910,909
9744,10141,6346,6745,397,399,114031,3802,110229,0.9666581894397137,9938.7,6556.04,9938.29,6555.6,912,910
2725,3030,6347,6659,305,312,56008,0,56008,1.0,2869.23,6477.36,2868.8,6477.12,911,911
3562,3701,6352,6539,139,187,16141,1345,14796,0.9166718295025091,3631.92,6444.57,3631.41,6444.1,914,912
5368,5562,6352,6482,194,130,13295,253,13042,0.9809702895825498,5483.22,6401.45,5481.85,6401.06,913,913
5204,5444,6354,6571,240,217,22313,0,22313,1.0,5337.21,6468.71,5336.33,6468.28,915,914
10769,11029,6371,6642,260,271,33631,0,33631,1.0,10883.51,6492.74,10883.33,6492.57,916,915
5790,6303,6375,6800,513,425,113238,2879,110359,0.9745756724774369,6058.37,6580.08,6057.68,6579.63,917,916
7657,7839,6391,6521,182,130,14741,0,14741,1.0,7766.19,6461.76,7765.29,6461.32,918,917
10424,10678,6396,6647,254,251,43338,0,43338,1.0,10541.09,6529.78,10540.65,6529.23,919,918
15880,16044,6401,6610,164,209,28743,0,28743,1.0,15959.3,6510.49,15958.82,6509.92,920,919
4820,5198,6403,6747,378,344,81420,0,81420,1.0,5010.67,6571.07,5010.16,6570.57,921,920
3144,3629,6413,6784,485,371,122785,3388,119397,0.972407052978784,3377.65,6585.08,3377.15,6584.57,922,921
10175,10324,6416,6581,149,165,13073,1366,11707,0.895509829419414,10260.7,6503.45,10260.05,6502.9,923,922
1763,2079,6427,6852,316,425,78104,0,78104,1.0,1940.14,6641.88,1939.55,6641.29,925,923
9222,9457,6427,6657,235,230,22653,0,22653,1.0,9343.63,6544.67,9343.01,6544.09,926,924
14178,14451,6427,6771,273,344,62043,230,61813,0.9962928936382831,14327.93,6589.84,14327.51,6589.53,924,925
5431,5607,6434,6566,176,132,12786,1829,10957,0.8569529172532457,5517.1,6494.76,5516.67,6494.32,927,926
12629,12894,6434,6687,265,253,46254,0,46254,1.0,12768.48,6561.81,12767.91,6561.31,928,927
12887,13328,6434,6639,441,205,50347,767,49580,0.9847657258625141,13087.54,6536.52,13087.37,6535.86,929,928
3553,4114,6443,6814,561,371,109230,2468,106762,0.9774054746864415,3842.85,6606.86,3842.18,6606.65,930,929
13613,14063,6443,6710,450,267,74062,0,74062,1.0,13855.12,6575.09,13854.37,6574.49,931,930
2861,3241,6447,6897,380,450,117954,6721,111233,0.9430201604015125,3043.75,6686.55,3043.31,6685.99,932,931
15089,15299,6448,6679,210,231,25576,1502,24074,0.9412730685017203,15178.32,6560.68,15178.28,6560.34,933,932
10279,10452,6450,6677,173,227,25171,0,25171,1.0,10370.91,6560.7,10370.45,6560.19,934,933
14432,14785,6454,6845,353,391,95561,5840,89721,0.9388872029384372,14589.96,6642.83,14589.57,6642.42,935,934
12180,12498,6468,6707,318,239,43514,0,43514,1.0,12340.25,6596.25,12339.77,6595.61,936,935
11364,11753,6469,6782,389,313,82070,0,82070,1.0,11567.69,6627.05,11567.0,6626.47,937,936
15270,15392,6473,6610,122,137,9955,804,9151,0.9192365645404319,15323.12,6549.3,15322.69,6548.64,938,937
5462,5930,6483,6901,468,418,125013,0,125013,1.0,5705.15,6679.84,5704.68,6679.31,942,938
2056,2182,6484,6635,126,151,11690,0,11690,1.0,2127.24,6559.93,2126.32,6559.6,939,939
5277,5490,6488,6648,213,160,22430,2206,20224,0.9016495764600981,5392.27,6574.03,5391.69,6573.45,940,940
7508,7928,6490,6809,420,319,87006,485,86521,0.9944256717927499,7723.05,6645.07,7722.47,6644.62,941,941
10675,10859,6492,6683,184,191,21268,0,21268,1.0,10771.19,6593.91,10770.63,6593.3,943,942
7955,8338,6507,6879,383,372,74601,62,74539,0.9991689119448801,8138.98,6715.49,8138.58,6714.87,944,943
15387,15531,6510,6672,144,162,14662,0,14662,1.0,15457.76,6593.27,15457.26,6592.74,945,944
10115,10380,6513,6860,265,347,59448,0,59448,1.0,10247.8,6700.73,10247.17,6700.01,946,945
6292,6711,6516,6868,419,352,99147,487,98660,0.9950881015058448,6487.0,6691.42,6486.6,6690.93,947,946
9016,9393,6518,6934,377,416,107324,4592,102732,0.9572136707539786,9211.29,6726.45,9210.71,6725.99,948,947
10858,11493,6519,6907,635,388,124829,0,124829,1.0,11164.09,6730.36,11163.65,6729.92,949,948
14740,14950,6519,6725,210,206,22732,7,22725,0.9996920640506775,14851.47,6633.19,14850.87,6632.23,952,949
5025,5386,6525,6919,361,394,70604,1725,68879,0.9755679564897173,5225.3,6744.6,5224.67,6743.96,950,950
2552,2863,6534,6800,311,266,50799,0,50799,1.0,2715.62,6685.03,2714.99,6684.4,951,951
12396,12674,6548,6767,278,219,37412,1971,35441,0.9473163690794397,12529.44,6654.49,12528.99,6654.07,953,952
4127,4515,6558,6969,388,411,94719,0,94719,1.0,4340.16,6761.33,4339.46,6760.74,954,953
9374,9652,6564,6917,278,353,69359,0,69359,1.0,9514.59,6733.31,9514.09,6732.83,955,954
8544,8802,6574,6867,258,293,33063,0,33063,1.0,8696.97,6725.5,8696.1,6725.15,956,955
13444,13974,6575,6916,530,341,95440,0,95440,1.0,13726.76,6752.58,13725.84,6751.88,958,956
15101,15469,6575,6935,368,360,50647,2799,47848,0.9447351274507868,15258.53,6755.98,15258.54,6755.81,959,957
10589,10768,6576,6738,179,162,13235,0,13235,1.0,10674.55,6656.26,10674.19,6655.81,957,958
13947,14240,6576,6809,293,233,37650,937,36713,0.9751128818061089,14080.68,6699.19,14080.39,6698.59,960,959
4773,4961,6580,6777,188,197,19760,1310,18450,0.9337044534412956,4856.7,6691.11,4856.3,6690.41,962,960
1378,1737,6581,6951,359,370,63398,1977,61421,0.9688160509795262,1545.84,6727.6,1545.45,6727.27,961,961
1306,1544,6583,6889,238,306,14731,666,14065,0.9547892200122191,1364.23,6690.99,1367.7,6694.55,964,962
15295,15480,6583,6836,185,253,30769,1356,29413,0.955929669472521,15378.25,6712.48,15378.0,6711.97,963,963
12913,13217,6588,6781,304,193,37624,0,37624,1.0,13054.23,6681.94,13053.98,6681.43,965,964
5285,5687,6599,6979,402,380,72972,210,72762,0.9971221838513402,5471.89,6808.75,5471.16,6807.96,966,965
16218,16401,6605,6855,183,250,28284,0,28284,1.0,16296.54,6734.28,16296.17,6733.75,967,966
12695,12932,6608,6785,237,177,25019,0,25019,1.0,12826.68,6704.25,12825.89,6703.73,968,967
1542,1862,6610,7182,320,572,88914,5993,82921,0.9325977911240074,1715.13,6887.57,1714.51,6887.24,969,968
4490,4949,6611,6923,459,312,83010,1113,81897,0.9865919768702566,4675.1,6769.72,4675.35,6769.24,970,969
2006,2210,6614,6852,204,238,32774,1239,31535,0.9621956428876548,2122.14,6742.44,2121.39,6742.06,971,970
9608,9891,6615,7056,283,441,87238,279,86959,0.996801852403769,9745.49,6847.72,9744.99,6847.09,973,971
6884,7262,6617,6991,378,374,77142,0,77142,1.0,7071.9,6786.96,7071.29,6786.69,972,972
10365,10660,6624,6952,295,328,76541,0,76541,1.0,10509.37,6786.36,10508.88,6785.88,974,973
14921,15128,6636,6802,207,166,20030,950,19080,0.9525711432850724,15037.94,6709.0,15037.42,6708.79,975,974
15456,15858,6643,6865,402,222,42361,0,42361,1.0,15601.5,6747.32,15601.8,6746.83,976,975
6147,6345,6651,6840,198,189,20516,0,20516,1.0,6254.57,6758.91,6254.02,6758.17,977,976
7795,8042,6657,6896,247,239,30920,1627,29293,0.9473803363518758,7934.52,6776.53,7933.95,6776.21,978,977
3896,4228,6660,6972,332,312,70831,606,70225,0.9914444240516158,4073.19,6827.46,4072.68,6826.9,979,978
12478,12739,6660,6853,261,193,26278,0,26278,1.0,12605.78,6764.74,12605.55,6764.17,980,979
13358,13655,6666,6973,297,307,44125,869,43256,0.9803059490084985,13507.8,6815.55,13507.37,6815.14,981,980
14647,15132,6668,7024,485,356,102556,1546,101010,0.9849253090994189,14874.87,6855.54,14874.52,6854.94,982,981
3517,3909,6670,7120,392,450,119140,5437,113703,0.9543646130602652,3714.81,6882.0,3714.48,6881.65,983,982
12132,12340,6671,6893,208,222,33696,0,33696,1.0,12229.81,6787.39,12229.38,6786.88,984,983
12294,12486,6672,6842,192,170,17509,2395,15114,0.863213204637615,12374.73,6762.29,12374.55,6761.68,988,984
10644,11014,6673,7039,370,366,94714,4593,90121,0.9515066410456744,10827.74,6852.86,10827.25,6852.38,985,985
11656,11855,6673,6811,199,138,16875,0,16875,1.0,11759.26,6757.12,11758.68,6756.48,987,986
11975,12178,6673,6871,203,198,19109,0,19109,1.0,12067.89,6791.18,12068.04,6789.9,986,987
6702,6917,6675,6906,215,231,26444,0,26444,1.0,6823.02,6772.93,6822.69,6772.93,989,988
7408,7663,6684,6814,255,130,20749,903,19846,0.95647983035327,7524.19,6756.39,7524.0,6755.99,990,989
12916,13368,6695,7020,452,325,94026,0,94026,1.0,13160.8,6857.33,13160.07,6856.65,991,990
2296,2632,6696,7070,336,374,78179,0,78179,1.0,2474.79,6888.04,2474.14,6887.64,992,991
9852,10233,6697,7039,381,342,84398,4671,79727,0.9446550866134269,10049.36,6862.2,10048.7,6861.6,993,992
3194,3569,6702,7075,375,373,84598,6683,77915,0.9210028605877207,3406.51,6891.16,3405.85,6890.42,994,993
14081,14475,6711,7095,394,384,103157,6611,96546,0.9359132196554766,14272.82,6882.09,14272.3,6881.77,995,994
5743,6208,6730,7076,465,346,98497,6913,91584,0.9298151212727291,5983.89,6894.74,5983.25,6894.33,996,995
4866,4994,6737,6940,128,203,13946,1379,12567,0.9011186003155026,4931.27,6844.46,4930.82,6843.87,997,996
4873,5224,6738,7256,351,518,119996,6937,113059,0.9421897396579886,5053.88,7019.08,5053.25,7018.35,998,997
11473,11679,6738,6959,206,221,22086,2347,19739,0.8937335868876212,11572.23,6837.03,11571.93,6836.93,1000,998
8306,8619,6744,7046,313,302,49669,3067,46602,0.9382512230969015,8456.75,6880.71,8456.61,6880.52,999,999
2553,2981,6748,7185,428,437,118069,4998,113071,0.957668820774293,2758.31,6962.72,2757.88,6962.3,1001,1000
11839,11986,6748,6860,147,112,13155,0,13155,1.0,11916.25,6799.31,11915.64,6798.89,1002,1001
7252,7468,6752,6980,216,228,26648,2317,24331,0.9130516361453017,7352.69,6844.83,7352.33,6844.56,1003,1002
12428,12999,6755,7174,571,419,139278,1267,138011,0.9909030859145019,12700.52,6946.84,12700.04,6946.39,1004,1003
12284,12521,6757,6980,237,223,22733,0,22733,1.0,12405.73,6885.49,12405.57,6884.41,1006,1004
15595,15879,6759,7043,284,284,53998,0,53998,1.0,15729.45,6882.03,15728.97,6881.65,1005,1005
6566,6983,6760,7166,417,406,95132,0,95132,1.0,6785.01,6963.8,6784.43,6963.25,1007,1006
1349,1543,6766,6975,194,209,26941,4160,22781,0.8455885082216695,1436.47,6879.57,1436.0,6878.99,1008,1007
8666,8930,6766,7118,264,352,50374,226,50148,0.9955135585818081,8801.19,6909.48,8801.16,6909.56,1009,1008
13933,14106,6769,7004,173,235,30962,1802,29160,0.9417996253471997,14021.89,6896.83,14021.32,6896.18,1011,1009
16211,16485,6771,7275,274,504,61328,0,61328,1.0,16358.87,7022.1,16358.08,7021.87,1010,1010
8881,9145,6774,7160,264,386,71833,857,70976,0.9880695502067295,9005.3,6965.56,9004.8,6965.1,1012,1011
14462,14648,6781,6893,186,112,15323,0,15323,1.0,14552.55,6837.58,14552.01,6837.0,1013,1012
11642,11888,6785,6978,246,193,31269,0,31269,1.0,11757.45,6880.93,11757.15,6880.53,1014,1013
8537,8689,6788,6995,152,207,19477,0,19477,1.0,8609.72,6896.58,8609.2,6895.99,1015,1014
6309,6486,6791,6957,177,166,18604,1797,16807,0.9034078692754246,6392.65,6876.42,6392.22,6875.85,1016,1015
1668,2364,6794,7885,696,1091,371228,9596,361632,0.9741506567392546,2021.39,7352.26,2021.07,7351.97,1017,1016
7673,8009,6794,6965,336,171,33014,1032,31982,0.9687405343187738,7847.52,6884.45,7846.77,6883.77,1018,1017
15127,15324,6797,7014,197,217,23867,1484,22383,0.9378220974567394,15203.97,6892.11,15203.77,6891.91,1019,1018
1911,2375,6798,7100,464,302,69361,0,69361,1.0,2177.37,6937.81,2176.16,6936.78,1022,1019
16022,16319,6798,7174,297,376,61008,0,61008,1.0,16202.47,6973.96,16201.72,6973.53,1020,1020
7340,7787,6800,7141,447,341,110019,5693,104326,0.9482543924231269,7577.91,6971.62,7577.27,6971.13,1021,1021
15708,16224,6801,7441,516,640,185010,2964,182046,0.9839792443651695,15952.96,7142.36,15952.47,7141.74,1023,1022
7997,8504,6809,7232,507,423,125470,2106,123364,0.9832151111819558,8254.39,7019.56,8253.8,7019.04,1024,1023
13197,13552,6825,7208,355,383,70973,0,70973,1.0,13349.48,7018.39,13349.24,7017.75,1025,1024
15447,15642,6827,7106,195,279,34073,33,34040,0.999031491210049,15542.13,6957.65,15541.65,6957.28,1026,1025
6137,6347,6829,7046,210,217,29727,1022,28705,0.9656204796985906,6240.49,6930.92,6240.0,6930.52,1027,1026
9103,9533,6831,7182,430,351,107914,5344,102570,0.950479085197472,9322.47,7019.75,9321.96,7019.19,1029,1027
11868,12219,6831,7094,351,263,55460,0,55460,1.0,12020.32,6946.31,12020.14,6945.75,1028,1028
15338,15489,6831,7042,151,211,16692,1443,15249,0.9135514018691588,15420.93,6957.55,15420.65,6956.32,1030,1029
10906,11343,6837,7208,437,371,107366,0,107366,1.0,11141.16,7004.02,11140.51,7003.63,1031,1030
2916,3318,6838,7178,402,340,87954,6946,81008,0.9210269004252223,3124.16,7004.01,3123.59,7003.6,1032,1031
16435,16545,6847,7017,110,170,9098,0,9098,1.0,16495.42,6940.24,16494.5,6939.16,1035,1032
10089,10470,6848,7174,381,326,63891,679,63212,0.9893725250817799,10297.21,6995.16,10296.48,6994.95,1033,1033
6975,7394,6851,7327,419,476,133490,152,133338,0.9988613379279346,7170.15,7069.58,7169.72,7069.18,1034,1034
14359,14785,6855,7185,426,330,90198,4085,86113,0.9547107474666844,14558.14,7028.42,14557.68,7027.82,1037,1035
4629,4942,6856,7231,313,375,69822,39,69783,0.9994414367964252,4789.87,7043.45,4789.54,7043.61,1036,1036
13797,13993,6857,7118,196,261,25338,801,24537,0.9683874023206251,13876.95,6979.31,13876.68,6979.07,1038,1037
4186,4717,6859,7278,531,419,142867,6598,136269,0.9538171866141236,4466.19,7061.71,4465.56,7061.06,1039,1038
6454,6635,6861,7069,181,208,24099,0,24099,1.0,6546.88,6962.12,6546.39,6961.7,1040,1039
11317,11579,6866,7169,262,303,49061,0,49061,1.0,11438.26,7013.12,11437.99,7012.79,1041,1040
5384,5826,6869,7236,442,367,93038,0,93038,1.0,5609.84,7058.08,5609.29,7057.61,1042,1041
10574,10735,6870,7028,161,158,14339,0,14339,1.0,10654.4,6956.38,10653.89,6955.76,1043,1042
11494,11680,6876,7099,186,223,23857,0,23857,1.0,11586.53,6991.24,11585.72,6990.4,1044,1043
3841,3956,6880,7035,115,155,8967,0,8967,1.0,3900.61,6952.0,3900.12,6951.75,1045,1044
12148,12335,6889,7034,187,145,19842,0,19842,1.0,12244.55,6964.79,12243.98,6964.25,1046,1045
13607,13826,6892,7077,219,185,30245,0,30245,1.0,13723.38,6978.88,13722.9,6978.42,1047,1046
9515,9703,6894,7067,188,173,15127,2095,13032,0.8615059165730151,9576.89,6974.98,9577.69,6975.29,1048,1047
5178,5459,6895,7209,281,314,54507,4970,49537,0.9088190507641221,5315.62,7039.31,5315.03,7039.05,1049,1048
14777,15182,6900,7165,405,265,63200,0,63200,1.0,15006.26,7041.68,15005.44,7041.17,1050,1049
9809,9967,6925,7106,158,181,12680,0,12680,1.0,9885.63,7011.54,9885.23,7011.13,1051,1050
12802,13068,6926,7147,266,221,32149,0,32149,1.0,12966.04,7038.24,12964.9,7037.88,1052,1051
15181,15374,6926,7133,193,207,24036,0,24036,1.0,15270.38,7023.44,15269.96,7023.01,1053,1052
3914,4214,6931,7169,300,238,49435,0,49435,1.0,4063.24,7041.92,4062.56,7041.57,1054,1053
6290,6560,6935,7303,270,368,51933,0,51933,1.0,6442.01,7098.09,6441.52,7097.67,1055,1054
7749,8080,6941,7138,331,197,41526,3075,38451,0.9259500072243896,7910.5,7037.43,7909.97,7037.01,1056,1055
11625,11904,6947,7123,279,176,31756,1099,30657,0.9653923667968258,11783.74,7025.63,11782.92,7025.33,1057,1056
10194,10685,6949,7642,491,693,201385,1335,200050,0.9933709064726767,10453.04,7285.52,10452.48,7285.17,1058,1057
8442,9020,6960,7526,578,566,185102,0,185102,1.0,8753.85,7236.0,8753.07,7235.14,1059,1058
12298,12481,6963,7118,183,155,21014,1023,19991,0.9513181688398211,12389.6,7044.52,12389.14,7044.03,1060,1059
13402,13695,6967,7281,293,314,68796,1542,67254,0.9775859061573348,13545.08,7123.15,13544.81,7122.84,1061,1060
3423,3682,6969,7240,259,271,36783,0,36783,1.0,3553.97,7093.41,3553.35,7093.09,1062,1061
5926,6213,6969,7200,287,231,39887,0,39887,1.0,6085.85,7085.44,6085.17,7084.9,1063,1062
16478,16654,6990,7240,176,250,20550,1533,19017,0.9254014598540146,16578.91,7100.41,16578.3,7100.08,1064,1063
9872,10123,6993,7220,251,227,36289,0,36289,1.0,9988.07,7109.45,9987.64,7108.93,1065,1064
10663,11075,6993,7416,412,423,106921,5220,101701,0.9511789077917341,10861.73,7189.27,10861.53,7189.01,1066,1065
13838,14007,6996,7169,169,173,18259,0,18259,1.0,13929.52,7090.8,13929.01,7090.22,1067,1066
6142,6397,6997,7287,255,290,46083,0,46083,1.0,6275.3,7159.28,6274.61,7158.33,1068,1067
2291,2775,7001,7499,484,498,137848,3085,134763,0.977620277406999,2488.83,7257.3,2488.67,7256.79,1070,1068
2053,2341,7003,7413,288,410,41942,4007,37935,0.9044633064708407,2247.46,7192.04,2245.78,7190.76,1082,1069
13986,14258,7003,7250,272,247,52662,0,52662,1.0,14115.93,7125.19,14115.44,7124.69,1069,1070
11981,12223,7006,7240,242,234,35377,2252,33125,0.9363428216072589,12107.39,7125.19,12107.02,7124.65,1071,1071
15221,15416,7010,7337,195,327,33777,1212,32565,0.9641175948130385,15323.52,7198.1,15323.09,7196.9,1073,1072
9417,9748,7011,7272,331,261,46421,0,46421,1.0,9598.78,7141.61,9598.1,7141.18,1072,1073
12998,13205,7017,7221,207,204,26803,978,25825,0.963511547214864,13112.75,7110.93,13112.03,7110.58,1074,1074
15366,15643,7019,7330,277,311,40346,2927,37419,0.9274525355673425,15455.76,7164.8,15456.29,7163.89,1075,1075
6520,6855,7022,7314,335,292,54910,2028,52882,0.9630668366417775,6674.07,7158.74,6673.49,7158.6,1076,1076
12178,12331,7023,7225,153,202,20869,0,20869,1.0,12248.15,7113.05,12247.74,7112.7,1078,1077
9711,9897,7024,7220,186,196,26083,0,26083,1.0,9802.08,7124.8,9801.72,7124.32,1077,1078
14251,14451,7029,7224,200,195,21780,2013,19767,0.9075757575757576,14338.51,7144.2,14338.19,7143.44,1080,1079
15515,16007,7029,7501,492,472,88921,1304,87617,0.9853352976237334,15707.97,7271.72,15708.23,7271.88,1079,1080
11836,12088,7032,7331,252,299,38486,1150,37336,0.9701190043132568,11950.05,7189.47,11949.68,7188.92,1083,1081
3822,3988,7033,7207,166,174,15397,0,15397,1.0,3909.98,7123.78,3909.4,7123.19,1081,1082
11191,11371,7043,7212,180,169,15273,517,14756,0.9661494139985596,11292.4,7135.22,11291.69,7134.66,1084,1083
3125,3492,7045,7313,367,268,57256,5201,52055,0.9091623585301104,3318.67,7178.49,3318.08,7178.06,1085,1084
7314,7504,7047,7303,190,256,26994,0,26994,1.0,7395.06,7181.55,7394.72,7180.93,1086,1085
16236,16639,7052,7570,403,518,105813,0,105813,1.0,16475.31,7303.69,16474.66,7303.22,1087,1086
13643,13844,7057,7318,201,261,33702,0,33702,1.0,13747.65,7179.21,13747.12,7178.87,1088,1087
14457,14868,7060,7394,411,334,80622,0,80622,1.0,14671.06,7240.08,14670.74,7239.41,1090,1088
5733,6004,7062,7323,271,261,46827,0,46827,1.0,5879.71,7189.84,5879.2,7189.42,1089,1089
2686,3113,7065,7394,427,329,83750,3342,80408,0.9600955223880597,2895.3,7225.84,2894.83,7225.23,1091,1090
12544,13096,7065,7620,552,555,205294,7924,197370,0.9614016970783364,12839.14,7322.06,12838.62,7321.64,1092,1091
10041,10337,7068,7355,296,287,44179,2832,41347,0.9358971457027094,10186.77,7189.44,10186.29,7189.16,1093,1092
11409,11856,7068,7457,447,389,108211,6815,101396,0.9370211900823391,11630.96,7247.26,11630.41,7246.88,1094,1093
15053,15242,7068,7284,189,216,24148,0,24148,1.0,15151.38,7172.87,15150.89,7172.49,1095,1094
4154,4489,7081,7475,335,394,60203,1505,58698,0.9750012457850937,4324.27,7292.53,4323.51,7291.71,1096,1095
7715,8247,7089,7507,532,418,135699,7297,128402,0.9462265749931834,7975.68,7275.82,7975.04,7275.61,1097,1096
3482,3914,7091,7399,432,308,78581,0,78581,1.0,3677.39,7246.23,3677.08,7245.63,1098,1097
7440,7795,7101,7431,355,330,79871,0,79871,1.0,7623.14,7248.79,7622.59,7248.4,1099,1098
12224,12574,7106,7475,350,369,90570,1767,88803,0.9804902285525008,12405.26,7285.68,12404.69,7285.2,1100,1099
14817,15068,7106,7319,251,213,27782,0,27782,1.0,14926.96,7202.18,14926.64,7201.78,1101,1100
11287,11478,7116,7321,191,205,23944,0,23944,1.0,11381.93,7217.2,11381.38,7216.82,1102,1101
9023,9464,7123,7382,441,259,64568,1926,62642,0.9701709825300459,9252.38,7240.99,9251.66,7240.44,1103,1102
3953,4208,7141,7311,255,170,32749,1637,31112,0.9500137408775841,4089.66,7222.72,4089.04,7222.18,1104,1103
6750,7140,7143,7496,390,353,96242,0,96242,1.0,6938.46,7331.18,6937.99,7330.65,1105,1104
13068,13384,7146,7596,316,450,98640,0,98640,1.0,13211.92,7378.45,13211.43,7377.9,1106,1105
5184,5533,7150,7717,349,567,114248,0,114248,1.0,5374.82,7407.57,5374.25,7407.37,1109,1106
13788,14051,7150,7325,263,175,21485,0,21485,1.0,13917.98,7222.1,13917.16,7222.12,1107,1107
4598,5289,7151,7616,691,465,188286,1514,186772,0.9919590410333217,4907.98,7368.69,4907.84,7367.9,1108,1108
13292,13431,7153,7312,139,159,11685,0,11685,1.0,13365.74,7234.3,13365.26,7233.72,1110,1109
8413,8605,7159,7360,192,201,20021,0,20021,1.0,8510.41,7265.92,8509.96,7265.46,1112,1110
8165,8394,7160,7314,229,154,19523,1471,18052,0.9246529734159709,8275.5,7222.34,8275.02,7221.86,1111,1111
8952,9140,7160,7466,188,306,34960,1594,33366,0.9544050343249428,9035.38,7330.42,9034.79,7329.72,1113,1112
5473,5857,7164,7537,384,373,98365,0,98365,1.0,5653.16,7342.48,5652.71,7341.94,1114,1113
11046,11331,7170,7415,285,245,45560,0,45560,1.0,11173.4,7291.45,11173.0,7291.02,1115,1114
9803,10220,7173,7637,417,464,124285,0,124285,1.0,10019.82,7417.08,10019.27,7416.59,1116,1115
5972,6149,7175,7316,177,141,14759,0,14759,1.0,6042.94,7239.78,6042.78,7239.26,1117,1116
3021,3354,7176,7454,333,278,51253,0,51253,1.0,3173.77,7334.04,3173.33,7333.41,1118,1117
13758,14528,7185,7552,770,367,194277,2949,191328,0.9848206426905912,14136.21,7377.74,14135.89,7377.1,1119,1118
9585,9882,7199,7554,297,355,75630,0,75630,1.0,9728.66,7364.8,9728.22,7364.3,1120,1119
3495,4271,7203,7680,776,477,199743,10308,189435,0.948393685886364,3863.97,7442.05,3863.55,7441.52,1121,1120
4391,4682,7205,7591,291,386,65263,1621,63642,0.9751620366823468,4541.17,7434.33,4540.75,7433.39,1122,1121
8234,8455,7211,7424,221,213,23448,0,23448,1.0,8343.9,7323.35,8343.48,7322.75,1124,1122
9369,9604,7211,7530,235,319,45199,0,45199,1.0,9503.12,7352.37,9502.64,7352.08,1123,1123
14824,15316,7211,7797,492,586,160896,7225,153671,0.9550952167859984,15072.11,7491.83,15071.46,7491.44,1125,1124
13352,13510,7216,7405,158,189,14120,2095,12025,0.851628895184136,13422.22,7317.72,13422.0,7316.9,1126,1125
6550,6794,7219,7494,244,275,42637,0,42637,1.0,6674.3,7357.29,6673.71,7357.09,1127,1126
15139,15307,7219,7442,168,223,19233,0,19233,1.0,15228.85,7314.93,15228.56,7314.89,1128,1127
3321,3500,7225,7443,179,218,24790,0,24790,1.0,3415.88,7332.28,3415.17,7331.99,1129,1128
11981,12305,7226,7598,324,372,92396,0,92396,1.0,12143.74,7419.56,12143.25,7419.0,1130,1129
6112,6611,7229,7823,499,594,178297,7621,170676,0.9572567121151786,6385.0,7525.7,6384.6,7525.46,1131,1130
5898,6268,7233,7672,370,439,113580,0,113580,1.0,6071.8,7449.34,6071.3,7448.78,1133,1131
7127,7357,7233,7415,230,182,21749,1042,20707,0.9520897512529312,7234.99,7323.03,7234.7,7322.48,1132,1132
11689,11992,7245,7574,303,329,72032,0,72032,1.0,11842.2,7416.58,11841.65,7416.03,1134,1133
10610,10754,7249,7442,144,193,13231,0,13231,1.0,10668.35,7336.89,10667.93,7336.58,1135,1134
15977,16519,7260,7892,542,632,234353,1342,233011,0.9942735958148605,16246.16,7584.63,16245.63,7584.1,1136,1135
13453,13789,7262,7467,336,205,42355,0,42355,1.0,13595.95,7349.5,13595.81,7349.01,1137,1136
15392,15671,7268,7624,279,356,48318,5910,42408,0.8776853346578914,15525.69,7438.83,15525.38,7438.55,1138,1137
14680,14917,7281,7468,237,187,22364,0,22364,1.0,14787.83,7385.4,14787.77,7384.6,1139,1138
15294,15479,7287,7491,185,204,21927,2800,19127,0.8723035526975874,15379.38,7387.43,15379.05,7386.83,1140,1139
7227,7576,7290,7630,349,340,90213,0,90213,1.0,7403.08,7467.61,7402.61,7467.06,1141,1140
9110,9281,7290,7460,171,170,17692,0,17692,1.0,9186.2,7381.29,9185.78,7380.7,1142,1141
8296,8516,7293,7529,220,236,30645,0,30645,1.0,8418.02,7426.25,8417.46,7425.55,1143,1142
5783,5928,7306,7530,145,224,19616,0,19616,1.0,5859.73,7415.23,5859.28,7414.8,1144,1143
11143,11451,7308,7528,308,220,38267,2368,35899,0.938119005932004,11298.58,7414.67,11298.13,7414.13,1145,1144
10621,11068,7318,7626,447,308,86438,0,86438,1.0,10833.41,7458.83,10832.96,7458.39,1146,1145
2606,2877,7320,7554,271,234,37696,0,37696,1.0,2731.72,7431.87,2731.31,7431.35,1147,1146
13564,13785,7328,7559,221,231,20792,0,20792,1.0,13683.77,7445.98,13682.85,7445.6,1148,1147
1633,1934,7333,7708,301,375,77075,0,77075,1.0,1772.25,7548.09,1771.78,7547.38,1149,1148
2704,3242,7334,7710,538,376,119951,7447,112504,0.9379163158289635,2966.66,7543.01,2966.71,7542.52,1150,1149
7848,8381,7338,7777,533,439,132524,0,132524,1.0,8135.35,7555.48,8134.79,7554.98,1151,1150
8482,8893,7345,7756,411,411,81230,0,81230,1.0,8651.46,7544.62,8651.46,7544.23,1152,1151
14409,14689,7351,7548,280,197,34329,0,34329,1.0,14552.69,7447.76,14552.12,7447.52,1153,1152
11563,11723,7356,7508,160,152,11885,0,11885,1.0,11639.46,7451.56,11639.27,7450.43,1159,1153
9281,9549,7357,7594,268,237,34127,3167,30960,0.9071995780467079,9400.73,7481.07,9400.35,7480.5,1154,1154
2278,2731,7366,7852,453,486,136761,5643,131118,0.9587382367780288,2497.66,7636.98,2497.25,7636.31,1155,1155
7569,7837,7370,7576,268,206,35381,0,35381,1.0,7686.07,7467.32,7685.78,7466.87,1156,1156
12525,12881,7371,7700,356,329,44434,1077,43357,0.9757618040239456,12723.31,7547.03,12722.27,7546.0,1157,1157
3367,3520,7378,7625,153,247,20804,0,20804,1.0,3455.13,7513.18,3454.32,7511.77,1158,1158
7040,7242,7387,7628,202,241,31130,35,31095,0.9988756826212657,7148.54,7499.33,7147.95,7498.97,1160,1159
13285,13585,7390,7568,300,178,32298,1515,30783,0.9530930707783764,13453.02,7491.21,13452.01,7490.86,1161,1160
3949,4691,7391,8074,742,683,262589,7343,255246,0.9720361477441934,4364.82,7791.47,4363.75,7790.41,1164,1161
9140,9339,7391,7561,199,170,17882,0,17882,1.0,9231.02,7492.1,9231.05,7491.53,1163,1162
11339,11586,7392,7664,247,272,44616,0,44616,1.0,11461.72,7522.38,11461.18,7521.93,1162,1163
3185,3437,7411,7662,252,251,45017,0,45017,1.0,3297.93,7538.54,3297.83,7538.14,1165,1164
10927,11249,7411,7790,322,379,70511,0,70511,1.0,11107.65,7585.18,11107.05,7584.84,1166,1165
8857,9159,7413,7628,302,215,36021,0,36021,1.0,9015.78,7525.88,9015.3,7525.28,1167,1166
15564,16010,7417,7801,446,384,96301,0,96301,1.0,15794.9,7579.68,15794.35,7579.23,1168,1167
12255,12696,7427,7796,441,369,108824,319,108505,0.9970686613247078,12483.57,7602.02,12482.95,7601.54,1169,1168
4978,5354,7430,7914,376,484,122998,4450,118548,0.9638205499276411,5164.46,7649.02,5163.96,7648.7,1170,1169
10460,10742,7438,7671,282,233,35700,0,35700,1.0,10599.53,7563.4,10599.08,7562.89,1171,1170
15276,15607,7449,7854,331,405,70932,3676,67256,0.9481757175886765,15415.95,7677.07,15416.02,7676.57,1172,1171
5712,5950,7452,7799,238,347,51049,0,51049,1.0,5830.31,7635.66,5829.68,7634.98,1173,1172
14615,14961,7461,7804,346,343,72965,1465,71500,0.9799218803535942,14797.66,7603.66,14797.27,7603.41,1174,1173
6516,6787,7462,7739,271,277,46867,0,46867,1.0,6643.07,7605.26,6642.86,7604.48,1175,1174
9548,9749,7465,7632,201,167,11975,1223,10752,0.8978705636743215,9648.54,7540.51,9648.46,7540.34,1176,1175
10152,10352,7465,7713,200,248,24291,0,24291,1.0,10260.42,7594.3,10259.74,7593.7,1177,1176
6710,7131,7469,7912,421,443,130900,3936,126964,0.9699312452253629,6922.8,7667.85,6922.21,7667.46,1178,1177
13716,14428,7472,7832,712,360,148876,766,148110,0.9948547784733603,14068.37,7647.4,14068.02,7647.02,1179,1178
11908,12059,7474,7623,151,149,10648,0,10648,1.0,11980.51,7556.53,11980.07,7555.82,1180,1179
13563,13861,7475,7638,298,163,30550,687,29863,0.9775122749590834,13705.18,7561.64,13704.85,7561.05,1181,1180
11573,11750,7489,7642,177,153,16186,1174,15012,0.9274681823798344,11657.41,7567.44,11657.08,7566.84,1182,1181
3905,4165,7501,7702,260,201,26808,0,26808,1.0,4029.69,7597.41,4029.63,7596.91,1183,1182
7652,8139,7503,7944,487,441,108446,0,108446,1.0,7874.13,7709.11,7873.79,7708.81,1184,1183
4093,4308,7504,7735,215,231,33020,0,33020,1.0,4199.27,7616.39,4198.81,7615.96,1186,1184
14383,14676,7504,7724,293,220,40747,0,40747,1.0,14533.75,7616.59,14533.26,7616.1,1185,1185
5210,5812,7509,8004,602,495,144074,6552,137522,0.9545233699348946,5515.17,7779.54,5514.59,7779.08,1187,1186
8346,8520,7512,7708,174,196,23336,0,23336,1.0,8434.22,7601.24,8433.51,7601.11,1188,1187
11220,11415,7513,7690,195,177,21968,0,21968,1.0,11307.39,7611.21,11307.05,7610.65,1189,1188
9713,9996,7515,7774,283,259,43932,0,43932,1.0,9852.56,7634.32,9852.0,7633.93,1190,1189
9020,9424,7521,7796,404,275,73420,0,73420,1.0,9215.71,7656.04,9215.48,7655.5,1191,1190
5618,5755,7522,7684,137,162,14686,1136,13550,0.9226474193109083,5685.66,7593.08,5685.3,7592.82,1192,1191
4615,4789,7529,7682,174,153,14574,0,14574,1.0,4700.35,7607.68,4699.85,7607.11,1193,1192
9407,9821,7533,7933,414,400,112450,0,112450,1.0,9612.27,7735.78,9611.77,7735.26,1194,1193
12811,13143,7535,7766,332,231,37463,0,37463,1.0,13016.31,7648.99,13014.94,7648.43,1195,1194
7481,7669,7537,7772,188,235,26088,0,26088,1.0,7589.26,7653.78,7588.53,7653.3,1196,1195
11717,11979,7544,7775,262,231,40673,0,40673,1.0,11847.98,7650.83,11847.53,7650.39,1197,1196
13271,13591,7545,7806,320,261,57003,0,57003,1.0,13419.89,7658.99,13419.46,7658.55,1198,1197
7129,7313,7547,7746,184,199,19397,553,18844,0.9714904366654638,7206.23,7646.35,7205.98,7645.75,1199,1198
11883,12307,7563,7886,424,323,91801,0,91801,1.0,12104.42,7729.04,12103.91,7728.43,1202,1199
4850,5001,7564,7727,151,163,12856,0,12856,1.0,4941.21,7640.61,4940.6,7640.2,1200,1200
8742,9040,7565,7865,298,300,52130,1750,50380,0.96643007864953,8870.42,7713.47,8870.06,7712.96,1201,1201
11416,11745,7565,7758,329,193,28199,785,27414,0.9721621334089862,11569.74,7667.13,11569.99,7666.5,1203,1202
13055,13381,7572,8103,326,531,113756,0,113756,1.0,13220.79,7850.08,13220.24,7849.52,1205,1203
10738,10982,7573,7716,244,143,19539,0,19539,1.0,10856.67,7645.22,10856.39,7644.61,1204,1204
3623,3960,7584,7802,337,218,46321,0,46321,1.0,3798.0,7690.56,3797.42,7690.09,1206,1205
8487,8767,7588,8043,280,455,78930,0,78930,1.0,8620.58,7859.33,8619.79,7858.26,1208,1206
3412,3627,7589,7801,215,212,29045,3824,25221,0.8683422275778964,3516.59,7701.65,3516.06,7701.16,1207,1207
15521,15718,7596,7862,197,266,37168,0,37168,1.0,15622.2,7719.04,15621.78,7718.71,1209,1208
7185,7561,7607,8051,376,444,121658,1401,120257,0.988484111196962,7374.77,7820.81,7374.3,7820.37,1211,1209
3196,3440,7608,7807,244,199,29048,893,28155,0.9692577802258331,3329.03,7711.71,3328.43,7711.17,1210,1210
10288,10613,7608,7769,325,161,34934,2146,32788,0.9385698746207134,10453.16,7685.81,10452.57,7685.36,1212,1211
9972,10387,7609,7975,415,366,90618,5781,84837,0.9362047275375753,10146.4,7770.36,10146.13,7770.04,1213,1212
1650,2030,7611,7973,380,362,70710,0,70710,1.0,1850.73,7781.34,1850.17,7780.9,1214,1213
4682,5063,7615,8171,381,556,128812,5586,123226,0.9566344750489085,4875.45,7862.22,4875.12,7862.11,1215,1214
2948,3454,7618,7992,506,374,88401,2099,86302,0.9762559247067341,3164.14,7828.22,3164.24,7827.39,1216,1215
13534,13736,7632,7848,202,216,27899,0,27899,1.0,13648.5,7723.82,13647.96,7723.51,1217,1216
10557,10799,7635,7860,242,225,31453,0,31453,1.0,10685.4,7734.2,10684.79,7733.87,1218,1217
10796,11118,7638,7925,322,287,45173,0,45173,1.0,10959.85,7775.45,10959.24,7774.87,1219,1218
14254,14584,7639,7941,330,302,66355,0,66355,1.0,14423.96,7797.44,14423.36,7796.87,1220,1219
5902,6262,7646,7826,360,180,36588,1127,35461,0.9691975511096534,6092.97,7742.34,6092.31,7741.84,1221,1220
12488,12764,7655,7883,276,228,28793,0,28793,1.0,12641.37,7780.19,12640.5,7779.72,1222,1221
15061,15338,7659,7907,277,248,50013,0,50013,1.0,15213.84,7773.38,15213.26,7772.9,1223,1222
8387,8557,7660,7874,170,214,20901,0,20901,1.0,8482.43,7753.99,8481.77,7753.67,1224,1223
11018,11530,7665,8182,512,517,170567,3640,166927,0.978659412430306,11304.81,7912.07,11304.16,7911.58,1225,1224
2630,3058,7670,7905,428,235,69430,3361,66069,0.951591531038456,2850.66,7782.87,2850.07,7782.33,1226,1225
14576,14878,7679,7967,302,288,62302,3730,58572,0.9401303328946101,14726.43,7818.44,14725.94,7817.99,1229,1226
15827,16269,7679,8239,442,560,175524,653,174871,0.9962797110366673,16053.67,7971.11,16053.11,7970.51,1230,1227
12232,12466,7680,7887,234,207,25808,0,25808,1.0,12349.81,7790.39,12349.25,7789.94,1227,1228
12708,13099,7680,8083,391,403,105112,0,105112,1.0,12914.03,7860.7,12913.5,7860.36,1228,1229
8064,8502,7681,8223,438,542,151849,6049,145800,0.9601643738187278,8297.8,7941.55,8297.13,7941.11,1231,1230
15687,15844,7686,7861,157,175,14687,0,14687,1.0,15761.65,7781.71,15761.12,7781.03,1232,1231
9253,9488,7690,7847,235,157,17565,0,17565,1.0,9379.65,7771.74,9378.98,7771.37,1233,1232
11490,11918,7696,8031,428,335,106076,5617,100459,0.9470473999773747,11681.07,7859.78,11680.71,7859.28,1234,1233
8915,9204,7711,7922,289,211,33733,0,33733,1.0,9048.7,7816.46,9048.38,7815.93,1235,1234
16776,17005,7715,7950,229,235,33186,0,33186,1.0,16892.37,7819.54,16892.09,7819.49,1236,1235
3561,3736,7720,7922,175,202,17937,1551,16386,0.9135306907509617,3653.72,7807.73,3653.23,7807.47,1237,1236
3695,4126,7721,8174,431,453,130197,5169,125028,0.9602986243922671,3918.34,7942.94,3918.02,7942.53,1241,1237
6236,6511,7721,7942,275,221,41225,0,41225,1.0,6355.81,7829.68,6355.47,7829.29,1238,1238
7529,7882,7726,8054,353,328,85963,0,85963,1.0,7697.77,7901.34,7697.33,7900.79,1239,1239
16327,16957,7727,8256,630,529,144687,2383,142304,0.9835299646823834,16670.42,7984.41,16669.78,7983.94,1240,1240
10654,10949,7728,8144,295,416,73673,1893,71780,0.9743053764608473,10805.32,7946.91,10804.78,7946.33,1242,1241
7091,7191,7732,7856,100,124,8601,0,8601,1.0,7144.82,7794.53,7144.33,7794.13,1243,1242
13802,14318,7732,8037,516,305,96845,37,96808,0.9996179462026951,14067.84,7888.95,14067.27,7888.48,1244,1243
9816,10000,7733,7884,184,151,23098,0,23098,1.0,9905.09,7810.42,9904.65,7809.99,1245,1244
6491,6871,7734,8074,380,340,82642,0,82642,1.0,6664.25,7888.95,6663.87,7888.56,1246,1245
13359,13709,7737,8186,350,449,109504,7436,102068,0.932093804792519,13536.1,7951.74,13535.79,7951.6,1247,1246
10248,10686,7740,8142,438,402,113620,7830,105790,0.9310860763950009,10479.6,7943.94,10478.91,7943.61,1248,1247
14864,14997,7744,7948,133,204,17732,0,17732,1.0,14931.14,7854.44,14930.68,7853.82,1249,1248
14923,15364,7753,8191,441,438,115231,2963,112268,0.974286433338251,15121.9,8009.92,15121.51,8009.24,1250,1249
5547,6043,7771,8331,496,560,174346,3246,171100,0.981381849884712,5817.3,8059.58,5816.75,8059.01,1251,1250
13688,13910,7776,7931,222,155,17155,713,16442,0.9584377732439522,13810.21,7836.29,13809.16,7836.05,1252,1251
5028,5209,7786,7976,181,190,17453,0,17453,1.0,5091.56,7889.47,5091.53,7888.9,1253,1252
9123,9685,7787,8247,562,460,154339,7882,146457,0.9489306008202723,9382.93,7998.78,9382.69,7998.45,1254,1253
2299,2730,7789,8082,431,293,92521,39,92482,0.9995784740761556,2525.51,7938.18,2524.78,7937.64,1255,1254
6028,6181,7790,7932,153,142,15020,2074,12946,0.8619174434087883,6098.65,7861.14,6098.03,7860.63,1257,1255
3203,3701,7792,8212,498,420,124475,0,124475,1.0,3445.87,7985.28,3445.27,7984.92,1256,1256
12353,12529,7793,7990,176,197,19599,0,19599,1.0,12446.74,7893.62,12446.23,7893.02,1258,1257
8693,9204,7795,8236,511,441,147000,5966,141034,0.9594149659863945,8932.43,8043.25,8932.19,8042.59,1259,1258
15593,15884,7804,8156,291,352,66963,3061,63902,0.9542881889998954,15730.42,7989.58,15729.92,7988.99,1260,1259
6938,7095,7806,7964,157,158,12432,0,12432,1.0,7021.45,7887.74,7020.96,7887.19,1262,1260
15260,15642,7806,8155,382,349,93013,1816,91197,0.9804758474621827,15456.76,7985.03,15456.32,7984.47,1261,1261
2069,2356,7809,8092,287,283,45615,2669,42946,0.9414885454346158,2210.53,7944.83,2210.03,7944.36,1263,1262
1804,2131,7815,8124,327,309,63037,0,63037,1.0,1991.28,7981.1,1990.6,7980.56,1264,1263
6984,7290,7815,8199,306,384,72158,0,72158,1.0,7143.9,8022.07,7143.27,8021.37,1265,1264
6014,6245,7824,8113,231,289,33266,908,32358,0.9727048638249264,6132.22,7970.12,6131.9,7969.61,1266,1265
13668,14036,7831,8268,368,437,91547,0,91547,1.0,13834.06,8085.65,13833.46,8084.78,1267,1266
11973,12433,7842,8262,460,420,133291,4496,128795,0.9662692904997336,12201.58,8025.26,12201.09,8024.92,1268,1267
6639,7007,7847,8389,368,542,123367,7718,115649,0.9374386991659034,6826.84,8141.83,6826.32,8141.07,1269,1268
12478,12903,7851,8188,425,337,100508,5358,95150,0.9466908106817368,12683.44,8024.17,12682.97,8023.67,1270,1269
9558,9824,7856,8102,266,246,31435,1137,30298,0.9638301256561158,9708.89,7978.74,9708.43,7978.02,1272,1270
5162,5766,7858,8248,604,390,107940,4236,103704,0.9607559755419678,5446.35,8058.95,5446.21,8058.21,1271,1271
7853,8165,7858,8241,312,383,70275,0,70275,1.0,8030.11,8028.42,8029.53,8028.13,1273,1272
11645,12011,7862,8136,366,274,50724,0,50724,1.0,11854.6,8015.37,11853.84,8014.91,1274,1273
10111,10349,7863,8114,238,251,36539,0,36539,1.0,10241.28,7976.0,10240.7,7975.67,1275,1274
9786,10137,7865,8145,351,280,73392,181,73211,0.9975337911488991,9957.08,8008.87,9956.52,8008.26,1276,1275
2680,3055,7876,8153,375,277,67017,0,67017,1.0,2876.7,8009.19,2876.05,8008.67,1277,1276
4485,4811,7877,8159,326,282,59485,0,59485,1.0,4643.91,8032.47,4643.5,8031.86,1278,1277
14379,14821,7879,8174,442,295,90662,5361,85301,0.9408682799849992,14591.53,8029.36,14591.1,8028.88,1279,1278
16258,16645,7890,8305,387,415,87666,4952,82714,0.943512878424931,16446.91,8096.97,16446.4,8096.43,1280,1279
6108,6549,7892,8453,441,561,140820,0,140820,1.0,6304.25,8138.14,6303.74,8137.84,1281,1280
10855,11243,7900,8368,388,468,115413,0,115413,1.0,11043.12,8140.4,11042.6,8139.88,1282,1281
5030,5275,7905,8171,245,266,38579,3008,35571,0.9220301200134788,5152.49,8035.57,5151.82,8034.92,1283,1282
14766,14933,7907,8100,167,193,22834,0,22834,1.0,14861.53,8007.34,14860.9,8006.77,1284,1283
14167,14450,7912,8168,283,256,37754,1065,36689,0.9717910684960533,14319.35,8039.12,14318.81,8038.7,1285,1284
3036,3260,7930,8140,224,210,28098,0,28098,1.0,3148.28,8057.21,3148.22,8056.17,1286,1285
3560,3792,7972,8199,232,227,25227,2187,23040,0.9133071708883339,3682.9,8088.29,3682.12,8087.89,1287,1286
7353,7773,7976,8506,420,530,151526,0,151526,1.0,7554.82,8231.75,7554.33,8231.26,1288,1287
12364,12666,7979,8277,302,298,44592,2757,41835,0.9381727664155005,12499.58,8160.13,12499.18,8159.33,1289,1288
2314,2686,7989,8410,372,421,77792,628,77164,0.9919271904566023,2518.75,8195.59,2517.85,8194.74,1290,1289
12861,13151,7991,8242,290,251,43197,0,43197,1.0,13022.13,8127.1,13021.51,8126.57,1291,1290
14003,14214,7994,8146,211,152,20824,1171,19653,0.9437668075297734,14109.77,8069.46,14109.29,8068.91,1292,1291
4697,4926,8002,8277,229,275,35061,0,35061,1.0,4822.66,8149.6,4821.93,8148.85,1295,1292
10521,10857,8003,8322,336,319,55872,0,55872,1.0,10670.79,8165.5,10670.34,8165.07,1293,1293
1775,1963,8006,8338,188,332,37778,0,37778,1.0,1869.62,8159.54,1868.89,8159.66,1294,1294
11409,11779,8010,8298,370,288,62539,0,62539,1.0,11595.61,8157.0,11595.18,8156.51,1296,1295
7256,7390,8016,8193,134,177,16353,0,16353,1.0,7322.08,8111.27,7321.56,8110.61,1297,1296
8460,8713,8020,8293,253,273,37954,2037,35917,0.9463297676134268,8591.26,8127.09,8590.68,8126.9,1298,1297
2111,2302,8023,8249,191,226,22637,0,22637,1.0,2186.1,8130.92,2186.27,8130.12,1299,1298
7664,8040,8025,8557,376,532,135959,4195,131764,0.9691451099228444,7859.66,8301.79,7859.05,8301.23,1300,1299
4067,4312,8035,8194,245,159,25142,1850,23292,0.9264179460663432,4181.26,8115.83,4180.77,8115.34,1301,1300
10061,10285,8036,8308,224,272,30411,1288,29123,0.9576469040807603,10193.8,8164.94,10193.07,8164.46,1302,1301
6183,6689,8037,8720,506,683,193639,779,192860,0.995977050077722,6466.69,8393.03,6466.21,8392.58,1303,1302
13143,13529,8046,8370,386,324,94661,0,94661,1.0,13338.94,8207.24,13338.44,8206.74,1304,1303
4274,4554,8049,8315,280,266,45059,0,45059,1.0,4417.56,8165.74,4416.82,8165.28,1305,1304
2643,2967,8051,8429,324,378,84866,3969,80897,0.9532321542195933,2794.62,8243.12,2794.06,8242.59,1306,1305
2199,2459,8054,8391,260,337,36939,3934,33005,0.8935000947508054,2344.36,8225.13,2343.58,8224.75,1307,1306
9648,9919,8055,8330,271,275,36921,0,36921,1.0,9775.74,8181.5,9775.13,8180.82,1308,1307
5869,6148,8056,8354,279,298,54923,0,54923,1.0,6024.76,8223.01,6024.12,8222.44,1309,1308
15704,15961,8057,8330,257,273,43678,60,43618,0.9986263107285132,15820.62,8211.81,15820.37,8211.03,1310,1309
14129,14516,8065,8435,387,370,84074,794,83280,0.9905559388158052,14313.99,8256.86,14313.29,8256.21,1311,1310
6938,7086,8075,8278,148,203,10215,1157,9058,0.8867351933431229,7010.02,8164.66,7009.11,8165.06,1312,1311
11764,12164,8085,8432,400,347,87319,0,87319,1.0,11963.06,8236.87,11962.59,8236.53,1313,1312
3621,3888,8089,8300,267,211,29984,1309,28675,0.9563433831376734,3771.93,8193.29,3771.16,8192.82,1314,1313
14773,14952,8090,8215,179,125,15416,897,14519,0.9418137000518941,14867.0,8150.12,14866.4,8149.61,1315,1314
2949,3299,8093,8431,350,338,76210,0,76210,1.0,3108.74,8247.63,3108.28,8247.2,1316,1315
4927,5141,8096,8297,214,201,23947,1341,22606,0.9440013362842945,5025.27,8186.07,5024.89,8185.69,1317,1316
3288,3622,8101,8326,334,225,43677,0,43677,1.0,3457.77,8209.33,3457.12,8208.89,1318,1317
10430,10560,8103,8226,130,123,9699,0,9699,1.0,10507.47,8155.54,10506.71,8155.22,1319,1318
8154,8568,8105,8488,414,383,101184,7924,93260,0.9216872232764073,8363.18,8297.24,8362.65,8296.79,1321,1319
14906,15343,8105,8439,437,334,71668,0,71668,1.0,15148.26,8268.51,15147.33,8267.86,1324,1320
13502,13722,8106,8345,220,239,30135,0,30135,1.0,13602.99,8225.3,13602.51,8224.71,1320,1321
1955,2188,8109,8371,233,262,47266,1828,45438,0.9613252655185546,2066.49,8245.52,2066.01,8244.98,1322,1322
9059,9454,8109,8507,395,398,104826,4668,100158,0.9554690630187167,9255.55,8313.11,9255.0,8312.58,1323,1323
15583,15714,8113,8351,131,238,22229,0,22229,1.0,15648.17,8224.95,15647.72,8224.62,1325,1324
15276,15607,8121,8391,331,270,57984,6085,51899,0.8950572571743929,15456.95,8250.13,15456.17,8249.75,1326,1325
3857,4076,8123,8311,219,188,24438,1837,22601,0.9248301825026598,3961.86,8204.63,3961.42,8204.29,1327,1326
13921,14228,8127,8502,307,375,75536,0,75536,1.0,14071.19,8324.61,14070.81,8323.97,1328,1327
10239,10585,8130,8505,346,375,84467,0,84467,1.0,10410.63,8312.23,10410.05,8311.74,1329,1328
9812,10330,8133,8614,518,481,154492,5569,148923,0.9639528260362996,10072.99,8366.12,10072.52,8365.68,1330,1329
16223,16685,8133,8528,462,395,85131,1621,83510,0.9809587576793413,16463.43,8328.99,16462.9,8328.46,1331,1330
14435,14568,8135,8279,133,144,10614,792,9822,0.9253815715093273,14504.59,8195.61,14504.04,8195.31,1332,1331
8559,8832,8136,8356,273,220,30482,0,30482,1.0,8717.96,8260.43,8716.89,8259.85,1334,1332
9417,9746,8137,8493,329,356,68633,804,67829,0.9882855186280652,9589.46,8289.69,9588.98,8289.4,1333,1333
14516,14834,8139,8337,318,198,35799,0,35799,1.0,14671.25,8230.55,14670.82,8230.11,1335,1334
11208,11373,8146,8356,165,210,19682,0,19682,1.0,11297.34,8256.92,11296.61,8256.28,1336,1335
4370,4773,8150,8434,403,284,64791,0,64791,1.0,4587.14,8291.87,4586.43,8291.39,1338,1336
16626,16831,8151,8312,205,161,22541,0,22541,1.0,16719.37,8234.34,16719.03,8233.86,1337,1337
11344,11584,8155,8396,240,241,29123,0,29123,1.0,11454.92,8276.9,11454.62,8276.43,1340,1338
7129,7384,8156,8311,255,155,22659,2224,20435,0.9018491548612031,7271.39,8229.03,7270.58,8228.54,1339,1339
3954,4370,8157,8572,416,415,115690,4782,110908,0.9586653989108825,4153.7,8350.36,4153.26,8349.95,1341,1340
10736,10901,8158,8349,165,191,13614,0,13614,1.0,10829.05,8258.68,10828.44,8258.16,1342,1341
6904,7168,8164,8460,264,296,47123,0,47123,1.0,7046.0,8312.11,7045.37,8311.72,1343,1342
12602,12970,8166,8542,368,376,96782,221,96561,0.9977165175342523,12795.74,8334.61,12795.23,8334.18,1344,1343
8025,8194,8167,8455,169,288,34261,0,34261,1.0,8109.58,8328.36,8109.22,8327.58,1345,1344
5012,5266,8169,8454,254,285,50284,0,50284,1.0,5137.97,8316.01,5137.56,8315.39,1346,1345
12159,12649,8170,8515,490,345,80058,1539,78519,0.9807764370831148,12440.76,8341.39,12439.7,8340.69,1347,1346
5226,5721,8172,8548,495,376,110677,0,110677,1.0,5460.49,8353.21,5459.95,8352.55,1348,1347
15885,16171,8181,8566,286,385,56150,0,56150,1.0,16037.14,8361.69,16036.82,8361.24,1349,1348
12904,13252,8183,8582,348,399,94413,0,94413,1.0,13080.32,8395.28,13079.85,8394.68,1350,1349
13599,13947,8188,8508,348,320,54774,0,54774,1.0,13764.12,8347.37,13763.46,8346.87,1351,1350
16077,16424,8190,8633,347,443,83136,0,83136,1.0,16251.62,8424.8,16250.95,8424.18,1352,1351
3498,3749,8193,8592,251,399,58597,1139,57458,0.9805621448197007,3621.82,8392.71,3621.2,8392.25,1353,1352
8798,9069,8196,8469,271,273,52039,0,52039,1.0,8934.89,8322.28,8934.29,8321.92,1354,1353
14631,15256,8206,8681,625,475,140737,686,140051,0.9951256599188557,14968.01,8415.64,14967.48,8415.33,1355,1354
4705,5038,8217,8615,333,398,96066,0,96066,1.0,4870.98,8417.89,4870.5,8417.39,1356,1355
16766,16967,8226,8523,201,297,32603,0,32603,1.0,16860.27,8376.01,16859.88,8375.4,1357,1356
11546,11975,8232,8577,429,345,96998,0,96998,1.0,11759.11,8407.91,11758.67,8407.45,1358,1357
2177,2344,8233,8452,167,219,25727,2510,23217,0.9024371283087806,2261.49,8345.96,2260.88,8345.3,1359,1358
16626,16841,8244,8528,215,284,26483,0,26483,1.0,16729.88,8383.15,16729.5,8382.23,1360,1359
3591,4012,8250,8759,421,509,124452,6252,118200,0.9497637643428792,3819.21,8507.47,3818.57,8507.05,1361,1360
7047,7387,8261,8845,340,584,124777,0,124777,1.0,7210.72,8545.39,7210.21,8544.94,1362,1361
11970,12385,8261,8655,415,394,102050,0,102050,1.0,12195.48,8470.3,12194.85,8469.68,1363,1362
1774,1970,8266,8470,196,204,23566,0,23566,1.0,1880.17,8349.41,1879.54,8349.18,1364,1363
3379,3550,8268,8533,171,265,35020,0,35020,1.0,3462.04,8395.48,3461.66,8394.92,1365,1364
3066,3548,8269,8724,482,455,108970,3357,105613,0.9691933559695329,3283.26,8504.93,3283.01,8504.49,1367,1365
10516,10867,8270,8551,351,281,59480,0,59480,1.0,10719.07,8403.94,10718.17,8403.55,1366,1366
10993,11391,8272,8700,398,428,113941,0,113941,1.0,11202.79,8482.48,11202.25,8481.98,1368,1367
10838,11001,8273,8435,163,162,15005,0,15005,1.0,10915.19,8359.59,10914.72,8359.14,1369,1368
8325,8860,8278,8717,535,439,132782,1934,130848,0.9854347727854679,8586.48,8501.58,8585.8,8501.1,1370,1369
14421,14668,8280,8742,247,462,61137,1409,59728,0.976953399741564,14557.65,8514.1,14557.29,8513.59,1371,1370
15651,15728,8301,8443,77,142,6526,0,6526,1.0,15693.54,8365.95,15693.07,8365.69,1372,1371
13438,13664,8303,8506,226,203,25761,1047,24714,0.9593571678118086,13546.92,8406.44,13546.61,8406.09,1373,1372
15710,15891,8313,8514,181,201,27391,2785,24606,0.8983242670950312,15799.73,8410.5,15799.12,8409.97,1376,1373
1866,2065,8315,8514,199,199,21813,0,21813,1.0,1987.5,8430.19,1986.39,8429.64,1375,1374
15367,15610,8315,8719,243,404,59414,41,59373,0.9993099269532434,15475.95,8525.46,15475.47,8524.9,1374,1375
11330,11589,8319,8618,259,299,43087,1207,41880,0.9719869102049342,11446.64,8458.81,11446.23,8458.45,1377,1376
15535,15706,8320,8598,171,278,25554,0,25554,1.0,15604.79,8443.73,15604.44,8443.52,1379,1377
2515,2742,8321,8610,227,289,39114,0,39114,1.0,2633.83,8453.39,2633.31,8453.01,1378,1378
6598,6988,8321,8711,390,390,89393,0,89393,1.0,6781.65,8511.87,6781.34,8511.26,1383,1379
4214,4544,8322,8657,330,335,56038,0,56038,1.0,4398.96,8487.74,4398.43,8487.28,1382,1380
9087,9622,8322,8954,535,632,173721,8446,165275,0.951381813367411,9364.45,8669.63,9363.97,8669.03,1380,1381
9602,9977,8323,8901,375,578,150075,8051,142024,0.9463534899217058,9784.53,8609.41,9784.01,8608.89,1381,1382
5544,6187,8325,8729,643,404,188236,1071,187165,0.9943103338362481,5850.77,8518.92,5850.32,8518.45,1384,1383
15883,16016,8326,8509,133,183,17447,0,17447,1.0,15945.14,8424.76,15944.61,8424.09,1385,1384
2333,2664,8328,8869,331,541,85685,1325,84360,0.984536383264282,2501.24,8594.46,2500.78,8594.03,1388,1385
4540,4739,8329,8532,199,203,23939,0,23939,1.0,4637.71,8439.21,4637.34,8438.47,1386,1386
13237,13524,8329,8498,287,169,23826,1901,21925,0.9202132124569797,13341.87,8419.65,13342.34,8419.35,1389,1387
2608,3067,8330,8784,459,454,120454,4135,116319,0.9656715426635895,2847.94,8564.09,2847.32,8563.65,1387,1388
4949,5394,8352,8969,445,617,151399,8429,142970,0.944325920250464,5186.68,8687.05,5186.08,8686.34,1390,1389
7339,7526,8355,8602,187,247,24870,0,24870,1.0,7418.45,8495.18,7417.86,8494.73,1391,1390
2057,2235,8358,8548,178,190,24250,9,24241,0.9996288659793815,2146.54,8445.79,2146.09,8445.37,1392,1391
14218,14511,8369,8685,293,316,53300,1075,52225,0.9798311444652908,14373.81,8498.75,14373.24,8498.65,1393,1392
15183,15497,8375,8795,314,420,53063,1190,51873,0.977573827337316,15333.84,8590.96,15333.64,8590.87,1394,1393
8819,9250,8382,8715,431,333,95479,0,95479,1.0,9026.03,8551.18,9025.6,8550.65,1395,1394
14600,14738,8387,8525,138,138,11320,1499,9821,0.8675795053003533,14656.56,8458.3,14656.34,8457.76,1396,1395
12574,12820,8397,8662,246,265,29307,1053,28254,0.9640700174019858,12693.33,8526.02,12693.29,8525.85,1397,1396
13666,14092,8403,8696,426,293,88899,0,88899,1.0,13866.61,8545.32,13866.18,8544.83,1398,1397
10779,11102,8409,8737,323,328,70793,0,70793,1.0,10938.96,8582.04,10938.48,8581.5,1399,1398
7714,8210,8421,8845,496,424,131440,0,131440,1.0,7997.43,8634.7,7996.67,8634.23,1400,1399
10328,10701,8426,8737,373,311,62054,0,62054,1.0,10556.94,8571.73,10555.71,8571.03,1401,1400
2178,2360,8428,8661,182,233,28837,0,28837,1.0,2273.21,8551.83,2272.58,8551.19,1402,1401
4991,5141,8432,8548,150,116,8687,0,8687,1.0,5067.62,8490.01,5066.88,8489.57,1403,1402
6817,7117,8432,8797,300,365,69935,0,69935,1.0,6976.41,8625.52,6975.95,8624.83,1404,1403
8183,8362,8435,8735,179,300,34518,0,34518,1.0,8269.33,8571.56,8268.76,8571.49,1405,1404
14068,14258,8438,8615,190,177,19785,1359,18426,0.9313115996967399,14172.57,8536.26,14172.01,8535.5,1406,1405
15611,15746,8442,8609,135,167,15121,1852,13269,0.8775213279545003,15683.07,8540.59,15682.58,8539.86,1407,1406
13249,13633,8450,8741,384,291,75458,0,75458,1.0,13416.5,8600.77,13416.26,8600.28,1408,1407
12365,12626,8464,8738,261,274,40694,2273,38421,0.9441440998673023,12491.46,8590.29,12490.98,8589.86,1409,1408
7389,7780,8465,8864,391,399,95218,0,95218,1.0,7583.66,8661.25,7583.1,8660.8,1411,1409
16294,16666,8465,8727,372,262,69037,0,69037,1.0,16487.29,8602.02,16486.68,8601.5,1410,1410
13130,13274,8469,8634,144,165,13768,0,13768,1.0,13209.66,8558.81,13209.08,8558.18,1412,1411
14646,15064,8470,8862,418,392,98284,6066,92218,0.9382809002482602,14834.17,8677.14,14833.81,8676.64,1413,1412
15734,15910,8471,8675,176,204,23892,0,23892,1.0,15819.93,8570.96,15819.57,8570.56,1414,1413
15885,16009,8473,8634,124,161,11507,0,11507,1.0,15942.85,8554.97,15942.13,8554.2,1415,1414
10193,10532,8477,8837,339,360,70333,0,70333,1.0,10355.34,8677.6,10354.89,8676.95,1416,1415
9945,10189,8483,8732,244,249,30566,461,30105,0.98491788261467,10040.31,8631.52,10039.82,8630.63,1418,1416
11486,11873,8485,8918,387,433,82179,0,82179,1.0,11684.12,8685.55,11683.67,8685.22,1417,1417
13532,13668,8491,8603,136,112,12750,0,12750,1.0,13602.9,8544.36,13602.33,8543.85,1419,1418
16739,16994,8494,8829,255,335,45167,253,44914,0.9943985653242412,16867.56,8671.04,16866.76,8670.35,1420,1419
16645,16810,8495,8745,165,250,27495,926,26569,0.9663211492998727,16725.84,8616.34,16725.4,8615.86,1421,1420
11805,12159,8497,8817,354,320,65635,0,65635,1.0,11979.27,8669.87,11978.77,8669.45,1423,1421
4520,4727,8498,8683,207,185,24104,1808,22296,0.9249917026219715,4617.15,8584.5,4616.79,8584.03,1422,1422
5379,5576,8499,8793,197,294,39211,0,39211,1.0,5472.78,8635.88,5472.49,8635.49,1424,1423
14849,15190,8509,8762,341,253,38023,0,38023,1.0,15030.38,8627.58,15029.74,8627.05,1426,1424
2765,3261,8510,9038,496,528,147923,6257,141666,0.957700966043144,3023.24,8794.49,3022.71,8793.88,1425,1425
15891,16362,8513,9194,471,681,171698,3703,167995,0.9784330627031183,16082.97,8813.41,16082.54,8813.1,1427,1426
6118,6252,8519,8634,134,115,8722,405,8317,0.9535656959412979,6186.22,8587.48,6185.66,8586.82,1429,1427
4859,5068,8521,8705,209,184,24442,1526,22916,0.9375664839211194,4977.65,8619.41,4977.04,8618.82,1428,1428
12777,13223,8524,8966,446,442,135802,3395,132407,0.9750003681830901,13010.51,8739.67,13009.82,8739.2,1430,1429
10684,10905,8525,8855,221,330,38425,0,38425,1.0,10788.87,8708.24,10788.31,8707.03,1431,1430
3837,4444,8533,8907,607,374,160115,6484,153631,0.9595041064235081,4159.96,8709.56,4159.34,8709.05,1432,1431
2289,2534,8539,8923,245,384,44074,5268,38806,0.880473748695376,2409.05,8745.38,2408.58,8744.76,1433,1432
11746,11896,8541,8707,150,166,13700,1296,12404,0.9054014598540145,11813.38,8609.51,11813.09,8609.1,1434,1433
4455,4893,8551,9013,438,462,104483,55,104428,0.9994735985758448,4670.51,8797.2,4670.06,8796.56,1435,1434
12226,12449,8558,8884,223,326,37656,1391,36265,0.9630603356702783,12338.65,8713.25,12337.99,8712.77,1436,1435
8613,8896,8565,8838,283,273,50145,0,50145,1.0,8755.62,8714.06,8755.16,8713.45,1437,1436
14194,14360,8566,8720,166,154,15626,1352,14274,0.913477537437604,14276.43,8646.24,14275.96,8645.67,1438,1437
14012,14206,8572,8714,194,142,15793,1243,14550,0.9212942442854429,14106.88,8644.36,14106.42,8643.86,1439,1438
7099,7467,8576,9009,368,433,80810,907,79903,0.9887761415666378,7303.79,8822.88,7303.4,8821.98,1440,1439
12553,12824,8582,8878,271,296,56092,0,56092,1.0,12689.09,8725.77,12688.56,8725.32,1441,1440
13476,13783,8583,8884,307,301,51693,0,51693,1.0,13628.84,8746.32,13628.54,8745.74,1442,1441
3075,3717,8590,9076,642,486,146241,735,145506,0.9949740496851088,3415.94,8812.29,3414.98,8812.14,1443,1442
6397,6747,8594,8924,350,330,73840,0,73840,1.0,6579.54,8764.25,6578.82,8763.67,1444,1443
15586,15778,8601,8783,192,182,26809,2531,24278,0.9055914058711627,15684.22,8689.74,15683.8,8689.3,1445,1444
9443,9631,8604,8882,188,278,21587,2405,19182,0.8885903553064344,9557.04,8744.8,9555.93,8744.69,1448,1445
11267,11715,8605,9001,448,396,121287,4995,116292,0.9588166909891415,11474.9,8814.58,11474.53,8814.11,1446,1446
5900,6438,8607,9164,538,557,201064,8507,192557,0.9576900887279672,6179.19,8872.47,6178.47,8871.97,1447,1447
8459,8704,8607,8803,245,196,22638,12,22626,0.9994699178372648,8569.72,8703.26,8569.71,8702.37,1449,1448
10075,10209,8613,8817,134,204,13204,290,12914,0.978036958497425,10147.82,8719.39,10147.35,8718.81,1450,1449
13174,13320,8621,8806,146,185,16944,0,16944,1.0,13247.22,8717.08,13246.66,8716.38,1451,1450
15761,15914,8626,8782,153,156,17407,0,17407,1.0,15841.79,8707.0,15841.24,8706.46,1452,1451
11024,11279,8633,8888,255,255,38021,0,38021,1.0,11156.42,8745.44,11155.78,8745.13,1453,1452
8995,9196,8635,8915,201,280,29129,2037,27092,0.9300696899996567,9086.94,8759.42,9086.63,8759.22,1454,1453
4379,4596,8638,8885,217,247,29930,1481,28449,0.9505178750417641,4484.1,8748.03,4483.63,8747.71,1455,1454
14320,14670,8640,8878,350,238,51936,0,51936,1.0,14484.98,8756.63,14484.59,8756.11,1456,1455
10512,10782,8648,9049,270,401,57612,212,57400,0.9963202110671388,10654.73,8843.94,10654.15,8843.48,1459,1456
12054,12277,8649,8913,223,264,41360,813,40547,0.9803433268858801,12176.22,8782.42,12175.66,8781.95,1457,1457
13764,14075,8649,8887,311,238,58889,0,58889,1.0,13929.75,8769.47,13929.19,8768.95,1458,1458
2164,2395,8657,8922,231,265,39831,1328,38503,0.966659134844719,2272.29,8795.79,2271.87,8795.32,1460,1459
15138,15480,8657,8942,342,285,55536,1807,53729,0.9674625468164794,15277.79,8795.78,15277.75,8795.44,1461,1460
16552,16722,8664,8871,170,207,19898,0,19898,1.0,16649.61,8778.93,16648.91,8778.32,1462,1461
14070,14425,8666,8982,355,316,70531,693,69838,0.9901745331839901,14229.5,8824.57,14229.07,8824.08,1463,1462
8200,8423,8667,9108,223,441,64836,161,64675,0.99751681164785,8314.96,8905.13,8314.56,8904.38,1464,1463
5708,5941,8672,8828,233,156,24964,3373,21591,0.8648854350264381,5819.0,8742.88,5818.61,8742.4,1465,1464
8075,8276,8675,8930,201,255,28671,2640,26031,0.9079208956785603,8194.71,8803.97,8193.98,8803.48,1466,1465
4783,5015,8678,8939,232,261,34175,0,34175,1.0,4895.03,8811.83,4894.62,8811.41,1467,1466
15486,15655,8680,8823,169,143,14850,0,14850,1.0,15561.82,8752.53,15561.59,8752.1,1468,1467
8848,9020,8683,8880,172,197,22311,0,22311,1.0,8928.89,8787.93,8928.46,8787.15,1469,1468
6658,6889,8691,9020,231,329,38020,981,37039,0.9741977906365071,6780.6,8846.6,6780.04,8846.26,1470,1469
5239,5460,8694,9036,221,342,34408,0,34408,1.0,5345.16,8849.3,5344.51,8849.4,1471,1470
16473,16613,8704,8820,140,116,10464,0,10464,1.0,16546.95,8749.84,16546.4,8749.49,1472,1471
12235,12745,8709,9186,510,477,151917,3996,147921,0.9736961630363948,12497.71,8975.84,12497.03,8975.46,1473,1472
5426,5713,8710,8931,287,221,38705,0,38705,1.0,5569.87,8811.19,5569.35,8810.73,1474,1473
8391,8549,8715,8874,158,159,17885,0,17885,1.0,8461.06,8800.34,8460.67,8799.79,1475,1474
9852,10123,8719,8986,271,267,52495,0,52495,1.0,9995.75,8850.45,9995.2,8849.97,1476,1475
7326,7944,8720,9209,618,489,179791,8047,171744,0.955242475986006,7632.87,8961.84,7632.24,8961.3,1477,1476
16341,16565,8721,8945,224,224,31632,1326,30306,0.9580804248861912,16442.45,8823.4,16442.07,8823.03,1478,1477
10894,11131,8723,8941,237,218,31867,0,31867,1.0,11012.86,8828.46,11012.48,8828.01,1479,1478
5835,6016,8730,9014,181,284,30672,598,30074,0.9805033907146583,5924.63,8864.02,5924.08,8863.67,1480,1479
10064,10405,8731,9128,341,397,80490,7913,72577,0.9016896508883091,10240.65,8928.05,10240.02,8927.6,1481,1480
16681,16920,8734,8965,239,231,31962,0,31962,1.0,16786.86,8856.76,16786.5,8856.31,1482,1481
13293,13531,8735,8875,238,140,24536,1889,22647,0.9230110857515488,13406.69,8806.38,13406.34,8805.9,1483,1482
3670,3903,8739,8960,233,221,29077,400,28677,0.986243422636448,3778.85,8832.19,3778.25,8831.83,1484,1483
10373,10614,8744,8977,241,233,22237,288,21949,0.9870486126725727,10484.04,8870.28,10484.34,8869.73,1486,1484
14549,14911,8744,8981,362,237,55706,0,55706,1.0,14732.74,8878.48,14732.16,8877.86,1485,1485
14981,15148,8749,8926,167,177,19831,0,19831,1.0,15079.79,8840.93,15079.06,8840.43,1487,1486
16199,16422,8758,9062,223,304,44785,862,43923,0.9807524840906554,16305.82,8927.28,16305.38,8926.61,1488,1487
15744,15921,8767,8986,177,219,29395,0,29395,1.0,15833.44,8876.37,15832.91,8875.93,1489,1488
2533,2991,8768,9292,458,524,112844,2027,110817,0.982037148629967,2742.98,9007.88,2742.71,9007.5,1490,1489
15391,15586,8768,9075,195,307,34902,0,34902,1.0,15498.18,8923.4,15497.75,8922.91,1491,1490
15547,15777,8773,9064,230,291,45341,198,45143,0.9956330914624733,15660.4,8906.75,15659.81,8906.38,1492,1491
11821,12108,8781,9081,287,300,55344,0,55344,1.0,11971.66,8920.46,11971.12,8920.04,1493,1492
6777,7138,8783,9259,361,476,117890,0,117890,1.0,6959.38,9009.9,6958.86,9009.51,1494,1493
8515,8795,8785,9210,280,425,63160,0,63160,1.0,8664.93,8983.64,8664.36,8983.31,1495,1494
5458,5900,8790,9277,442,487,112699,0,112699,1.0,5665.2,9013.15,5664.8,9012.8,1496,1495
13640,13838,8797,9004,198,207,25460,0,25460,1.0,13741.64,8889.28,13741.22,8888.99,1497,1496
9429,9771,8799,9291,342,492,131996,0,131996,1.0,9592.01,9043.19,9591.53,9042.7,1498,1497
13160,13356,8804,8950,196,146,15797,0,15797,1.0,13263.83,8874.7,13263.03,8874.65,1499,1498
8697,8894,8807,8958,197,151,17488,0,17488,1.0,8786.8,8880.34,8786.44,8879.74,1500,1499
3705,4125,8816,9088,420,272,65234,660,64574,0.9898825765705,3949.32,8949.46,3948.07,8949.05,1501,1500
12664,12986,8820,9242,322,422,80251,2587,77664,0.9677636415745599,12821.44,8999.09,12820.79,8999.03,1502,1501
11120,11331,8822,9016,211,194,28225,0,28225,1.0,11228.32,8922.39,11227.84,8921.85,1503,1502
4296,4473,8823,9022,177,199,21588,0,21588,1.0,4379.31,8910.23,4378.8,8909.87,1504,1503
6344,6535,8826,9080,191,254,27012,2465,24547,0.9087442618095661,6432.04,8965.91,6431.58,8965.21,1505,1504
13795,14197,8828,9245,402,417,106861,5578,101283,0.9478013494165317,14012.8,9037.05,14012.03,9036.21,1507,1505
7677,8222,8832,9476,545,644,219161,8837,210324,0.959678044907625,7961.43,9164.87,7960.84,9164.41,1506,1506
16556,16877,8834,9156,321,322,57633,2554,55079,0.9556851109607343,16716.86,9008.03,16716.06,9007.13,1508,1507
4889,5071,8842,9048,182,206,21357,0,21357,1.0,4977.93,8947.13,4977.52,8946.56,1509,1508
3600,3717,8846,8945,117,99,8179,184,7995,0.9775033622692261,3657.59,8899.82,3657.1,8899.22,1510,1509
10636,11194,8847,9283,558,436,149709,7636,142073,0.9489943824352577,10928.46,9063.52,10927.91,9063.13,1511,1510
8770,9132,8852,9250,362,398,108382,0,108382,1.0,8951.75,9055.15,8951.32,9054.57,1512,1511
5295,5518,8856,9083,223,227,28478,0,28478,1.0,5418.06,8977.59,5417.47,8976.99,1513,1512
9746,9902,8857,9035,156,178,13546,0,13546,1.0,9811.92,8937.41,9811.62,8937.04,1514,1513
14366,14641,8859,9066,275,207,37488,0,37488,1.0,14505.03,8961.75,14504.5,8961.25,1515,1514
14855,15167,8859,9073,312,214,36350,470,35880,0.98707015130674,15021.28,8961.12,15020.68,8960.58,1516,1515
16361,16613,8861,9058,252,197,23982,0,23982,1.0,16515.29,8973.62,16513.96,8973.3,1518,1516
13307,13847,8862,9193,540,331,102994,0,102994,1.0,13582.47,9012.49,13581.97,9012.03,1517,1517
8389,8539,8868,9054,150,186,17713,0,17713,1.0,8462.77,8940.67,8461.9,8940.83,1519,1518
4113,4330,8871,9128,217,257,34613,103,34510,0.9970242394476064,4224.06,8982.52,4223.49,8982.42,1520,1519
9099,9457,8872,9321,358,449,102374,0,102374,1.0,9280.74,9078.82,9280.22,9078.37,1521,1520
3371,3610,8874,9067,239,193,22050,2086,19964,0.9053968253968254,3486.32,8965.76,3486.05,8965.21,1522,1521
11657,11908,8876,9058,251,182,23277,0,23277,1.0,11766.08,8971.16,11765.9,8970.64,1523,1522
12224,12332,8878,9034,108,156,13381,0,13381,1.0,12277.47,8953.01,12276.97,8952.56,1524,1523
15151,15408,8880,9112,257,232,31959,0,31959,1.0,15267.96,8972.93,15267.66,8972.7,1525,1524
12081,12253,8882,9111,172,229,26393,2385,24008,0.9096351305270337,12162.85,8995.99,12162.62,8995.2,1526,1525
4395,4966,8889,9323,571,434,149667,4363,145304,0.9708486172636587,4674.34,9120.93,4674.12,9120.49,1527,1526
2365,2592,8895,9201,227,306,42997,0,42997,1.0,2484.45,9033.35,2483.9,9032.9,1528,1527
2252,2408,8901,9044,156,143,16110,0,16110,1.0,2331.55,8977.73,2331.12,8977.08,1529,1528
6327,6782,8905,9235,455,330,72992,45,72947,0.9993834940815431,6551.77,9064.72,6551.12,9064.27,1530,1529
4289,4499,8916,9158,210,242,22630,0,22630,1.0,4404.3,9049.42,4403.86,9048.54,1531,1530
15276,15593,8921,9432,317,511,86284,0,86284,1.0,15409.19,9167.25,15408.72,9166.91,1532,1531
13146,13342,8925,9128,196,203,24165,0,24165,1.0,13239.63,9010.58,13239.16,9010.28,1533,1532
10318,10615,8928,9148,297,220,34998,2796,32202,0.9201097205554604,10464.65,9017.89,10463.97,9017.65,1534,1533
12939,13238,8931,9274,299,343,48298,0,48298,1.0,13097.68,9084.7,13097.23,9084.38,1535,1534
9712,10016,8936,9258,304,322,55111,0,55111,1.0,9874.76,9094.86,9874.19,9094.5,1536,1535
11284,11415,8938,9220,131,282,24036,1135,22901,0.9527791645864536,11353.11,9078.38,11352.51,9077.96,1537,1536
3243,3752,8939,9475,509,536,168397,6769,161628,0.9598033219119105,3527.85,9218.7,3527.24,9218.13,1538,1537
14139,14479,8941,9342,340,401,79906,1798,78108,0.9774985608089505,14322.96,9113.89,14322.42,9113.62,1539,1538
4994,5255,8943,9294,261,351,57534,1511,56023,0.9737372683978169,5113.59,9099.55,5113.1,9099.07,1540,1539
15715,16039,8946,9605,324,659,113510,919,112591,0.9919037970222888,15889.67,9225.95,15889.24,9225.81,1541,1540
11126,11314,8953,9159,188,206,23400,0,23400,1.0,11221.67,9069.49,11220.9,9068.57,1542,1541
7083,7337,8963,9206,254,243,42382,0,42382,1.0,7204.35,9084.24,7203.87,9083.73,1543,1542
5119,5542,8965,9715,423,750,193157,317,192840,0.9983588479837645,5311.78,9349.79,5311.19,9349.15,1544,1543
14596,15065,8969,9288,469,319,90158,5110,85048,0.9433217240843852,14855.28,9103.12,14854.6,9102.69,1545,1544
11389,11859,8973,9376,470,403,111161,1673,109488,0.984949757558856,11626.06,9152.75,11625.61,9152.42,1546,1545
3687,3950,8978,9317,263,339,53156,0,53156,1.0,3810.46,9155.41,3809.99,9154.87,1547,1546
3124,3445,8979,9301,321,322,59827,0,59827,1.0,3263.83,9116.29,3263.39,9115.96,1548,1547
8304,8659,8980,9357,355,377,88690,0,88690,1.0,8483.23,9165.42,8482.73,9164.96,1549,1548
9899,10168,8980,9259,269,279,34352,0,34352,1.0,10065.65,9096.85,10063.99,9097.38,1550,1549
15998,16237,8996,9717,239,721,123555,0,123555,1.0,16122.05,9360.89,16121.56,9360.33,1551,1550
2922,3154,9006,9216,232,210,27028,1793,25235,0.9336613881900252,3052.18,9121.1,3051.54,9120.38,1554,1551
11756,12094,9006,9330,338,324,59270,0,59270,1.0,11920.1,9163.88,11919.69,9163.46,1552,1552
5770,6208,9009,9330,438,321,76438,0,76438,1.0,5951.2,9167.67,5951.21,9167.25,1553,1553
16219,16770,9016,9394,551,378,126860,1911,124949,0.9849361500867098,16487.22,9186.94,16486.66,9186.66,1555,1554
15572,15735,9019,9208,163,189,23314,1390,21924,0.9403791713133739,15653.11,9114.0,15652.71,9113.52,1557,1555
2569,2841,9020,9476,272,456,45306,2923,42383,0.9354831589634927,2706.44,9265.27,2705.4,9264.69,1559,1556
15027,15313,9020,9379,286,359,62420,1520,60900,0.9756488305030439,15179.08,9194.28,15178.47,9193.83,1556,1557
3939,4198,9021,9214,259,193,30503,1620,28883,0.9468904697898567,4063.57,9114.93,4063.14,9114.45,1560,1558
6550,6821,9021,9311,271,290,49081,0,49081,1.0,6699.58,9187.54,6699.03,9186.86,1558,1559
13174,13701,9024,9465,527,441,151745,5140,146605,0.9661273847573232,13434.25,9249.66,13433.69,9249.31,1561,1560
11992,12232,9031,9286,240,255,38011,0,38011,1.0,12119.8,9161.07,12119.26,9160.38,1562,1561
2295,2476,9042,9338,181,296,33026,0,33026,1.0,2385.83,9179.07,2385.37,9178.72,1563,1562
10387,10659,9042,9381,272,339,68728,409,68319,0.9940490047724363,10529.11,9204.64,10528.58,9204.18,1564,1563
10612,10802,9044,9299,190,255,25220,1262,23958,0.949960348929421,10714.01,9176.83,10713.3,9175.95,1565,1564
4818,5037,9048,9318,219,270,35739,0,35739,1.0,4938.92,9191.84,4938.35,9191.26,1566,1565
4158,4406,9064,9377,248,313,54733,2000,52733,0.9634589735625674,4281.24,9221.38,4280.7,9220.88,1567,1566
14415,14976,9064,9477,561,413,143659,5921,137738,0.9587843434800465,14680.33,9275.92,14679.87,9275.47,1568,1567
6203,6350,9070,9306,147,236,16415,0,16415,1.0,6270.52,9192.89,6270.48,9192.04,1569,1568
8175,8366,9076,9274,191,198,24805,1945,22860,0.9215883894376133,8266.26,9173.32,8265.89,9172.71,1570,1569
10153,10404,9077,9370,251,293,51794,0,51794,1.0,10276.58,9214.57,10275.97,9214.22,1571,1570
12185,12356,9089,9283,171,194,17015,0,17015,1.0,12275.6,9196.98,12274.71,9196.54,1572,1571
12820,13139,9092,9302,319,210,41664,0,41664,1.0,12965.49,9193.43,12965.22,9193.04,1573,1572
2871,3049,9104,9332,178,228,23843,1008,22835,0.9577234408421759,2956.92,9218.82,2956.45,9218.32,1574,1573
13636,14146,9115,9536,510,421,102935,4807,98128,0.9533006266090251,13856.25,9294.54,13855.72,9294.37,1575,1574
7140,7421,9117,9357,281,240,30332,0,30332,1.0,7262.32,9228.17,7261.92,9227.87,1577,1575
7400,7762,9118,9597,362,479,111928,0,111928,1.0,7597.78,9339.16,7597.37,9338.93,1576,1576
2458,2692,9124,9486,234,362,48484,0,48484,1.0,2577.06,9306.38,2576.6,9305.93,1578,1577
12333,12875,9133,9563,542,430,157362,5987,151375,0.9619539660146669,12607.75,9336.56,12607.21,9336.08,1579,1578
5539,5781,9138,9354,242,216,27106,0,27106,1.0,5653.94,9245.74,5653.57,9245.16,1580,1579
6290,6439,9141,9321,149,180,16923,955,15968,0.9435679253087514,6355.08,9243.68,6354.7,9242.99,1581,1580
11096,11342,9149,9402,246,253,46924,0,46924,1.0,11223.36,9274.79,11222.81,9274.27,1582,1581
3600,4192,9153,9617,592,464,146422,360,146062,0.9975413530753575,3885.24,9384.29,3884.97,9383.58,1583,1582
7023,7175,9158,9407,152,249,23282,0,23282,1.0,7093.82,9295.57,7093.39,9294.92,1584,1583
6894,7083,9160,9410,189,250,21375,0,21375,1.0,6975.14,9299.12,6975.38,9297.81,1585,1584
8745,9032,9163,9538,287,375,65245,2701,62544,0.9586021917388305,8892.29,9353.82,8891.53,9353.15,1586,1585
15596,15766,9174,9295,170,121,12332,0,12332,1.0,15687.72,9233.45,15687.06,9232.91,1587,1586
9014,9277,9175,9545,263,370,61052,0,61052,1.0,9134.52,9353.79,9134.05,9353.38,1588,1587
9895,10186,9175,9443,291,268,57233,0,57233,1.0,10032.94,9305.93,10032.57,9305.38,1589,1588
11280,11785,9179,9715,505,536,151984,6529,145455,0.9570415306874408,11531.09,9438.06,11530.52,9437.61,1590,1589
8374,8792,9181,9671,418,490,106481,0,106481,1.0,8604.11,9419.59,8603.34,9419.45,1591,1590
5640,5923,9187,9669,283,482,71769,0,71769,1.0,5779.5,9403.33,5778.96,9403.08,1593,1591
6304,6603,9188,9446,299,258,40692,467,40225,0.988523542711098,6464.84,9325.94,6464.18,9325.39,1592,1592
2974,3210,9193,9404,236,211,24195,20,24175,0.9991733829303575,3092.7,9298.96,3091.97,9298.4,1594,1593
9252,9505,9195,9469,253,274,43268,0,43268,1.0,9385.53,9324.18,9384.97,9323.8,1595,1594
15427,15651,9195,9426,224,231,27069,0,27069,1.0,15553.21,9302.79,15552.6,9302.57,1596,1595
9400,9899,9196,9695,499,499,143702,2825,140877,0.9803412617778459,9633.24,9436.92,9632.83,9436.34,1597,1596
6732,6905,9197,9390,173,193,20217,1210,19007,0.9401493792352971,6829.73,9294.79,6829.05,9294.33,1598,1597
14124,14603,9206,9473,479,267,58478,0,58478,1.0,14340.66,9353.11,14340.43,9352.63,1599,1598
2819,2994,9215,9437,175,222,21297,0,21297,1.0,2897.19,9331.24,2896.79,9330.69,1600,1599
5757,6313,9219,9834,556,615,168871,5884,162987,0.9651568356911489,6012.24,9510.0,6011.81,9509.54,1601,1600
16227,16534,9224,9532,307,308,59865,0,59865,1.0,16393.19,9379.15,16392.62,9378.64,1602,1601
4313,4546,9233,9500,233,267,30574,0,30574,1.0,4423.09,9368.69,4422.67,9368.15,1603,1602
14938,15090,9235,9375,152,140,11475,0,11475,1.0,15024.91,9301.68,15024.13,9301.28,1604,1603
10740,11148,9239,9605,408,366,97474,0,97474,1.0,10951.99,9395.99,10951.47,9395.72,1605,1604
12834,13354,9239,9605,520,366,105055,1271,103784,0.9879015753652849,13107.41,9416.74,13106.6,9416.14,1606,1605
6942,7532,9243,9909,590,666,203107,0,203107,1.0,7250.34,9564.09,7249.61,9563.84,1607,1606
4880,5051,9244,9418,171,174,15033,0,15033,1.0,4978.64,9340.03,4977.79,9339.08,1608,1607
8076,8332,9247,9488,256,241,37319,0,37319,1.0,8194.36,9356.44,8193.98,9355.9,1609,1608
15597,15868,9252,9554,271,302,51776,807,50969,0.9844136279357231,15742.7,9395.74,15742.15,9395.33,1610,1609
12179,12416,9254,9406,237,152,16511,0,16511,1.0,12295.72,9322.92,12295.64,9322.68,1611,1610
10543,10758,9257,9451,215,194,25308,0,25308,1.0,10674.4,9357.79,10673.52,9357.26,1612,1611
4500,4937,9261,9797,437,536,160955,1457,159498,0.9909477804355254,4702.83,9509.33,4702.31,9508.87,1613,1612
12015,12530,9268,9829,515,561,171763,0,171763,1.0,12297.3,9550.15,12296.61,9549.51,1614,1613
11737,12108,9270,9644,371,374,86847,0,86847,1.0,11922.21,9454.05,11921.78,9453.64,1615,1614
10214,10501,9280,9447,287,167,27590,0,27590,1.0,10363.62,9376.38,10363.14,9375.77,1616,1615
15049,15269,9289,9475,220,186,22476,2601,19875,0.8842765616657768,15143.54,9380.39,15143.6,9379.89,1617,1616
5007,5163,9291,9479,156,188,19248,2213,17035,0.8850270157938487,5093.06,9383.22,5092.41,9382.82,1618,1617
3187,3433,9298,9502,246,204,23019,0,23019,1.0,3297.18,9405.33,3296.87,9404.86,1619,1618
6459,6798,9306,9806,339,500,98831,7026,91805,0.9289089455737572,6607.34,9524.34,6606.78,9524.27,1620,1619
13939,14247,9312,9621,308,309,62376,591,61785,0.9905252020007695,14083.26,9463.56,14082.87,9463.04,1621,1620
16476,16743,9313,9559,267,246,44380,0,44380,1.0,16613.96,9436.59,16613.47,9436.21,1622,1621
8221,8495,9322,9580,274,258,48872,0,48872,1.0,8353.32,9452.74,8353.07,9452.07,1623,1622
2930,3166,9328,9605,236,277,30719,1869,28850,0.939158175721866,3052.94,9483.8,3052.11,9482.76,1625,1623
6587,7021,9328,9924,434,596,131970,6731,125239,0.948995983935743,6803.38,9634.99,6803.09,9634.41,1624,1624
10035,10253,9334,9544,218,210,25094,0,25094,1.0,10155.74,9442.23,10155.04,9441.68,1626,1625
3876,4406,9336,9921,530,585,169566,3971,165595,0.9765813901371737,4118.94,9618.31,4118.51,9617.94,1628,1626
2458,2726,9337,9775,268,438,51063,0,51063,1.0,2602.88,9574.94,2602.06,9573.94,1627,1627
3067,3313,9339,9545,246,206,26658,0,26658,1.0,3188.29,9444.64,3187.81,9444.15,1629,1628
15214,15409,9342,9561,195,219,27414,3247,24167,0.8815568687531918,15297.37,9458.43,15297.05,9457.79,1630,1629
5377,5718,9343,9760,341,417,97841,3358,94483,0.9656790098220582,5553.95,9552.57,5553.42,9552.11,1631,1630
9751,9978,9348,9614,227,266,32089,0,32089,1.0,9854.52,9475.16,9854.16,9474.82,1632,1631
14912,15070,9352,9507,158,155,14914,0,14914,1.0,15001.55,9432.16,15000.87,9431.73,1633,1632
15405,15604,9352,9539,199,187,25771,504,25267,0.9804431337549959,15502.08,9447.26,15501.56,9446.71,1634,1633
7917,8146,9356,9523,229,167,21558,1679,19879,0.9221170795064477,8038.12,9450.54,8037.61,9450.04,1635,1634
13739,13948,9361,9534,209,173,20754,1294,19460,0.9376505733834442,13860.79,9440.04,13859.5,9440.15,1636,1635
10474,10791,9375,9681,317,306,70303,0,70303,1.0,10625.34,9536.31,10624.85,9535.74,1637,1636
2756,3142,9377,9758,386,381,73128,0,73128,1.0,2936.32,9583.1,2935.9,9582.57,1638,1637
6967,7137,9378,9639,170,261,27461,0,27461,1.0,7040.59,9499.31,7040.21,9498.82,1639,1638
6252,6492,9381,9835,240,454,79906,0,79906,1.0,6374.09,9609.6,6373.54,9609.06,1641,1639
12689,13031,9381,9809,342,428,80374,1731,78643,0.9784631846119392,12869.4,9608.34,12868.74,9607.78,1640,1640
11081,11409,9385,9681,328,296,61329,2447,58882,0.9601004418790458,11254.49,9528.06,11253.88,9527.57,1642,1641
6136,6306,9388,9585,170,197,14776,1157,13619,0.9216973470492691,6217.2,9506.19,6217.17,9504.88,1644,1642
13341,13843,9389,9848,502,459,120205,0,120205,1.0,13592.51,9602.78,13592.14,9602.45,1643,1643
4823,5144,9404,9923,321,519,103351,1044,102307,0.9898985012239843,4980.29,9653.93,4979.68,9653.69,1645,1644
9129,9425,9405,9704,296,299,58397,0,58397,1.0,9282.78,9558.24,9282.2,9557.74,1646,1645
4111,4548,9407,9963,437,556,121009,3801,117208,0.9685891132064557,4355.05,9729.99,4354.67,9729.11,1647,1646
14611,14860,9410,9565,249,155,17912,0,17912,1.0,14732.27,9472.9,14732.04,9472.64,1648,1647
14131,14819,9416,9771,688,355,148909,6352,142557,0.9573430753010228,14498.29,9591.04,14497.6,9590.49,1649,1648
16188,16483,9417,9709,295,292,52888,0,52888,1.0,16336.66,9586.75,16336.18,9585.98,1650,1649
15023,15214,9420,9576,191,156,17389,0,17389,1.0,15108.37,9505.48,15107.97,9504.76,1651,1650
10149,10497,9426,9769,348,343,88963,0,88963,1.0,10330.65,9589.57,10330.09,9589.16,1652,1651
2646,2796,9432,9590,150,158,13982,0,13982,1.0,2718.78,9508.93,2718.38,9508.62,1653,1652
9858,10210,9437,9905,352,468,104002,0,104002,1.0,10029.85,9670.7,10029.48,9670.31,1654,1653
15343,15470,9437,9648,127,211,15754,0,15754,1.0,15404.28,9547.22,15403.81,9546.6,1655,1654
8576,8911,9441,9773,335,332,70868,0,70868,1.0,8757.4,9617.75,8756.8,9617.2,1656,1655
15558,15758,9446,9691,200,245,31193,0,31193,1.0,15658.5,9570.31,15657.96,9569.77,1657,1656
8889,9157,9449,9755,268,306,56545,8077,48468,0.8571580157396763,9021.07,9602.48,9020.58,9601.98,1658,1657
7706,7926,9456,9678,220,222,26084,0,26084,1.0,7809.86,9541.91,7809.13,9541.54,1659,1658
3695,4001,9464,9763,306,299,36870,2066,34804,0.9439652834282615,3858.55,9637.11,3858.29,9635.96,1661,1659
3434,3672,9466,9612,238,146,18395,2391,16004,0.8700190269094863,3543.2,9530.59,3543.32,9530.45,1660,1660
15754,16002,9471,9655,248,184,17797,0,17797,1.0,15834.7,9555.3,15836.1,9555.21,1662,1661
14789,14943,9473,9622,154,149,14894,263,14631,0.9823418826373036,14870.72,9543.83,14870.06,9543.41,1663,1662
14913,15050,9473,9643,137,170,13867,1075,12792,0.9224778250522824,14984.55,9565.68,14983.72,9564.7,1664,1663
3261,3547,9475,9684,286,209,34939,1,34938,0.9999713786885716,3399.28,9580.2,3398.93,9579.86,1665,1664
15007,15326,9480,9782,319,302,43828,3077,40751,0.9297937391621794,15166.87,9656.05,15166.58,9655.43,1667,1665
8063,8251,9481,9679,188,198,26888,0,26888,1.0,8164.48,9574.77,8163.9,9574.26,1666,1666
10789,11025,9485,9763,236,278,39994,0,39994,1.0,10899.77,9605.83,10899.34,9605.55,1668,1667
13719,14073,9490,9768,354,278,57804,0,57804,1.0,13883.01,9625.74,13882.65,9625.25,1669,1668
7739,8127,9491,9905,388,414,91313,2777,88536,0.9695881199829159,7936.1,9687.63,7935.6,9687.21,1670,1669
12480,12775,9498,9900,295,402,52410,1744,50666,0.9667239076512116,12602.66,9679.85,12602.16,9679.43,1671,1670
16439,16724,9515,9846,285,331,70596,0,70596,1.0,16586.76,9678.58,16586.28,9678.18,1672,1671
11522,12172,9519,10042,650,523,178550,0,178550,1.0,11867.99,9776.98,11867.32,9776.53,1674,1672
13017,13184,9519,9691,167,172,17015,0,17015,1.0,13089.4,9594.73,13088.97,9594.41,1673,1673
3089,3303,9524,9756,214,232,33083,0,33083,1.0,3197.93,9648.48,3197.53,9648.02,1675,1674
15434,15581,9534,9693,147,159,15403,1546,13857,0.8996299422190482,15506.13,9605.41,15505.63,9605.09,1676,1675
15757,16073,9541,9896,316,355,66045,0,66045,1.0,15914.22,9725.49,15913.68,9724.82,1677,1676
8215,8423,9545,9723,208,178,20308,0,20308,1.0,8320.02,9638.5,8319.21,9637.93,1678,1677
15227,15391,9556,9746,164,190,19751,0,19751,1.0,15305.36,9635.31,15304.97,9635.07,1679,1678
6004,6301,9557,10037,297,480,88116,1012,87104,0.9885151391347768,6153.02,9780.11,6152.14,9780.25,1680,1679
13202,13813,9561,10034,611,473,156067,2053,154014,0.9868453933246618,13490.19,9820.55,13489.75,9820.0,1681,1680
7574,7741,9563,9788,167,225,21584,0,21584,1.0,7652.98,9648.95,7652.16,9649.23,1682,1681
10901,11373,9566,10045,472,479,144996,8661,136335,0.9402673177191095,11146.18,9816.96,11145.61,9816.38,1683,1682
9566,9883,9568,9917,317,349,79123,0,79123,1.0,9722.53,9740.8,9722.05,9740.3,1684,1683
2699,3004,9570,9955,305,385,60580,0,60580,1.0,2851.48,9753.8,2850.83,9753.2,1686,1684
13077,13252,9571,9775,175,204,17723,758,16965,0.9572307171472099,13161.56,9679.63,13161.24,9678.75,1685,1685
3511,3707,9573,9842,196,269,33146,410,32736,0.9876304833162373,3618.23,9701.4,3617.72,9700.99,1687,1686
12030,12224,9576,9777,194,201,19466,2039,17427,0.895253262098017,12129.04,9678.13,12128.49,9677.58,1688,1687
13854,14560,9583,9913,706,330,119028,1144,117884,0.9903888160768894,14197.94,9760.81,14197.39,9760.4,1689,1688
14808,14981,9591,9714,173,123,13570,1699,11871,0.8747973470891672,14890.28,9653.48,14889.89,9652.95,1690,1689
7367,7609,9596,9828,242,232,36470,0,36470,1.0,7496.74,9720.25,7496.21,9719.69,1691,1690
11271,11491,9596,9804,220,208,25710,0,25710,1.0,11387.63,9702.42,11387.04,9701.87,1692,1691
16065,16724,9597,10209,659,612,210758,2809,207949,0.986671917554731,16377.99,9907.57,16377.52,9906.94,1693,1692
5047,5207,9613,9870,160,257,23243,0,23243,1.0,5121.63,9735.24,5121.08,9734.9,1695,1693
9187,9598,9613,10139,411,526,128243,7123,121120,0.944457007400014,9412.56,9878.76,9411.88,9878.29,1694,1694
10659,10907,9619,9852,248,233,31531,2285,29246,0.9275316355332847,10796.39,9738.27,10795.71,9737.67,1696,1695
3287,3583,9621,9906,296,285,52473,2976,49497,0.9432851180607169,3430.46,9760.06,3430.0,9759.6,1697,1696
15631,15845,9625,9947,214,322,38332,0,38332,1.0,15737.88,9816.86,15737.4,9816.0,1699,1697
15497,15689,9626,9887,192,261,33870,0,33870,1.0,15588.43,9748.45,15587.93,9748.08,1698,1698
5554,5776,9627,9870,222,243,31113,1197,29916,0.961527335840324,5678.73,9755.11,5678.09,9754.56,1700,1699
5299,5476,9630,9815,177,185,15024,241,14783,0.9839589989350372,5388.64,9720.5,5388.17,9720.1,1701,1700
8133,8687,9634,10281,554,647,214011,1053,212958,0.995079692165356,8419.83,9949.02,8419.1,9948.79,1702,1701
10354,10779,9636,9936,425,300,83492,0,83492,1.0,10554.94,9800.57,10554.5,9800.04,1703,1702
15323,15499,9639,9849,176,210,27202,0,27202,1.0,15414.04,9747.74,15413.49,9747.21,1704,1703
3682,3896,9640,9811,214,171,16204,1228,14976,0.9242162429029869,3767.18,9746.04,3767.02,9745.31,1705,1704
14911,15061,9643,9788,150,145,13361,0,13361,1.0,14993.9,9716.41,14993.17,9715.99,1706,1705
4667,4866,9648,9895,199,247,28217,0,28217,1.0,4782.06,9787.16,4781.6,9786.38,1707,1706
12921,13107,9651,9850,186,199,20142,0,20142,1.0,13024.18,9747.09,13023.51,9746.68,1708,1707
9004,9298,9660,10065,294,405,76579,0,76579,1.0,9151.72,9838.55,9151.36,9838.48,1709,1708
7943,8316,9664,10050,373,386,86659,1465,85194,0.9830946583736253,8127.67,9856.0,8127.27,9855.55,1710,1709
14561,14966,9671,10145,405,474,119717,5022,114695,0.9580510704411237,14799.41,9895.68,14798.73,9895.16,1711,1710
7564,7830,9678,9959,266,281,40006,0,40006,1.0,7692.11,9824.36,7691.41,9824.04,1712,1711
8776,9020,9689,9884,244,195,34478,0,34478,1.0,8894.95,9799.52,8894.6,9798.93,1713,1712
11346,11661,9701,10014,315,313,62707,178,62529,0.9971614014384359,11500.37,9868.75,11499.88,9868.17,1714,1713
5058,5441,9703,10082,383,379,87446,0,87446,1.0,5260.57,9888.1,5259.92,9887.74,1715,1714
12573,12853,9708,9944,280,236,39444,1402,38042,0.9644559375316905,12720.16,9823.56,12719.67,9823.11,1716,1715
10167,10379,9710,9892,212,182,22466,0,22466,1.0,10254.01,9800.23,10253.71,9799.75,1717,1716
8621,8780,9711,9915,159,204,22174,0,22174,1.0,8699.68,9818.28,8699.03,9817.64,1720,1717
5759,6052,9712,10176,293,464,77654,2500,75154,0.9678059082597161,5909.7,9962.0,5909.44,9961.17,1718,1718
15000,15192,9719,9906,192,187,19676,0,19676,1.0,15097.93,9797.82,15097.29,9797.53,1719,1719
3107,3347,9729,9903,240,174,22409,0,22409,1.0,3238.75,9808.85,3237.96,9808.21,1721,1720
12166,12543,9730,10015,377,285,45165,0,45165,1.0,12329.2,9856.12,12329.69,9856.01,1722,1721
5196,5683,9732,10634,487,902,209726,7261,202465,0.9653786368881302,5445.07,10184.86,5444.52,10184.33,1723,1722
7035,7398,9732,10036,363,304,52236,0,52236,1.0,7227.87,9878.23,7227.58,9877.75,1724,1723
13155,13355,9735,9942,200,207,16170,0,16170,1.0,13237.75,9844.7,13237.55,9844.13,1725,1724
6252,7103,9745,10953,851,1208,345403,2372,343031,0.9931326595310406,6677.9,10302.26,6677.37,10302.03,1726,1725
4339,4679,9747,10156,340,409,71680,0,71680,1.0,4497.49,9933.07,4496.99,9932.69,1727,1726
2566,2869,9750,10036,303,286,48110,0,48110,1.0,2725.19,9880.54,2724.71,9880.21,1728,1727
9754,10024,9751,10068,270,317,53160,0,53160,1.0,9897.8,9919.23,9897.27,9918.62,1729,1728
15965,16138,9751,10063,173,312,35210,0,35210,1.0,16057.13,9910.38,16056.63,9909.83,1730,1729
2991,3152,9756,9874,161,118,13066,0,13066,1.0,3064.81,9808.17,3064.17,9807.73,1731,1730
6394,6636,9756,10279,242,523,75096,0,75096,1.0,6497.55,9983.54,6496.98,9983.38,1732,1731
12792,13117,9759,10154,325,395,78511,0,78511,1.0,12962.94,9969.14,12962.35,9968.57,1733,1732
13045,13293,9768,10107,248,339,44929,1892,43037,0.9578891139353202,13152.0,9939.56,13151.84,9939.51,1734,1733
13770,14066,9768,10044,296,276,39296,1047,38249,0.9733560667752443,13898.01,9912.11,13897.81,9911.63,1735,1734
3679,3953,9770,9951,274,181,28661,1885,26776,0.9342311852342905,3804.03,9870.02,3804.1,9869.15,1737,1735
14206,14757,9770,10213,551,443,152474,7325,145149,0.9519590225218726,14491.54,10025.61,14491.04,10024.9,1736,1736
15066,15354,9772,10120,288,348,57637,1599,56038,0.972257404098062,15206.33,9932.83,15205.85,9932.71,1738,1737
14940,15081,9781,10119,141,338,27825,0,27825,1.0,15004.45,9938.96,15003.77,9938.9,1739,1738
7236,7605,9790,10198,369,408,85557,1494,84063,0.9825379571513728,7414.75,9979.66,7414.52,9979.72,1740,1739
6126,6449,9798,10321,323,523,96205,3108,93097,0.967693986799023,6289.6,10046.7,6289.33,10046.11,1745,1740
5644,5825,9801,9973,181,172,20306,864,19442,0.9574509997045209,5741.07,9886.98,5740.46,9886.45,1741,1741
10765,11070,9804,10117,305,313,47316,0,47316,1.0,10926.87,9950.0,10926.32,9949.5,1742,1742
15349,15562,9806,9976,213,170,24195,3370,20825,0.8607150237652408,15453.87,9891.0,15453.32,9890.53,1743,1743
3494,3727,9807,10018,233,211,23091,3153,19938,0.8634532934909706,3611.28,9895.35,3610.48,9895.24,1744,1744
4429,4820,9812,10265,391,453,59591,836,58755,0.985971035894682,4618.55,10044.99,4618.18,10044.2,1746,1745
16695,16842,9822,10053,147,231,24031,0,24031,1.0,16762.94,9935.79,16762.54,9935.31,1747,1746
15545,15652,9828,9971,107,143,7745,0,7745,1.0,15596.8,9910.46,15596.78,9909.29,1752,1747
3302,3541,9831,10090,239,259,33986,3376,30610,0.9006649796975225,3430.6,9958.35,3429.97,9957.79,1748,1748
3117,3306,9832,10107,189,275,32505,5684,26821,0.8251345946777419,3203.9,9963.52,3203.64,9963.11,1749,1749
2854,3151,9834,10061,297,227,30313,0,30313,1.0,3037.29,9941.44,3036.02,9940.9,1750,1750
10065,10490,9838,10269,425,431,117416,8069,109347,0.9312785310349526,10301.02,10065.06,10300.36,10064.57,1751,1751
10428,10906,9843,10263,478,420,117881,6933,110948,0.9411864507426981,10674.24,10063.67,10673.8,10062.99,1753,1752
7482,7957,9848,10157,475,309,56429,1104,55325,0.980435591628418,7709.28,9982.76,7708.73,9982.37,1754,1753
14046,14282,9852,10073,236,221,33842,2786,31056,0.9176762602683056,14144.86,9955.13,14144.58,9954.59,1755,1754
9973,10189,9855,10094,216,239,31085,2683,28402,0.9136882740871803,10089.41,9977.18,10088.81,9976.73,1756,1755
8669,9034,9858,10160,365,302,77954,7945,70009,0.898080919516638,8843.76,10002.3,8843.35,10001.78,1757,1756
4583,5148,9867,10265,565,398,135685,897,134788,0.9933890997531046,4894.22,10068.37,4893.31,10067.96,1758,1757
3885,4152,9872,10090,267,218,34070,1520,32550,0.9553859700616378,4027.11,9981.67,4026.44,9981.15,1759,1758
9568,9779,9877,10071,211,194,22536,0,22536,1.0,9672.07,9971.61,9671.54,9971.1,1760,1759
15545,16086,9877,10186,541,309,101621,2166,99455,0.9786855079166707,15825.54,10037.63,15824.63,10037.13,1763,1760
11565,11845,9878,10159,280,281,54240,0,54240,1.0,11706.21,10028.12,11705.68,10027.54,1761,1761
12520,12920,9878,10245,400,367,99525,771,98754,0.9922532027128862,12712.16,10063.96,12711.69,10063.46,1762,1762
13241,13523,9878,10105,282,227,35523,0,35523,1.0,13356.88,10005.58,13356.75,10005.05,1764,1763
15238,15363,9883,10041,125,158,12703,0,12703,1.0,15302.78,9962.49,15302.34,9961.96,1765,1764
12129,12565,9892,10313,436,421,116330,461,115869,0.9960371357345482,12343.0,10077.34,12342.43,10076.96,1766,1765
3246,3467,9918,10219,221,301,31871,5730,26141,0.8202127325782059,3339.43,10070.63,3338.87,10070.08,1767,1766
4111,4427,9921,10172,316,251,34914,509,34405,0.9854213209600733,4259.3,10039.42,4259.36,10039.23,1768,1767
11257,11435,9923,10137,178,214,16753,532,16221,0.968244493523548,11357.28,10029.62,11356.59,10029.14,1769,1768
11842,12155,9926,10189,313,263,54712,0,54712,1.0,11997.84,10052.45,11997.42,10051.8,1772,1769
3565,3731,9928,10059,166,131,13456,1051,12405,0.9218935790725327,3659.33,9985.45,3658.6,9985.08,1770,1770
3594,4267,9929,10471,673,542,178655,4631,174024,0.9740785312473762,3948.1,10179.2,3947.52,10178.83,1771,1771
2748,2920,9936,10223,172,287,20262,859,19403,0.9576053696574869,2855.86,10090.32,2854.93,10088.88,1773,1772
15355,15582,9946,10207,227,261,46030,45,45985,0.9990223767108407,15472.69,10064.82,15472.18,10064.38,1774,1773
13865,14076,9948,10174,211,226,23680,0,23680,1.0,13974.05,10052.61,13973.46,10052.28,1775,1774
5582,5794,9960,10359,212,399,60567,4479,56088,0.9260488384763981,5688.71,10153.24,5688.31,10153.03,1776,1775
2880,3048,9963,10191,168,228,23486,0,23486,1.0,2958.05,10064.94,2957.54,10064.67,1777,1776
7562,7942,9967,10340,380,373,75459,5160,70299,0.9316184948117521,7763.79,10131.0,7763.24,10130.61,1778,1777
7080,7247,9969,10196,167,227,25376,0,25376,1.0,7169.14,10063.64,7168.77,10063.62,1779,1778
5858,6145,9975,10381,287,406,67464,0,67464,1.0,6016.84,10197.72,6016.33,10197.01,1780,1779
8921,9239,9978,10318,318,340,58226,0,58226,1.0,9067.25,10122.38,9066.81,10122.14,1781,1780
14968,15139,9983,10152,171,169,14917,0,14917,1.0,15068.67,10074.59,15067.83,10074.1,1782,1781
13718,13941,9985,10272,223,287,35093,0,35093,1.0,13827.09,10137.13,13826.31,10136.85,1783,1782
15261,15403,9987,10203,142,216,17426,0,17426,1.0,15327.66,10113.44,15327.32,10112.52,1785,1783
9692,9971,9989,10302,279,313,57821,0,57821,1.0,9811.38,10139.27,9811.02,10138.76,1784,1784
3510,3661,9991,10165,151,174,17265,0,17265,1.0,3585.32,10083.81,3584.79,10083.25,1786,1785
7841,8187,9995,10277,346,282,51723,2704,49019,0.9477215165400306,8004.46,10125.43,8004.05,10124.95,1787,1786
11378,11632,9998,10218,254,220,37655,2076,35579,0.9448678794316824,11500.13,10107.96,11499.73,10107.48,1788,1787
9368,9711,10008,10366,343,358,85918,4482,81436,0.9478339812379245,9554.88,10182.97,9554.29,10182.5,1789,1788
2688,2831,10009,10244,143,235,22057,1180,20877,0.9465022441855193,2754.62,10136.76,2754.16,10136.1,1790,1789
16035,16423,10015,10430,388,415,107450,0,107450,1.0,16198.96,10235.86,16198.64,10235.39,1791,1790
16393,16721,10015,10289,328,274,50484,941,49543,0.9813604310276524,16578.19,10179.9,16577.76,10179.29,1792,1791
13504,13759,10018,10153,255,135,23367,0,23367,1.0,13635.5,10072.43,13634.87,10072.0,1793,1792
3009,3309,10023,10287,300,264,37556,664,36892,0.9823197358611141,3162.51,10141.7,3162.21,10141.48,1794,1793
14078,14303,10023,10218,225,195,18922,0,18922,1.0,14185.2,10119.74,14184.63,10119.09,1795,1794
11046,11377,10031,10265,331,234,48001,0,48001,1.0,11201.03,10131.58,11200.57,10131.18,1796,1795
4951,5319,10036,10637,368,601,129449,6619,122830,0.9488678939196131,5139.62,10302.59,5139.03,10302.39,1797,1796
16687,16819,10045,10257,132,212,22415,0,22415,1.0,16751.57,10143.71,16751.06,10143.32,1798,1797
10792,11049,10056,10274,257,218,27837,0,27837,1.0,10915.5,10159.78,10914.94,10159.4,1799,1798
13286,13698,10058,10356,412,298,73788,0,73788,1.0,13479.96,10202.36,13479.68,10201.92,1800,1799
9826,10119,10062,10443,293,381,67611,0,67611,1.0,9980.78,10275.86,9980.27,10275.18,1801,1800
13939,14132,10063,10229,193,166,19069,1280,17789,0.9328753474225182,14049.1,10158.05,14048.4,10157.39,1802,1801
9049,9418,10066,10380,369,314,76045,0,76045,1.0,9243.97,10247.3,9243.41,10246.64,1803,1802
13062,13293,10066,10224,231,158,24789,0,24789,1.0,13191.31,10152.53,13190.69,10152.01,1804,1803
15689,15876,10071,10253,187,182,16657,0,16657,1.0,15774.4,10150.95,15774.01,10150.63,1805,1804
3314,3730,10088,10507,416,419,83516,1766,81750,0.9788543512620336,3545.7,10296.65,3545.03,10296.17,1806,1805
8263,8532,10089,10335,269,246,31166,2629,28537,0.9156452544439453,8404.15,10218.58,8403.63,10217.99,1807,1806
8389,8780,10089,10452,391,363,82826,6493,76333,0.9216067418443484,8590.11,10268.86,8589.53,10268.39,1808,1807
14746,15078,10092,10343,332,251,50625,1501,49124,0.9703506172839507,14922.68,10207.41,14922.13,10206.88,1809,1808
7279,7528,10094,10355,249,261,35334,0,35334,1.0,7411.09,10216.5,7410.48,10216.01,1810,1809
10060,10230,10094,10373,170,279,21496,0,21496,1.0,10142.0,10247.57,10141.28,10246.58,1811,1810
11882,12329,10096,10523,447,427,120136,5242,114894,0.9563661183991476,12111.25,10307.99,12110.76,10307.5,1812,1811
6692,7318,10100,10606,626,506,170487,0,170487,1.0,7002.74,10343.22,7002.15,10342.8,1813,1812
4268,4584,10103,10363,316,260,44943,757,44186,0.9831564426050775,4428.63,10243.86,4428.01,10243.18,1814,1813
11505,11921,10104,10410,416,306,83701,0,83701,1.0,11701.02,10264.18,11700.8,10263.5,1816,1814
15022,15215,10104,10331,193,227,22676,234,22442,0.9896807197036515,15133.61,10208.54,15132.82,10208.27,1815,1815
15131,15374,10110,10635,243,525,70710,0,70710,1.0,15248.66,10389.34,15248.22,10388.76,1817,1816
13617,13770,10117,10246,153,129,11821,0,11821,1.0,13700.69,10175.65,13700.04,10175.22,1818,1817
6357,6591,10119,10581,234,462,51764,3,51761,0.9999420446642454,6469.11,10332.64,6468.52,10332.44,1819,1818
14165,14423,10122,10337,258,215,33161,0,33161,1.0,14305.27,10222.55,14304.66,10222.17,1820,1819
12484,12696,10124,10331,212,207,25374,2458,22916,0.9031291873571372,12578.95,10232.41,12578.63,10231.84,1821,1820
15527,16050,10125,10684,523,559,157070,0,157070,1.0,15808.66,10405.32,15807.95,10404.94,1822,1821
6036,6384,10132,10800,348,668,160334,4101,156233,0.9744221437748699,6201.71,10489.99,6201.2,10489.38,1823,1822
12903,13203,10134,10534,300,400,51507,876,50631,0.9829926029471723,13063.06,10290.66,13062.83,10290.91,1824,1823
8709,9057,10135,10524,348,389,79916,840,79076,0.9894889634115822,8869.14,10320.89,8868.71,10320.51,1825,1824
5746,5926,10138,10383,180,245,24757,0,24757,1.0,5822.84,10261.0,5822.69,10259.96,1826,1825
2913,3271,10140,10389,358,249,31825,4961,26864,0.8441162608012569,3045.45,10232.8,3045.51,10233.35,1827,1826
7380,7777,10144,10525,397,381,81858,3374,78484,0.9587822815118865,7563.8,10363.08,7563.42,10362.36,1828,1827
10805,11208,10145,10497,403,352,102241,0,102241,1.0,11016.07,10342.78,11015.5,10342.19,1829,1828
15495,15755,10148,10451,260,303,49223,0,49223,1.0,15610.9,10273.89,15610.42,10273.65,1830,1829
11186,11550,10157,10520,364,363,99653,0,99653,1.0,11368.44,10353.66,11367.95,10353.07,1831,1830
10187,10654,10164,10721,467,557,153316,5508,147808,0.9640741996921391,10427.32,10452.6,10426.78,10452.04,1832,1831
7879,8264,10167,10473,385,306,63818,0,63818,1.0,8065.37,10320.79,8064.89,10320.47,1833,1832
3594,3990,10174,10564,396,390,63372,0,63372,1.0,3805.34,10390.66,3804.27,10389.47,1834,1833
12769,13145,10176,10730,376,554,108477,0,108477,1.0,12955.11,10465.78,12954.49,10464.99,1838,1834
4161,4452,10178,10585,291,407,74930,1697,73233,0.9773521953823568,4300.78,10402.3,4300.19,10401.6,1837,1835
15295,15469,10178,10397,174,219,22003,0,22003,1.0,15365.37,10280.25,15365.1,10279.88,1835,1836
15404,15510,10179,10280,106,101,7082,0,7082,1.0,15456.86,10229.74,15456.29,10229.14,1836,1837
13855,14549,10180,10682,694,502,151353,8289,143064,0.9452339894154724,14203.43,10413.3,14203.04,10412.88,1839,1838
14351,14978,10180,10552,627,372,153919,5800,148119,0.9623178425015755,14679.06,10365.68,14678.49,10365.23,1840,1839
2780,2960,10193,10392,180,199,22164,1021,21143,0.953934307886663,2873.1,10286.9,2872.59,10286.48,1841,1840
4551,4769,10199,10492,218,293,32149,0,32149,1.0,4649.94,10338.56,4649.68,10337.84,1842,1841
4646,4986,10200,10655,340,455,107631,0,107631,1.0,4835.64,10431.01,4835.07,10430.75,1843,1842
13147,13705,10215,10675,558,460,152571,0,152571,1.0,13428.1,10444.52,13427.56,10444.02,1844,1843
3247,3582,10220,10541,335,321,54568,1557,53011,0.9714667937252602,3399.12,10390.25,3398.69,10389.9,1845,1844
13597,13845,10229,10470,248,241,32716,0,32716,1.0,13713.2,10339.24,13712.83,10338.73,1846,1845
10614,10796,10232,10342,182,110,13016,0,13016,1.0,10696.57,10281.39,10696.28,10280.87,1847,1846
12320,12531,10237,10438,211,201,27428,114,27314,0.9958436634096544,12419.75,10333.69,12419.34,10333.22,1848,1847
12570,12824,10237,10720,254,483,80378,176,80202,0.9978103461146085,12696.83,10452.48,12696.24,10452.37,1849,1848
10178,10387,10242,10452,209,210,23327,1364,21963,0.9415269858961718,10261.98,10350.17,10262.01,10349.3,1851,1849
7516,7980,10243,10925,464,682,151820,0,151820,1.0,7739.61,10586.61,7739.49,10585.87,1850,1850
14946,15161,10251,10576,215,325,44803,121,44682,0.9972992879941075,15056.29,10423.66,15055.75,10423.16,1852,1851
7143,7422,10252,10681,279,429,67762,752,67010,0.9889023346418346,7286.25,10458.76,7285.87,10458.34,1853,1852
2944,3277,10255,10488,333,233,43376,8612,34764,0.8014570269273331,3113.49,10356.96,3112.87,10356.54,1854,1853
16320,16715,10257,10599,395,342,79620,2384,77236,0.9700577744285356,16516.79,10408.6,16516.56,10407.93,1855,1854
10615,10834,10262,10474,219,212,26558,409,26149,0.9845997439566232,10742.16,10384.21,10741.46,10383.75,1856,1855
9618,9867,10270,10519,249,249,36177,0,36177,1.0,9738.41,10382.43,9737.89,10382.1,1857,1856
13793,14021,10272,10548,228,276,36378,0,36378,1.0,13906.55,10395.91,13906.17,10395.7,1858,1857
15342,15554,10280,10609,212,329,36642,0,36642,1.0,15435.16,10434.91,15434.99,10435.03,1859,1858
7937,8451,10282,10817,514,535,119436,3720,115716,0.9688536119762886,8222.97,10550.8,8222.18,10550.37,1860,1859
9233,9638,10297,10706,405,409,118705,0,118705,1.0,9437.85,10508.79,9437.39,10508.24,1861,1860
12455,12603,10309,10451,148,142,11145,0,11145,1.0,12551.73,10379.77,12550.38,10379.29,1862,1861
5425,5781,10315,10753,356,438,109898,0,109898,1.0,5602.28,10530.05,5601.79,10529.53,1863,1862
4447,4687,10318,10526,240,208,16962,0,16962,1.0,4546.9,10433.17,4547.41,10432.4,1864,1863
11728,11973,10323,10512,245,189,27119,0,27119,1.0,11855.26,10409.47,11854.72,10409.08,1865,1864
3105,3413,10324,10636,308,312,40163,3901,36262,0.9028708014839529,3271.95,10499.62,3271.27,10498.91,1866,1865
10033,10184,10329,10480,151,151,11666,1406,10260,0.8794788273615635,10121.43,10411.83,10120.57,10411.18,1867,1866
5719,6064,10334,11005,345,671,165521,7058,158463,0.9573588849753204,5896.23,10646.9,5895.74,10646.6,1868,1867
3947,4176,10339,10583,229,244,34507,2081,32426,0.9396933955429333,4048.92,10469.89,4048.51,10469.28,1869,1868
16030,16354,10345,10905,324,560,118651,0,118651,1.0,16206.82,10615.0,16206.14,10614.94,1870,1869
8062,8773,10347,10960,711,613,163628,5362,158266,0.9672305473390862,8458.4,10647.04,8457.45,10646.84,1871,1870
8881,9295,10351,10747,414,396,107823,3476,104347,0.9677619802825,9098.62,10534.06,9098.11,10533.68,1872,1871
2904,3081,10369,10614,177,245,24810,0,24810,1.0,2994.26,10487.3,2993.77,10486.82,1873,1872
7949,8170,10377,10593,221,216,27553,0,27553,1.0,8061.98,10491.14,8061.44,10490.63,1874,1873
12395,12599,10387,10642,204,255,34343,0,34343,1.0,12497.82,10513.78,12497.53,10513.28,1875,1874
13694,13942,10390,10619,248,229,37454,0,37454,1.0,13803.83,10522.33,13803.46,10521.66,1876,1875
12160,12405,10397,10618,245,221,31472,0,31472,1.0,12313.64,10516.85,12312.55,10516.36,1877,1876
9712,9997,10398,10630,285,232,35767,2225,33542,0.9377918192747504,9838.37,10513.02,9838.11,10512.39,1878,1877
11509,11996,10400,10926,487,526,153982,6498,147484,0.9578002623683287,11761.66,10644.88,11761.14,10644.45,1879,1878
4415,4792,10402,10934,377,532,105978,3084,102894,0.9708996206759893,4594.35,10672.94,4593.84,10672.3,1880,1879
9916,10181,10426,10719,265,293,52600,0,52600,1.0,10040.55,10577.11,10040.35,10576.22,1881,1880
11896,12241,10427,10918,345,491,100273,4938,95335,0.9507544403777687,12072.8,10647.97,12072.32,10647.63,1882,1881
9595,9735,10431,10680,140,249,20416,0,20416,1.0,9666.59,10571.54,9665.99,10570.72,1883,1882
10415,10881,10439,10956,466,517,150484,6304,144180,0.9581085032295792,10644.28,10692.35,10643.76,10691.84,1884,1883
16316,16608,10441,10890,292,449,71136,0,71136,1.0,16439.0,10676.12,16438.48,10675.2,1885,1884
10140,10245,10445,10733,105,288,17597,0,17597,1.0,10183.29,10602.26,10182.84,10601.48,1886,1885
8646,8964,10446,10773,318,327,48581,0,48581,1.0,8804.4,10630.41,8804.35,10629.18,1888,1886
15447,15555,10446,10609,108,163,10223,0,10223,1.0,15505.52,10533.2,15505.05,10532.53,1887,1887
14467,14674,10455,10594,207,139,17496,1145,16351,0.9345564700502972,14557.48,10527.45,14557.16,10526.83,1889,1888
11148,11663,10457,10899,515,442,138019,0,138019,1.0,11393.58,10678.26,11393.14,10677.79,1890,1889
6405,6933,10470,11128,528,658,176209,6243,169966,0.9645704816439569,6686.04,10800.21,6685.43,10799.76,1891,1890
13003,13514,10470,10859,511,389,118042,0,118042,1.0,13261.12,10689.99,13260.51,10689.43,1892,1891
10839,11177,10477,10651,338,174,35571,0,35571,1.0,11026.02,10549.91,11025.14,10549.26,1893,1892
15609,16127,10485,10961,518,476,134257,0,134257,1.0,15907.21,10712.42,15906.45,10711.9,1894,1893
3711,3878,10486,10673,167,187,14751,0,14751,1.0,3806.62,10570.07,3805.93,10569.6,1895,1894
4073,4356,10486,10735,283,249,33807,1,33806,0.9999704203271512,4224.98,10620.61,4224.23,10619.87,1898,1895
3056,3232,10487,10645,176,158,15979,0,15979,1.0,3145.68,10563.63,3145.1,10563.33,1896,1896
3543,3878,10489,10813,335,324,60980,4443,56537,0.927140045916694,3710.7,10648.56,3710.23,10648.04,1897,1897
13901,14056,10492,10749,155,257,25378,0,25378,1.0,13980.85,10622.38,13980.44,10621.8,1899,1898
6848,7264,10495,11028,416,533,120391,4428,115963,0.9632198420147685,7040.09,10751.54,7039.75,10751.16,1900,1899
4934,5132,10501,10692,198,191,19585,0,19585,1.0,5028.0,10620.41,5027.43,10619.54,1901,1900
3350,3576,10507,10728,226,221,26701,1695,25006,0.9365192314894574,3456.93,10612.28,3456.7,10611.64,1902,1901
7175,7591,10510,11178,416,668,168634,310,168324,0.9981616993014457,7377.83,10826.91,7377.34,10826.53,1903,1902
14683,14950,10515,10728,267,213,35601,0,35601,1.0,14828.55,10608.52,14827.63,10608.32,1904,1903
5119,5346,10516,10740,227,224,34573,1730,32843,0.9499609521881237,5226.67,10627.94,5226.26,10627.52,1905,1904
14933,15320,10523,10788,387,265,61154,1409,59745,0.9769598063904241,15134.41,10638.16,15133.81,10637.72,1906,1905
14027,14580,10543,10932,553,389,138823,5934,132889,0.957254921734871,14288.92,10732.11,14288.53,10731.71,1907,1906
16476,16697,10543,10978,221,435,56053,0,56053,1.0,16602.29,10793.91,16601.95,10793.1,1908,1907
4261,4511,10547,10919,250,372,45593,1161,44432,0.9745355646700151,4384.0,10735.8,4383.21,10735.28,1909,1908
3848,4314,10548,10940,466,392,93239,0,93239,1.0,4087.6,10736.18,4087.05,10735.71,1910,1909
12662,13007,10551,10913,345,362,73396,0,73396,1.0,12837.13,10727.39,12836.63,10726.94,1911,1910
14483,14758,10552,10793,275,241,43336,0,43336,1.0,14624.68,10677.35,14624.18,10676.77,1912,1911
2952,3050,10560,10645,98,85,4999,0,4999,1.0,2998.4,10606.87,2997.87,10606.2,1913,1912
10682,11197,10566,11190,515,624,177335,7035,170300,0.9603293202131559,10954.08,10897.79,10953.61,10897.26,1914,1913
15263,15526,10570,10864,263,294,39651,0,39651,1.0,15372.42,10712.77,15372.25,10712.28,1915,1914
5328,5445,10572,10750,117,178,13313,1149,12164,0.9136933824081724,5393.76,10669.08,5393.25,10668.34,1916,1915
12312,12679,10584,10936,367,352,93456,0,93456,1.0,12492.59,10763.9,12492.08,10763.36,1917,1916
9636,9993,10587,10873,357,286,70670,0,70670,1.0,9830.18,10732.97,9829.53,10732.44,1918,1917
13649,13979,10590,10840,330,250,45768,0,45768,1.0,13816.68,10709.17,13816.08,10708.6,1922,1918
3045,3293,10591,10821,248,230,22237,0,22237,1.0,3165.74,10697.4,3165.37,10697.08,1919,1919
12179,12356,10591,10801,177,210,23015,0,23015,1.0,12262.68,10700.77,12262.34,10700.12,1920,1920
3208,3444,10592,10780,236,188,26524,0,26524,1.0,3319.15,10689.87,3318.79,10689.39,1921,1921
15417,15591,10602,10862,174,260,24904,0,24904,1.0,15499.1,10730.49,15498.51,10730.05,1923,1922
4650,5424,10605,11062,774,457,195634,3544,192090,0.9818845394972244,5006.69,10837.74,5006.43,10837.15,1924,1923
11034,11198,10612,10772,164,160,15205,1068,14137,0.9297599473857284,11122.25,10690.25,11121.65,10689.79,1925,1924
7518,8135,10618,11223,617,605,171609,4863,166746,0.9716623254025138,7842.11,10956.59,7841.66,10955.93,1926,1925
7664,7912,10620,10909,248,289,25787,2253,23534,0.9126303951603522,7804.9,10746.49,7803.61,10746.82,1927,1926
9445,9659,10622,10846,214,224,28838,0,28838,1.0,9554.41,10732.26,9553.91,10731.71,1928,1927
2870,3298,10637,11158,428,521,129729,0,129729,1.0,3064.09,10908.03,3063.66,10907.56,1929,1928
5574,5725,10642,10838,151,196,16240,0,16240,1.0,5660.73,10748.88,5660.16,10748.24,1930,1929
3435,3741,10646,10947,306,301,57786,0,57786,1.0,3585.54,10793.27,3585.07,10792.79,1931,1930
14876,15044,10653,10862,168,209,17256,0,17256,1.0,14967.1,10734.77,14966.43,10734.86,1932,1931
13414,13769,10655,11040,355,385,89534,0,89534,1.0,13585.87,10839.48,13585.43,10839.02,1933,1932
9095,9244,10671,10833,149,162,12970,0,12970,1.0,9167.4,10744.45,9166.96,10744.02,1934,1933
8703,9149,10675,11009,446,334,85817,0,85817,1.0,8895.88,10830.39,8895.77,10829.94,1935,1934
9112,9520,10676,11027,408,351,84167,35,84132,0.9995841600627324,9305.47,10845.65,9305.02,10845.23,1936,1935
15419,15867,10677,11324,448,647,208528,618,207910,0.997036369216604,15637.42,11022.03,15636.87,11021.35,1937,1936
10177,10444,10686,10906,267,220,39784,0,39784,1.0,10320.31,10787.36,10319.79,10786.84,1938,1937
8394,8754,10689,10941,360,252,45632,0,45632,1.0,8571.03,10804.96,8570.53,10804.68,1939,1938
9978,10241,10692,10945,263,253,37907,0,37907,1.0,10103.18,10807.42,10103.15,10807.54,1940,1939
14669,14970,10697,11050,301,353,65196,427,64769,0.993450518436714,14826.2,10847.84,14825.85,10847.65,1941,1940
15000,15287,10710,10961,287,251,41863,2536,39327,0.9394214461457612,15144.54,10828.56,15143.74,10828.3,1942,1941
2346,2672,10721,11047,326,326,57895,0,57895,1.0,2504.38,10884.76,2504.07,10884.33,1943,1942
3857,4271,10733,11229,414,496,116019,0,116019,1.0,4060.25,11004.47,4059.68,11003.76,1944,1943
5378,5606,10733,10903,228,170,25654,2057,23597,0.919817572308412,5484.08,10813.22,5483.62,10812.82,1945,1944
9339,9742,10736,11126,403,390,83081,1067,82014,0.9871571117343315,9558.39,10955.72,9557.88,10954.96,1946,1945
6118,6311,10741,11008,193,267,27990,1229,26761,0.9560914612361557,6214.92,10880.03,6214.43,10879.27,1948,1946
11086,11260,10741,10967,174,226,24568,1834,22734,0.9253500488440247,11161.37,10844.56,11161.01,10844.12,1947,1947
13823,14156,10741,11049,333,308,53333,0,53333,1.0,14010.72,10872.94,14009.97,10872.65,1949,1948
3225,3672,10752,11121,447,369,77453,0,77453,1.0,3446.07,10927.98,3445.65,10927.57,1950,1949
12575,12905,10755,11166,330,411,79609,18,79591,0.9997738949113794,12758.45,10984.6,12757.73,10983.82,1952,1950
5981,6173,10757,10968,192,211,21899,0,21899,1.0,6074.61,10864.48,6074.3,10863.8,1951,1951
5640,5843,10763,11010,203,247,27287,639,26648,0.9765822552864001,5730.87,10889.72,5730.56,10889.38,1953,1952
7022,7209,10774,10980,187,206,22114,0,22114,1.0,7120.95,10895.21,7120.38,10894.47,1954,1953
12889,13243,10781,11251,354,470,120984,7147,113837,0.9409260728691398,13060.63,11012.12,13060.16,11011.63,1955,1954
16152,16411,10791,11023,259,232,26955,0,26955,1.0,16281.25,10912.48,16280.64,10911.58,1956,1955
11530,11950,10792,11196,420,404,86381,0,86381,1.0,11744.52,10994.07,11743.9,10993.5,1958,1956
14531,14712,10792,10962,181,170,19559,0,19559,1.0,14628.92,10876.33,14628.32,10875.88,1957,1957
12088,12415,10793,11102,327,309,69196,0,69196,1.0,12265.1,10945.64,12264.44,10945.34,1959,1958
3653,3963,10802,11213,310,411,77646,0,77646,1.0,3815.46,10998.27,3814.98,10997.92,1960,1959
14938,15048,10810,10987,110,177,12802,787,12015,0.9385252304327449,14996.61,10894.5,14996.09,10894.06,1961,1960
4338,4631,10813,11157,293,344,59632,0,59632,1.0,4492.04,10963.65,4491.65,10963.33,1962,1961
5414,5708,10815,11040,294,225,35058,0,35058,1.0,5573.76,10940.39,5573.16,10939.76,1963,1962
13680,13937,10818,11164,257,346,44328,0,44328,1.0,13799.14,10968.02,13798.89,10967.92,1964,1963
11190,11558,10821,11212,368,391,117200,6763,110437,0.9422952218430034,11379.05,11012.16,11378.52,11011.68,1965,1964
11871,12110,10824,11052,239,228,35247,0,35247,1.0,11991.6,10941.53,11991.07,10940.98,1967,1965
8878,9220,10825,11083,342,258,40051,0,40051,1.0,9037.46,10965.04,9037.52,10964.65,1966,1966
9858,10087,10835,11034,229,199,33496,0,33496,1.0,9970.94,10932.86,9970.46,10932.36,1969,1967
15276,15448,10835,11074,172,239,28038,682,27356,0.9756758684642272,15351.21,10942.26,15350.78,10941.96,1968,1968
8018,8476,10841,11143,458,302,85123,7408,77715,0.9129729920233074,8238.92,11010.23,8238.65,11009.54,1970,1969
13198,13474,10846,11088,276,242,49469,0,49469,1.0,13330.38,10959.16,13329.93,10958.7,1971,1970
5168,5435,10847,11077,267,230,31228,0,31228,1.0,5308.77,10945.83,5308.37,10945.58,1972,1971
9594,9926,10853,11388,332,535,99352,1062,98290,0.9893107335534262,9756.6,11104.06,9756.17,11103.58,1973,1972
15938,16198,10857,11046,260,189,25667,0,25667,1.0,16109.6,10952.5,16108.39,10951.82,1974,1973
10213,10433,10858,11031,220,173,18148,0,18148,1.0,10324.04,10919.79,10324.12,10919.83,1975,1974
14059,14439,10858,11093,380,235,64231,1780,62451,0.9722875247154801,14249.24,10983.48,14248.7,10982.97,1976,1975
8292,8769,10859,11311,477,452,114841,5130,109711,0.9553295425849653,8517.2,11072.51,8516.72,11072.07,1977,1976
15147,15322,10866,11096,175,230,20969,2052,18917,0.9021412561400162,15227.83,10999.15,15227.75,10998.5,1978,1977
16266,16483,10870,11087,217,217,23487,938,22549,0.9600630135819815,16378.0,10976.95,16377.59,10976.34,1979,1978
2641,2916,10879,11152,275,273,46396,0,46396,1.0,2798.38,10996.0,2797.59,10995.4,1980,1979
6526,6907,10880,11348,381,468,95296,0,95296,1.0,6736.75,11127.42,6736.26,11126.85,1981,1980
10379,10575,10887,11154,196,267,29078,1283,27795,0.9558772955499003,10486.79,11017.04,10486.27,11016.66,1982,1981
4176,4362,10888,11077,186,189,18389,0,18389,1.0,4281.54,10969.78,4280.72,10969.5,1983,1982
6060,6246,10898,11127,186,229,24428,2431,21997,0.90048305223514,6149.42,11023.45,6148.95,11022.81,1985,1983
14423,14737,10898,11275,314,377,62410,0,62410,1.0,14587.06,11066.33,14586.7,11065.98,1984,1984
10057,10233,10901,11064,176,163,15930,678,15252,0.9574387947269303,10135.34,10971.68,10134.95,10971.29,1986,1985
14936,15256,10905,11293,320,388,65351,90,65261,0.998622821379933,15108.1,11108.31,15107.59,11107.62,1987,1986
7432,7660,10906,11093,228,187,23408,1355,22053,0.9421138072453862,7538.22,10992.99,7537.84,10992.42,1988,1987
12374,12666,10910,11246,292,336,68833,0,68833,1.0,12519.1,11081.95,12518.55,11081.34,1989,1988
2306,2581,10915,11288,275,373,52916,0,52916,1.0,2445.21,11098.52,2444.73,11098.08,1990,1989
10560,10927,10918,11250,367,332,79963,0,79963,1.0,10717.0,11090.42,10716.69,11089.94,1991,1990
5862,6065,10919,11073,203,154,16595,0,16595,1.0,5974.96,11003.95,5974.1,11003.31,1992,1991
15830,16379,10925,11451,549,526,152566,2779,149787,0.9817849324226892,16095.4,11166.46,16095.03,11165.9,1993,1992
4593,4670,10928,11126,77,198,12334,0,12334,1.0,4630.64,11030.68,4630.21,11030.15,1994,1993
6224,6522,10936,11168,298,232,38750,0,38750,1.0,6361.95,11053.09,6361.7,11052.69,1995,1994
10106,10413,10937,11265,307,328,66439,626,65813,0.9905778232664549,10265.87,11097.77,10265.29,11097.3,1996,1995
14674,14904,10940,11177,230,237,42328,0,42328,1.0,14781.61,11059.0,14781.17,11058.59,1997,1996
4658,4890,10945,11203,232,258,41619,0,41619,1.0,4765.87,11073.34,4765.36,11072.82,1998,1997
6861,7212,10953,11391,351,438,96467,6100,90367,0.9367659406843791,7033.88,11155.94,7033.39,11155.52,1999,1998
5333,5588,10955,11148,255,193,33588,0,33588,1.0,5469.72,11062.08,5469.05,11061.47,2000,1999
11526,11743,10956,11190,217,234,21430,1299,20131,0.939384041063929,11619.89,11093.51,11619.41,11093.36,2001,2000
15318,15526,10958,11327,208,369,23110,3520,19590,0.8476849848550411,15391.96,11130.36,15392.9,11131.2,2002,2001
13848,14068,10962,11107,220,145,19237,542,18695,0.9718251286583147,13955.32,11038.18,13954.57,11037.87,2003,2002
2532,2893,10966,11321,361,355,64547,0,64547,1.0,2678.86,11142.85,2678.85,11142.38,2004,2003
3060,3744,10966,11718,684,752,262225,0,262225,1.0,3420.94,11298.36,3420.37,11297.95,2005,2004
5716,5928,10970,11084,212,114,13353,0,13353,1.0,5813.61,11026.79,5813.57,11026.48,2006,2005
13318,13733,10974,11611,415,637,150776,7994,142782,0.94698095187563,13532.26,11293.17,13531.77,11292.6,2007,2006
14887,15015,10974,11180,128,206,17619,1950,15669,0.8893240252000681,14948.9,11072.64,14948.42,11072.21,2008,2007
9801,10126,10977,11377,325,400,61584,0,61584,1.0,9952.65,11179.78,9952.39,11179.07,2011,2008
5128,5409,10979,11222,281,243,30523,4109,26414,0.8653802050912427,5277.01,11093.29,5276.46,11092.87,2009,2009
8372,8919,10980,11488,547,508,140977,5586,135391,0.9603765153181015,8661.87,11249.16,8661.32,11248.6,2010,2010
9059,9464,10987,11399,405,412,102633,0,102633,1.0,9259.91,11197.56,9259.42,11197.05,2012,2011
11893,12139,10990,11189,246,199,26562,0,26562,1.0,12018.28,11097.08,12017.8,11096.43,2013,2012
13564,13800,10999,11231,236,232,33968,0,33968,1.0,13676.29,11106.31,13675.89,11105.93,2014,2013
5579,5807,11010,11198,228,188,31060,2311,28749,0.9255956213779781,5683.82,11107.76,5683.4,11107.27,2015,2014
8862,9231,11012,11306,369,294,58261,0,58261,1.0,9021.63,11156.94,9021.63,11156.13,2016,2015
4237,4600,11014,11367,363,353,77994,0,77994,1.0,4417.38,11190.26,4416.89,11189.79,2017,2016
4954,5217,11019,11179,263,160,23665,2312,21353,0.902302979083034,5099.21,11099.43,5098.26,11098.76,2018,2017
14038,14575,11022,11340,537,318,109389,0,109389,1.0,14328.49,11189.76,14327.82,11189.15,2019,2018
3571,3974,11031,11606,403,575,112467,0,112467,1.0,3795.0,11324.13,3794.21,11323.48,2020,2019
10403,10576,11038,11236,173,198,13819,0,13819,1.0,10471.05,11145.78,10470.94,11145.2,2021,2020
12100,12465,11040,11524,365,484,118522,6022,112500,0.9491908675182666,12287.4,11267.94,12286.88,11267.52,2022,2021
5931,6143,11041,11207,212,166,25368,0,25368,1.0,6042.12,11121.17,6041.55,11120.67,2023,2022
7877,8027,11042,11139,150,97,7982,0,7982,1.0,7963.41,11096.33,7962.53,11095.97,2024,2023
11110,11251,11042,11214,141,172,12821,0,12821,1.0,11178.17,11136.59,11177.72,11135.85,2025,2024
7329,7524,11047,11240,195,193,17880,1614,16266,0.9097315436241611,7434.95,11144.82,7434.28,11144.31,2027,2025
4863,5072,11048,11262,209,214,20931,283,20648,0.9864793846447852,4948.0,11138.26,4948.03,11138.49,2026,2026
13182,13329,11056,11193,147,137,13951,0,13951,1.0,13259.76,11133.35,13259.19,11132.84,2028,2027
5804,5950,11060,11195,146,135,13196,0,13196,1.0,5876.1,11123.43,5875.69,11123.03,2029,2028
15245,15324,11062,11225,79,163,9612,0,9612,1.0,15288.46,11145.24,15287.93,11144.72,2030,2029
13853,14043,11064,11204,190,140,19241,1725,17516,0.910347695026246,13943.98,11137.61,13943.55,11137.07,2031,2030
6212,6385,11084,11234,173,150,15591,0,15591,1.0,6296.42,11158.09,6295.96,11157.59,2032,2031
12658,12815,11100,11197,157,97,9291,878,8413,0.9054999461844796,12721.21,11159.14,12720.99,11158.49,2033,2032
15770,16155,11111,11533,385,422,66383,0,66383,1.0,15946.2,11347.74,15945.73,11347.07,2037,2033
6011,6248,11116,11333,237,217,24734,0,24734,1.0,6133.61,11227.0,6133.24,11226.47,2035,2034
2876,3239,11117,11480,363,363,78470,0,78470,1.0,3044.24,11297.09,3043.83,11296.66,2034,2035
7860,8293,11118,11378,433,260,81933,4215,77718,0.948555527077002,8087.98,11240.55,8087.35,11240.05,2036,2036
9217,9699,11121,11579,482,458,112496,3034,109462,0.9730301521831888,9450.37,11351.32,9449.9,11350.92,2038,2037
4533,4778,11122,11458,245,336,55219,0,55219,1.0,4652.66,11295.38,4652.12,11294.81,2039,2038
6347,6552,11122,11348,205,226,28255,0,28255,1.0,6460.28,11238.91,6459.92,11238.42,2040,2039
12821,13069,11124,11353,248,229,30034,0,30034,1.0,12938.69,11244.0,12938.29,11243.55,2042,2040
7041,7331,11125,11451,290,326,57604,224,57380,0.9961113811540865,7201.8,11294.37,7201.3,11294.02,2041,2041
5364,5593,11130,11294,229,164,24646,0,24646,1.0,5482.48,11208.99,5482.02,11208.38,2043,2042
11961,12149,11132,11415,188,283,36442,0,36442,1.0,12049.66,11279.64,12049.26,11279.09,2044,2043
11171,11552,11134,11416,381,282,49728,772,48956,0.984475546975547,11367.16,11272.72,11366.47,11272.03,2045,2044
13683,13969,11134,11419,286,285,44359,0,44359,1.0,13837.48,11279.49,13836.8,11278.96,2046,2045
5125,5356,11135,11374,231,239,30077,2443,27634,0.9187751437975862,5223.15,11236.08,5223.01,11236.06,2047,2046
7416,7561,11135,11306,145,171,14354,0,14354,1.0,7492.5,11228.1,7491.98,11227.47,2048,2047
11746,12024,11140,11428,278,288,44904,0,44904,1.0,11874.77,11277.37,11874.72,11277.27,2049,2048
5894,6035,11142,11273,141,131,8857,0,8857,1.0,5965.06,11203.46,5964.74,11203.14,2051,2049
7574,8002,11142,11539,428,397,90566,3549,87017,0.9608131086721287,7763.27,11356.6,7763.08,11355.8,2050,2050
5679,5913,11148,11340,234,192,28379,0,28379,1.0,5802.78,11238.13,5802.19,11237.65,2052,2051
9830,10227,11152,11626,397,474,109848,6000,103848,0.9453790692593402,10042.11,11391.3,10041.46,11390.87,2053,2052
11515,11761,11152,11383,246,231,41638,0,41638,1.0,11645.8,11265.12,11645.2,11264.54,2054,2053
10528,10799,11156,11454,271,298,37635,0,37635,1.0,10658.63,11311.4,10658.14,11310.84,2055,2054
7507,7699,11159,11346,192,187,18826,0,18826,1.0,7605.68,11241.79,7604.98,11241.54,2056,2055
10846,11315,11161,11590,469,429,133111,1,133110,0.999992487472861,11077.4,11358.26,11076.92,11357.84,2057,2056
4959,5127,11164,11324,168,160,18148,0,18148,1.0,5055.7,11235.86,5054.96,11235.47,2058,2057
12439,12891,11164,11674,452,510,153216,5308,147908,0.9653560985797828,12671.84,11398.08,12671.43,11397.75,2059,2058
14520,14689,11164,11356,169,192,13925,0,13925,1.0,14593.61,11281.51,14593.03,11280.21,2063,2059
4752,5034,11165,11407,282,242,40297,0,40297,1.0,4887.64,11283.66,4887.26,11283.21,2060,2060
13918,14154,11165,11368,236,203,35668,0,35668,1.0,14035.77,11271.57,14035.27,11270.98,2061,2061
14579,14953,11165,11510,374,345,59784,976,58808,0.9836745617556537,14775.34,11309.0,14774.63,11308.77,2062,2062
7299,7422,11180,11332,123,152,11638,706,10932,0.9393366557827806,7356.36,11261.24,7355.87,11260.63,2064,2063
10202,10602,11182,11689,400,507,143696,5763,137933,0.9598944994989422,10393.0,11423.23,10392.52,11422.8,2065,2064
14866,15157,11186,11561,291,375,62615,0,62615,1.0,15018.19,11358.63,15017.53,11358.29,2068,2065
13062,13476,11187,11567,414,380,83932,0,83932,1.0,13271.25,11356.86,13270.88,11356.61,2066,2066
3892,4386,11189,11634,494,445,153573,0,153573,1.0,4134.38,11403.42,4133.96,11402.83,2067,2067
5509,5751,11190,11375,242,185,26238,0,26238,1.0,5632.29,11284.7,5631.79,11284.23,2069,2068
15138,15303,11192,11392,165,200,17999,0,17999,1.0,15212.32,11301.54,15212.15,11300.62,2070,2069
6176,6404,11197,11381,228,184,27037,0,27037,1.0,6290.83,11291.42,6290.31,11290.88,2071,2070
15239,15513,11202,11531,274,329,47461,0,47461,1.0,15357.12,11343.73,15356.81,11343.49,2072,2071
10701,10862,11216,11410,161,194,17529,781,16748,0.9554452621370301,10797.2,11302.23,10796.43,11301.69,2073,2072
5241,5464,11220,11401,223,181,22899,0,22899,1.0,5352.61,11318.23,5352.15,11317.6,2074,2073
6742,6930,11223,11399,188,176,20742,1744,18998,0.9159193906084273,6835.65,11323.75,6835.16,11323.05,2075,2074
5835,6021,11228,11403,186,175,18109,0,18109,1.0,5939.69,11314.7,5939.01,11314.33,2076,2075
6535,6747,11254,11389,212,135,18756,0,18756,1.0,6630.41,11327.88,6630.07,11327.36,2077,2076
8434,9097,11261,11683,663,422,96616,0,96616,1.0,8752.75,11451.94,8752.25,11451.56,2078,2077
8169,8378,11266,11415,209,149,18877,0,18877,1.0,8285.37,11350.43,8284.6,11349.89,2079,2078
14099,14302,11272,11567,203,295,42074,1893,40181,0.9550078433236678,14196.63,11424.34,14196.29,11423.75,2080,2079
5967,6195,11279,11590,228,311,41805,0,41805,1.0,6071.09,11430.45,6070.66,11429.88,2081,2080
7262,7464,11282,11472,202,190,21162,184,20978,0.991305169643701,7359.29,11383.82,7358.95,11383.09,2082,2081
15373,15807,11283,11659,434,376,124668,0,124668,1.0,15593.48,11478.17,15593.01,11477.63,2083,2082
7398,7581,11284,11437,183,153,12223,0,12223,1.0,7491.39,11353.63,7490.58,11353.54,2084,2083
5403,5578,11288,11429,175,141,15003,23,14980,0.9984669732720123,5484.74,11359.36,5484.36,11358.84,2085,2084
11391,11588,11291,11504,197,213,22906,1418,21488,0.9380948223172968,11504.37,11397.78,11503.67,11397.27,2086,2085
4968,5361,11294,11691,393,397,96882,0,96882,1.0,5149.82,11481.54,5149.48,11481.03,2087,2086
12984,13154,11294,11496,170,202,19446,0,19446,1.0,13075.04,11402.89,13074.22,11401.94,2088,2087
12877,13042,11300,11599,165,299,28632,0,28632,1.0,12946.08,11436.44,12945.83,11436.42,2089,2088
5640,6017,11302,11616,377,314,53560,1991,51569,0.9628267363704257,5855.41,11446.44,5854.74,11446.12,2090,2089
11704,11910,11305,11595,206,290,30603,0,30603,1.0,11805.66,11442.74,11805.12,11442.36,2091,2090
6378,6591,11306,11466,213,160,19290,1501,17789,0.9221876620010369,6480.99,11386.36,6480.46,11385.79,2092,2091
6152,6328,11309,11469,176,160,16991,0,16991,1.0,6223.58,11391.9,6223.34,11391.32,2093,2092
13649,13958,11313,11650,309,337,59594,0,59594,1.0,13802.59,11507.9,13802.0,11507.29,2094,2093
4290,4623,11319,11697,333,378,71650,0,71650,1.0,4465.12,11491.12,4464.84,11491.0,2095,2094
4712,5026,11322,11618,314,296,54713,0,54713,1.0,4868.29,11474.88,4867.8,11474.38,2096,2095
14263,14724,11329,11710,461,381,124482,97,124385,0.9992207708745039,14478.38,11505.92,14477.98,11505.44,2097,2096
9695,9867,11331,11542,172,211,24713,0,24713,1.0,9791.18,11429.08,9790.58,11428.65,2098,2097
7255,7791,11346,11756,536,410,102448,1933,100515,0.9811318913009527,7547.82,11565.36,7547.14,11564.66,2099,2098
13897,14123,11348,11572,226,224,31669,0,31669,1.0,14019.89,11460.48,14019.38,11459.88,2104,2099
14766,14962,11349,11510,196,161,16517,0,16517,1.0,14863.04,11430.18,14862.38,11429.95,2100,2100
15798,16306,11355,11952,508,597,129246,521,128725,0.9959689274716432,16088.96,11611.73,16087.95,11611.06,2101,2101
5494,5713,11356,11561,219,205,25437,2469,22968,0.9029366670597948,5604.11,11447.71,5603.59,11447.35,2102,2102
6794,7032,11359,11508,238,149,22566,0,22566,1.0,6907.31,11434.49,6906.96,11433.83,2103,2103
6582,6863,11363,11588,281,225,35504,0,35504,1.0,6718.34,11467.02,6717.91,11466.55,2105,2104
10561,10807,11364,11675,246,311,37985,2733,35252,0.9280505462682638,10675.74,11525.73,10675.31,11525.18,2107,2105
11974,12351,11364,11740,377,376,93431,3979,89452,0.957412422001263,12164.55,11567.2,12163.97,11566.67,2106,2106
7739,8173,11367,11613,434,246,66318,0,66318,1.0,7960.94,11490.71,7960.44,11490.16,2108,2107
8889,9236,11368,11696,347,328,75448,6571,68877,0.912906902767469,9073.58,11522.45,9072.99,11522.0,2109,2108
11550,11806,11369,11691,256,322,48317,0,48317,1.0,11679.54,11524.1,11679.04,11523.68,2110,2109
7862,8492,11373,11816,630,443,131593,6702,124891,0.9490702392984429,8187.71,11588.96,8186.79,11588.53,2111,2110
6245,6477,11378,11550,232,172,23575,4363,19212,0.814931071049841,6369.29,11464.16,6368.68,11463.66,2112,2111
11793,12033,11380,11698,240,318,39232,0,39232,1.0,11929.11,11542.56,11928.43,11542.16,2113,2112
15077,15398,11387,11650,321,263,53189,0,53189,1.0,15219.26,11524.89,15218.88,11524.46,2114,2113
6964,7187,11391,11520,223,129,21059,2055,19004,0.9024170188517974,7078.51,11463.15,7077.88,11462.65,2115,2114
6440,6648,11392,11612,208,220,22184,0,22184,1.0,6531.83,11521.7,6531.83,11520.72,2120,2115
10694,10960,11392,11600,266,208,25113,959,24154,0.9618126070162863,10836.91,11480.76,10835.98,11480.42,2116,2116
5353,5611,11393,11840,258,447,70365,0,70365,1.0,5486.08,11634.13,5485.3,11633.31,2117,2117
5239,5424,11394,11705,185,311,32624,0,32624,1.0,5343.12,11565.47,5342.68,11564.72,2118,2118
9346,9785,11396,11923,439,527,129879,6227,123652,0.9520553746179136,9529.26,11630.61,9528.88,11630.2,2119,2119
11211,11643,11397,11793,432,396,102690,1329,101361,0.9870581361378907,11411.41,11596.07,11410.96,11595.57,2121,2120
3056,3378,11411,11797,322,386,65277,0,65277,1.0,3212.81,11592.35,3212.26,11592.02,2122,2121
12936,13358,11417,11825,422,408,90769,0,90769,1.0,13162.36,11612.28,13161.85,11612.08,2123,2122
10095,10244,11425,11658,149,233,21552,1585,19967,0.9264569413511508,10183.45,11551.26,10182.88,11550.59,2124,2123
4589,4844,11432,11700,255,268,45643,0,45643,1.0,4705.29,11577.96,4704.77,11577.49,2125,2124
14687,14982,11432,11808,295,376,57024,3275,53749,0.9425680415263749,14834.39,11621.18,14833.84,11620.31,2127,2125
7186,7286,11433,11514,100,81,6028,0,6028,1.0,7232.57,11474.35,7232.2,11473.81,2126,2126
14620,14760,11435,11760,140,325,22063,454,21609,0.9794225626614694,14688.55,11617.38,14688.21,11615.96,2135,2127
2541,3178,11445,11966,637,521,193938,2072,191866,0.989316173209995,2857.67,11712.56,2857.35,11711.78,2128,2128
5602,5911,11462,11745,309,283,60186,0,60186,1.0,5743.01,11604.3,5742.59,11603.78,2129,2129
6054,6347,11463,11665,293,202,37966,0,37966,1.0,6215.06,11569.48,6214.36,11568.96,2130,2130
15735,16010,11470,11768,275,298,35451,0,35451,1.0,15873.74,11629.71,15873.12,11629.04,2131,2131
12333,12645,11471,11855,312,384,78289,0,78289,1.0,12482.86,11676.04,12482.34,11675.43,2132,2132
7145,7287,11474,11627,142,153,10216,0,10216,1.0,7221.77,11558.27,7221.73,11556.9,2134,2133
10728,11154,11475,11890,426,415,107695,0,107695,1.0,10954.29,11678.39,10953.63,11677.95,2133,2134
8196,8947,11488,12097,751,609,182323,5271,177052,0.9710897692556617,8588.57,11787.91,8587.62,11787.62,2136,2135
13353,13680,11488,11860,327,372,72249,0,72249,1.0,13528.47,11683.25,13527.75,11682.52,2137,2136
3562,3957,11500,11994,395,494,114819,0,114819,1.0,3771.26,11702.37,3770.91,11702.27,2138,2137
12769,12983,11502,11669,214,167,18220,0,18220,1.0,12873.98,11586.02,12873.32,11585.83,2139,2138
6965,7207,11504,11723,242,219,25876,0,25876,1.0,7076.79,11597.54,7076.14,11597.09,2140,2139
6752,7021,11505,11676,269,171,29658,0,29658,1.0,6894.2,11585.77,6893.4,11585.43,2141,2140
6551,6754,11510,11653,203,143,17258,113,17145,0.9934523119712597,6652.01,11586.14,6651.44,11585.6,2142,2141
14929,15147,11524,11791,218,267,36514,833,35681,0.9771868324478282,15027.81,11658.54,15027.42,11658.03,2143,2142
3163,3691,11528,12021,528,493,127437,0,127437,1.0,3439.0,11810.52,3438.41,11809.77,2144,2143
13988,14482,11528,12092,494,564,154919,6334,148585,0.9591141177002175,14252.85,11765.98,14252.4,11765.75,2145,2144
6324,6471,11529,11705,147,176,17569,2311,15258,0.8684614946781263,6396.18,11613.06,6395.66,11612.61,2146,2145
9496,9924,11536,11970,428,434,111359,3515,107844,0.9684354205766934,9727.74,11769.3,9727.28,11768.79,2147,2146
13857,14015,11538,11739,158,201,17646,0,17646,1.0,13947.01,11642.39,13946.42,11641.76,2148,2147
11142,11331,11545,11861,189,316,33972,0,33972,1.0,11225.16,11723.71,11224.69,11722.85,2151,2148
3912,4238,11550,11976,326,426,50788,0,50788,1.0,4064.8,11758.16,4064.38,11757.76,2149,2149
10184,10754,11551,12106,570,555,188472,5771,182701,0.9693800670656649,10463.25,11818.25,10462.82,11817.68,2150,2150
13289,13417,11556,11771,128,215,17471,0,17471,1.0,13355.52,11670.24,13354.98,11669.63,2152,2151
8942,9366,11557,12022,424,465,135774,6790,128984,0.9499904252655148,9187.13,11810.08,9186.44,11809.59,2153,2152
12536,12717,11559,11749,181,190,16054,0,16054,1.0,12643.13,11637.08,12642.13,11636.56,2154,2153
4297,4626,11561,11790,329,229,39736,0,39736,1.0,4457.99,11682.19,4457.51,11681.69,2155,2154
7237,7363,11562,11670,126,108,8025,712,7313,0.9112772585669782,7300.9,11617.27,7300.4,11616.76,2156,2155
9893,10260,11562,11901,367,339,85257,14,85243,0.9998357906095687,10048.68,11739.09,10048.45,11738.46,2157,2156
8158,8497,11563,11914,339,351,60875,0,60875,1.0,8327.44,11757.19,8327.24,11756.26,2158,2157
15651,15935,11582,11920,284,338,56167,0,56167,1.0,15790.22,11761.19,15789.69,11760.58,2159,2158
5890,6157,11583,11870,267,287,50684,3109,47575,0.9386591429247889,6030.52,11713.96,6029.85,11713.45,2160,2159
4800,5252,11584,12088,452,504,127609,94,127515,0.9992633748403326,5029.56,11807.33,5029.11,11806.92,2161,2160
7766,7938,11599,11772,172,173,16978,2148,14830,0.8734833313700082,7846.62,11671.26,7846.22,11671.09,2162,2161
6559,6843,11602,11862,284,260,41604,0,41604,1.0,6698.9,11736.79,6698.6,11736.35,2163,2162
6410,6613,11608,11742,203,134,15640,1947,13693,0.8755115089514066,6524.2,11667.92,6523.34,11667.68,2164,2163
4072,4427,11609,11900,355,291,58425,0,58425,1.0,4258.97,11749.03,4258.3,11748.45,2165,2164
7047,7260,11613,11780,213,167,24793,1930,22863,0.9221554471020046,7167.66,11699.87,7166.98,11699.35,2166,2165
14944,15422,11613,12021,478,408,103888,0,103888,1.0,15180.0,11795.36,15179.4,11794.97,2167,2166
7327,7595,11614,11807,268,193,33377,861,32516,0.9742037930311293,7450.62,11704.3,7450.32,11703.91,2168,2167
11524,11748,11617,11804,224,187,25621,0,25621,1.0,11631.86,11727.63,11631.51,11727.01,2169,2168
13659,14003,11620,12060,344,440,91622,0,91622,1.0,13834.64,11823.45,13834.19,11823.08,2172,2169
8752,9032,11622,11922,280,300,48559,0,48559,1.0,8910.0,11788.29,8909.37,11787.79,2170,2170
11865,12091,11623,11859,226,236,29089,0,29089,1.0,11979.85,11737.14,11979.41,11736.66,2171,2171
5722,5929,11626,11831,207,205,21827,0,21827,1.0,5840.14,11739.47,5839.39,11738.87,2173,2172
12629,13081,11629,12123,452,494,137671,0,137671,1.0,12850.9,11849.83,12850.57,11849.32,2174,2173
6793,7023,11640,11831,230,191,27396,0,27396,1.0,6887.64,11718.47,6887.49,11718.1,2175,2174
7242,7367,11645,11802,125,157,12213,0,12213,1.0,7301.45,11731.87,7300.95,11731.26,2177,2175
6127,6409,11646,11931,282,285,57926,0,57926,1.0,6270.65,11775.58,6270.14,11775.2,2176,2176
11717,12040,11650,11997,323,347,47595,1843,45752,0.9612774451097804,11866.53,11815.76,11866.2,11815.36,2178,2177
15007,15810,11656,12488,803,832,421226,1995,419231,0.9952638251200069,15439.59,12103.19,15439.12,12102.81,2179,2178
5167,5426,11665,11913,259,248,36968,2839,34129,0.9232038519800909,5298.39,11784.11,5297.86,11783.64,2180,2179
14768,14971,11681,11947,203,266,33134,0,33134,1.0,14867.55,11815.74,14867.1,11815.21,2181,2180
4612,4912,11682,11974,300,292,53793,869,52924,0.9838454817541316,4758.15,11819.2,4757.74,11818.82,2182,2181
12059,12441,11684,11967,382,283,66256,0,66256,1.0,12241.29,11817.15,12240.96,11816.71,2183,2182
14449,14676,11685,11840,227,155,20840,1602,19238,0.9231285988483685,14563.11,11759.44,14562.65,11758.92,2184,2183
2435,2648,11686,11888,213,202,23990,271,23719,0.9887036265110463,2542.93,11785.24,2542.14,11784.68,2185,2184
6398,6602,11700,11879,204,179,23582,2200,21382,0.9067085064879993,6486.01,11788.85,6485.64,11788.31,2186,2185
5501,5754,11709,11903,253,194,33082,0,33082,1.0,5629.16,11813.71,5628.64,11813.2,2187,2186
15929,16037,11710,11953,108,243,17618,82,17536,0.9953456692019526,15983.78,11837.5,15983.3,11836.82,2189,2187
6857,7091,11711,11893,234,182,26414,0,26414,1.0,6992.85,11809.04,6992.0,11808.52,2188,2188
7661,7878,11714,11891,217,177,24604,1785,22819,0.9274508210047147,7766.98,11798.7,7766.54,11798.24,2190,2189
7484,7664,11718,11884,180,166,17698,0,17698,1.0,7580.65,11805.15,7579.95,11804.42,2192,2190
3881,4076,11722,12011,195,289,28000,0,28000,1.0,3980.06,11878.4,3979.21,11877.9,2191,2191
10582,10951,11729,12067,369,338,59714,0,59714,1.0,10769.63,11917.41,10768.88,11917.22,2193,2192
7849,8192,11734,11948,343,214,43187,2676,40511,0.9380369092550999,8028.31,11840.88,8027.84,11840.35,2197,2193
13056,13297,11735,12010,241,275,46517,0,46517,1.0,13171.41,11859.3,13171.02,11858.9,2194,2194
13944,14117,11735,11923,173,188,18428,1635,16793,0.9112763186455394,14016.12,11831.6,14015.8,11831.06,2195,2195
13263,13505,11737,11996,242,259,38452,0,38452,1.0,13381.25,11876.67,13380.77,11876.08,2196,2196
11327,11570,11742,11912,243,170,21883,1169,20714,0.9465795366266051,11437.39,11817.72,11437.24,11817.18,2198,2197
4339,4632,11749,12111,293,362,77626,1516,76110,0.9804704609280396,4499.56,11932.65,4499.2,11931.93,2199,2198
14458,14771,11758,12094,313,336,44390,2831,41559,0.9362243748592025,14634.38,11907.86,14633.24,11907.97,2200,2199
7051,7240,11761,11961,189,200,24398,2187,22211,0.9103615050413968,7146.82,11852.29,7146.3,11851.9,2202,2200
10865,11256,11761,12073,391,312,72464,962,71502,0.986724442481784,11050.51,11922.38,11050.19,11921.72,2201,2201
15630,15988,11766,12080,358,314,48411,0,48411,1.0,15803.64,11943.33,15803.01,11942.55,2203,2202
7228,7396,11774,12019,168,245,25008,981,24027,0.9607725527831094,7306.82,11889.0,7306.5,11888.65,2204,2203
5730,6015,11780,11957,285,177,36011,0,36011,1.0,5869.09,11875.43,5868.65,11874.88,2205,2204
11391,11915,11783,12222,524,439,162643,0,162643,1.0,11651.1,12003.18,11650.67,12002.69,2206,2205
7353,7558,11784,11993,205,209,33147,1749,31398,0.9472350438953752,7454.54,11891.48,7454.03,11890.93,2207,2206
2979,3583,11794,12481,604,687,271561,2918,268643,0.9892547162515972,3266.54,12149.37,3266.19,12148.83,2208,2207
13518,13729,11799,11949,211,150,17294,1363,15931,0.9211865386839366,13638.67,11879.86,13637.82,11879.21,2209,2208
14462,14586,11801,11978,124,177,13835,0,13835,1.0,14511.5,11885.14,14511.18,11884.63,2210,2209
6441,6778,11811,12113,337,302,72778,0,72778,1.0,6613.49,11961.17,6612.91,11960.72,2211,2210
6761,7108,11815,12154,347,339,68529,833,67696,0.9878445621561674,6916.55,11976.93,6916.08,11976.43,2212,2211
7716,7940,11817,12086,224,269,27758,962,26796,0.9653433244470063,7828.86,11970.68,7828.48,11969.72,2213,2212
6000,6264,11818,12035,264,217,34362,0,34362,1.0,6121.13,11926.52,6120.82,11926.03,2214,2213
7616,7790,11825,12017,174,192,17677,0,17677,1.0,7706.55,11914.93,7705.94,11914.44,2215,2214
12276,12785,11827,12223,509,396,115198,0,115198,1.0,12503.02,12001.97,12503.06,12001.65,2216,2215
3582,4004,11828,12508,422,680,152259,0,152259,1.0,3792.9,12173.82,3792.38,12173.29,2217,2216
6289,6493,11829,12049,204,220,23465,2414,21051,0.8971233752397187,6402.9,11929.84,6402.28,11929.43,2218,2217
5361,5555,11831,12022,194,191,25644,0,25644,1.0,5453.45,11925.6,5453.05,11925.09,2219,2218
8410,8819,11834,12245,409,411,69460,0,69460,1.0,8615.34,12021.98,8614.85,12021.64,2221,2219
11188,11415,11834,12152,227,318,37167,0,37167,1.0,11321.86,11971.15,11321.12,11970.86,2220,2220
10071,10481,11839,12215,410,376,63606,3135,60471,0.9507121969625507,10238.88,12030.94,10238.84,12030.65,2222,2221
12947,13231,11843,12172,284,329,46365,0,46365,1.0,13076.85,12014.53,13076.42,12014.1,2223,2222
13977,14305,11844,12191,328,347,63299,2,63297,0.9999684039242326,14156.86,11996.0,14156.24,11995.79,2224,2223
5172,5373,11847,12137,201,290,37939,0,37939,1.0,5263.94,11993.67,5263.46,11993.14,2225,2224
4079,4398,11848,12135,319,287,51913,0,51913,1.0,4254.23,12003.48,4253.38,12002.93,2226,2225
11862,12406,11849,12369,544,520,188707,7425,181282,0.9606532879013497,12128.22,12137.14,12127.73,12136.55,2227,2226
13375,13972,11851,12613,597,762,200958,0,200958,1.0,13676.01,12211.17,13675.58,12210.85,2228,2227
14868,14991,11851,12025,123,174,14503,0,14503,1.0,14930.93,11941.65,14930.42,11941.08,2229,2228
4613,4861,11855,12266,248,411,64545,0,64545,1.0,4732.6,12057.9,4732.09,12057.44,2230,2229
9637,9918,11860,12152,281,292,54771,0,54771,1.0,9796.34,12013.0,9795.84,12012.45,2231,2230
7556,7717,11868,12063,161,195,16690,0,16690,1.0,7624.13,11964.66,7623.86,11964.41,2232,2231
7865,8231,11873,12317,366,444,98561,0,98561,1.0,8056.83,12070.26,8056.35,12069.94,2233,2232
5501,5773,11881,12085,272,204,43172,3075,40097,0.9287732789771148,5637.47,11988.16,5636.98,11987.62,2234,2233
9862,10093,11885,12161,231,276,44310,0,44310,1.0,9986.31,12023.66,9985.61,12023.29,2235,2234
13681,14081,11894,12475,400,581,69528,0,69528,1.0,13897.11,12180.1,13896.41,12179.46,2236,2235
9212,9521,11896,12221,309,325,50429,0,50429,1.0,9353.81,12042.45,9353.34,12042.07,2237,2236
4838,5108,11901,12188,270,287,45496,0,45496,1.0,4967.94,12053.23,4967.47,12052.66,2238,2237
8480,8974,11908,12369,494,461,84423,0,84423,1.0,8750.02,12122.4,8749.08,12122.29,2239,2238
14697,14869,11909,12158,172,249,22742,0,22742,1.0,14772.88,12006.56,14772.19,12006.79,2240,2239
2648,2817,11910,12066,169,156,17722,0,17722,1.0,2737.0,11985.95,2736.47,11985.48,2241,2240
7108,7343,11911,12130,235,219,29786,1339,28447,0.9550459947626402,7219.92,12006.76,7219.54,12006.44,2242,2241
5720,6088,11922,12240,368,318,78148,2722,75426,0.9651686543481599,5893.07,12076.48,5892.72,12075.96,2243,2242
2788,3069,11926,12209,281,283,34967,478,34489,0.986329968255784,2928.26,12036.71,2928.17,12036.82,2244,2243
11006,11337,11926,12893,331,967,217360,0,217360,1.0,11180.25,12422.09,11179.79,12421.48,2245,2244
6172,6442,11929,12249,270,320,50166,0,50166,1.0,6310.25,12078.55,6309.73,12078.12,2246,2245
9378,9692,11934,12242,314,308,48056,1113,46943,0.9768395205593474,9523.83,12089.11,9523.56,12088.33,2247,2246
3881,4165,11949,12286,284,337,66852,0,66852,1.0,4028.72,12106.72,4028.19,12106.3,2248,2247
15810,16274,11953,12440,464,487,106403,0,106403,1.0,16031.58,12218.69,16030.74,12218.01,2249,2248
14492,14727,11960,12284,235,324,38097,1667,36430,0.9562432737485891,14631.31,12104.41,14630.6,12104.26,2250,2249
13216,13396,11963,12140,180,177,23268,0,23268,1.0,13306.79,12050.89,13306.48,12050.45,2251,2250
7353,7653,11975,12231,300,256,38657,2309,36348,0.9402695501461572,7530.99,12082.04,7530.27,12081.58,2252,2251
10478,10960,11978,12513,482,535,173359,4102,169257,0.976338119163124,10724.6,12242.17,10723.85,12241.59,2253,2252
8808,9230,11979,12375,422,396,116831,2743,114088,0.9765216423723155,9051.12,12177.9,9050.51,12177.45,2254,2253
14879,15047,11982,12220,168,238,28176,1626,26550,0.9422913117546848,14961.97,12097.77,14961.48,12097.29,2255,2254
14323,14637,11985,12326,314,341,47937,5849,42088,0.8779856895508689,14452.36,12179.67,14452.46,12179.1,2256,2255
14700,14904,11989,12230,204,241,25164,0,25164,1.0,14806.78,12128.45,14806.45,12127.58,2259,2256
5248,5525,11991,12299,277,308,53762,0,53762,1.0,5383.3,12147.28,5382.84,12146.68,2257,2257
6962,7235,11992,12242,273,250,44384,2709,41675,0.9389644917087239,7095.69,12133.07,7095.23,12132.42,2258,2258
7234,7553,12011,12287,319,276,51163,3863,47300,0.9244962179700174,7389.15,12166.81,7388.63,12166.14,2261,2259
5958,6258,12017,12260,300,243,41317,0,41317,1.0,6109.47,12151.84,6109.01,12151.3,2260,2260
12553,12837,12022,12343,284,321,53861,0,53861,1.0,12711.66,12181.17,12711.03,12180.72,2262,2261
10953,11139,12027,12204,186,177,13577,1099,12478,0.9190542829785667,11023.99,12115.42,11024.37,12114.43,2264,2262
6555,6878,12030,12260,323,230,46501,0,46501,1.0,6719.83,12141.57,6719.18,12141.16,2263,2263
7625,8044,12037,12387,419,350,77793,0,77793,1.0,7821.8,12205.15,7821.47,12204.71,2265,2264
13922,14266,12037,12388,344,351,70351,0,70351,1.0,14102.41,12224.32,14101.67,12223.54,2266,2265
15785,15938,12039,12295,153,256,22344,0,22344,1.0,15844.13,12178.84,15843.71,12178.16,2267,2266
14226,14389,12047,12282,163,235,24671,0,24671,1.0,14302.94,12168.53,14302.49,12167.93,2268,2267
6258,6594,12048,12429,336,381,62925,2407,60518,0.9617481128327374,6443.82,12256.26,6443.09,12255.68,2269,2268
8108,8533,12050,12480,425,430,103979,1284,102695,0.9876513526769829,8294.59,12240.99,8294.21,12240.58,2270,2269
2680,3070,12055,12415,390,360,81176,0,81176,1.0,2901.9,12225.2,2901.12,12224.57,2271,2270
3471,3746,12061,12410,275,349,51229,0,51229,1.0,3597.79,12253.9,3597.34,12253.48,2273,2271
12823,13159,12062,12423,336,361,66605,0,66605,1.0,12982.25,12236.86,12981.9,12236.76,2272,2272
4365,4833,12063,12532,468,469,124471,0,124471,1.0,4569.57,12293.62,4569.36,12293.18,2274,2273
5469,5754,12073,12300,285,227,46413,415,45998,0.9910585396332924,5610.72,12180.5,5610.21,12180.06,2275,2274
13091,13322,12079,12407,231,328,55200,0,55200,1.0,13201.08,12245.23,13200.61,12244.73,2276,2275
11302,11458,12085,12320,156,235,25798,0,25798,1.0,11376.96,12207.62,11376.55,12207.07,2277,2276
9846,10370,12087,12426,524,339,123994,0,123994,1.0,10106.53,12256.22,10105.99,12255.65,2278,2277
5073,5300,12088,12397,227,309,49211,0,49211,1.0,5173.47,12244.9,5173.04,12244.41,2279,2278
9235,9865,12090,12600,630,510,168383,6706,161677,0.9601741268417833,9547.1,12348.94,9546.64,12348.37,2280,2279
3863,4434,12100,12695,571,595,207325,0,207325,1.0,4172.02,12419.0,4171.51,12418.55,2281,2280
4816,5086,12108,12391,270,283,50514,0,50514,1.0,4952.78,12253.9,4952.36,12253.23,2282,2281
10259,10602,12109,12517,343,408,73885,0,73885,1.0,10417.02,12332.58,10416.72,12331.8,2283,2282
6809,7011,12127,12354,202,227,29537,0,29537,1.0,6902.96,12244.45,6902.51,12243.85,2285,2283
13286,13594,12128,12343,308,215,35422,0,35422,1.0,13415.33,12255.67,13415.19,12255.02,2284,2284
9242,9436,12131,12312,194,181,18516,1490,17026,0.9195290559516094,9346.16,12225.56,9345.57,12224.95,2286,2285
2162,2374,12139,12311,212,172,29757,0,29757,1.0,2263.94,12223.11,2263.57,12222.69,2287,2286
14801,14953,12147,12328,152,181,12109,0,12109,1.0,14864.63,12236.54,14864.48,12235.96,2289,2287
11328,11832,12148,13123,504,975,293883,11480,282403,0.9609368354072879,11623.78,12596.07,11623.11,12595.69,2288,2288
10889,11034,12159,12425,145,266,22683,0,22683,1.0,10977.28,12298.26,10976.59,12297.94,2290,2289
7121,7378,12166,12466,257,300,44701,2648,42053,0.9407619516341916,7258.68,12317.85,7258.05,12317.23,2291,2290
6127,6316,12169,12364,189,195,21649,0,21649,1.0,6229.64,12268.06,6229.01,12267.53,2292,2291
12386,12554,12169,12346,168,177,16414,0,16414,1.0,12456.41,12253.71,12455.92,12253.11,2293,2292
11714,11992,12173,12414,278,241,37244,0,37244,1.0,11854.52,12290.97,11854.12,12290.51,2294,2293
14838,15113,12173,12424,275,251,35448,0,35448,1.0,14975.09,12298.7,14974.63,12298.19,2295,2294
5642,5892,12193,12485,250,292,43092,1373,41719,0.968137937436183,5773.93,12325.38,5773.27,12325.05,2296,2295
7620,7849,12196,12404,229,208,20604,0,20604,1.0,7729.6,12310.23,7729.03,12309.51,2297,2296
7488,7721,12199,12423,233,224,25015,0,25015,1.0,7604.78,12315.41,7604.44,12315.06,2298,2297
8368,8973,12204,12694,605,490,141332,0,141332,1.0,8693.27,12465.43,8692.54,12465.14,2299,2298
14570,14839,12216,12504,269,288,54038,159,53879,0.9970576261149562,14703.96,12364.27,14703.46,12363.74,2301,2299
14435,14628,12217,12432,193,215,25832,2503,23329,0.9031046763703933,14529.55,12328.67,14529.06,12328.09,2300,2300
5876,6194,12219,12486,318,267,57057,0,57057,1.0,6032.86,12348.14,6032.38,12347.68,2302,2301
9132,9335,12219,12480,203,261,22492,836,21656,0.9628312288813801,9235.6,12354.92,9235.01,12354.31,2303,2302
6532,6821,12221,12381,289,160,33461,0,33461,1.0,6689.12,12302.81,6688.45,12302.33,2304,2303
4714,4838,12224,12349,124,125,9914,0,9914,1.0,4776.09,12288.28,4775.46,12287.67,2306,2304
6908,7168,12226,12455,260,229,38526,0,38526,1.0,7051.58,12340.57,7050.95,12340.12,2305,2305
5386,5719,12234,12576,333,342,67483,1107,66376,0.9835958685891262,5554.5,12395.85,5553.99,12395.42,2307,2306
12304,12803,12235,12964,499,729,217137,10191,206946,0.953066497188411,12587.59,12600.38,12586.85,12600.23,2308,2307
9656,9961,12261,12633,305,372,66286,2467,63819,0.9627824880065172,9808.29,12453.89,9807.84,12453.31,2309,2308
12742,12994,12262,12453,252,191,30376,0,30376,1.0,12860.54,12366.74,12860.13,12366.19,2310,2309
11310,11455,12273,12489,145,216,18753,0,18753,1.0,11373.9,12385.57,11373.2,12384.87,2313,2310
14858,15268,12274,12811,410,537,116766,0,116766,1.0,15047.91,12540.95,15047.5,12540.44,2311,2311
8235,8564,12275,12655,329,380,74105,0,74105,1.0,8401.44,12451.22,8400.96,12450.81,2312,2312
7359,7615,12277,12413,256,136,18849,142,18707,0.9924664438431747,7459.92,12343.59,7460.58,12343.6,2314,2313
14231,14456,12277,12568,225,291,35459,1536,33923,0.9566823655489438,14352.66,12408.56,14351.86,12408.25,2315,2314
5239,5408,12281,12483,169,202,22860,0,22860,1.0,5326.09,12377.09,5325.57,12376.69,2316,2315
8006,8150,12291,12462,144,171,13109,0,13109,1.0,8078.23,12366.49,8077.93,12366.38,2317,2316
4640,4968,12300,12646,328,346,46093,58,46035,0.9987416744408044,4806.48,12469.26,4806.04,12469.08,2318,2317
12253,12450,12302,12644,197,342,46249,1397,44852,0.9697939414906268,12366.25,12462.4,12365.67,12461.97,2319,2318
13163,13598,12309,12641,435,332,78531,0,78531,1.0,13406.68,12456.44,13406.4,12455.81,2320,2319
13529,13799,12314,12682,270,368,53834,0,53834,1.0,13662.48,12501.68,13661.94,12501.09,2322,2320
6734,6937,12315,12564,203,249,27258,1674,25584,0.9385868368919217,6821.02,12424.84,6820.47,12424.6,2321,2321
4861,5356,12326,12706,495,380,87094,1576,85518,0.9819046088134659,5113.82,12497.86,5113.37,12497.66,2323,2322
8554,9206,12335,12891,652,556,140302,0,140302,1.0,8911.58,12608.36,8910.57,12608.32,2324,2323
11893,11998,12338,12503,105,165,10723,0,10723,1.0,11950.61,12423.7,11950.12,12423.05,2325,2324
6531,6810,12340,12664,279,324,39974,2658,37316,0.9335067794066143,6681.84,12512.92,6681.03,12511.99,2327,2325
6354,6625,12341,12587,271,246,47255,0,47255,1.0,6495.0,12476.14,6494.41,12475.63,2326,2326
14744,14931,12342,12640,187,298,34376,376,34000,0.9890621363742146,14832.29,12497.63,14831.87,12496.95,2328,2327
15408,15715,12345,12643,307,298,56094,1355,54739,0.9758441188005847,15569.74,12499.68,15569.19,12499.12,2329,2328
6122,6364,12347,12594,242,247,41132,0,41132,1.0,6256.87,12473.07,6256.23,12472.54,2330,2329
11967,12318,12349,12821,351,472,124925,0,124925,1.0,12129.01,12565.82,12128.53,12565.42,2331,2330
7798,7940,12360,12474,142,114,9784,461,9323,0.9528822567457073,7872.79,12416.9,7872.16,12416.39,2332,2331
7919,8067,12362,12479,148,117,9782,791,8991,0.9191371907585361,7988.66,12416.44,7988.29,12415.96,2334,2332
14143,14311,12362,12516,168,154,16911,0,16911,1.0,14231.13,12436.18,14230.43,12435.57,2333,2333
3453,3722,12370,12583,269,213,29503,3532,25971,0.8802833610141342,3556.5,12474.06,3556.65,12473.26,2335,2334
7274,7632,12371,12544,358,173,41450,0,41450,1.0,7461.96,12461.69,7461.3,12461.18,2336,2335
6760,7100,12375,12729,340,354,60420,3366,57054,0.9442899702085402,6931.46,12552.83,6930.92,12552.17,2339,2336
2910,3169,12377,12661,259,284,43403,0,43403,1.0,3036.94,12509.03,3036.35,12508.46,2338,2337
5684,6090,12377,12799,406,422,100394,0,100394,1.0,5887.22,12576.26,5886.91,12576.2,2337,2338
7710,7902,12378,12597,192,219,24849,1981,22868,0.9202784820314701,7800.75,12492.15,7800.2,12491.54,2340,2339
14026,14253,12381,12675,227,294,34040,181,33859,0.9946827262044653,14130.82,12527.6,14130.71,12527.51,2342,2340
4304,4690,12382,12691,386,309,63608,0,63608,1.0,4491.67,12557.62,4491.25,12557.0,2343,2341
10080,10269,12382,12581,189,199,22933,0,22933,1.0,10178.2,12464.08,10177.62,12463.87,2341,2342
3534,3876,12386,12798,342,412,76190,259,75931,0.9966006037537735,3685.48,12600.17,3685.01,12599.58,2344,2343
11808,12017,12386,12815,209,429,56647,0,56647,1.0,11894.66,12628.47,11894.14,12627.68,2345,2344
7086,7275,12390,12583,189,193,21459,0,21459,1.0,7173.64,12482.11,7173.22,12481.67,2346,2345
10775,11054,12392,12735,279,343,68968,0,68968,1.0,10914.68,12562.93,10914.22,12562.5,2347,2346
12963,13176,12393,12586,213,193,28948,0,28948,1.0,13066.5,12481.62,13066.04,12481.12,2348,2347
10414,10590,12403,12636,176,233,20904,772,20132,0.9630692690394183,10495.8,12514.68,10495.38,12514.19,2349,2348
5320,5590,12406,12725,270,319,57503,0,57503,1.0,5442.34,12584.51,5441.89,12583.81,2351,2349
7602,7752,12406,12617,150,211,17479,0,17479,1.0,7674.04,12502.41,7673.5,12502.16,2350,2350
14402,14586,12409,12612,184,203,23496,0,23496,1.0,14493.34,12501.05,14492.85,12500.69,2352,2351
9834,10150,12414,12749,316,335,69109,0,69109,1.0,9989.67,12590.32,9989.2,12589.78,2353,2352
7989,8175,12423,12584,186,161,19540,0,19540,1.0,8080.76,12504.24,8080.26,12503.75,2354,2353
12752,13140,12427,13089,388,662,166545,496,166049,0.9970218259329311,12931.95,12764.86,12931.55,12764.44,2355,2354
15136,15443,12440,12655,307,215,33453,0,33453,1.0,15311.2,12565.27,15309.81,12564.58,2357,2355
3137,3457,12441,12695,320,254,52326,0,52326,1.0,3315.33,12550.61,3314.62,12550.07,2356,2356
7852,8064,12452,12713,212,261,30619,653,29966,0.9786733727424148,7957.8,12582.45,7957.22,12581.95,2358,2357
8025,8466,12463,12873,441,410,78470,5439,73031,0.9306868867082961,8270.03,12675.01,8269.17,12674.22,2359,2358
13754,14099,12471,12714,345,243,41528,0,41528,1.0,13945.19,12599.86,13944.24,12599.45,2360,2359
8773,9374,12472,13078,601,606,183301,2739,180562,0.985057364662495,9089.81,12789.8,9089.17,12789.32,2361,2360
13074,13538,12473,12859,464,386,117145,0,117145,1.0,13287.39,12671.61,13286.97,12671.08,2362,2361
6005,6232,12479,12700,227,221,28010,0,28010,1.0,6106.22,12595.3,6105.88,12594.72,2363,2362
7167,7341,12480,12668,174,188,19138,0,19138,1.0,7259.66,12582.96,7259.12,12582.28,2365,2363
10484,10935,12481,13150,451,669,189302,294,189008,0.9984469260757942,10696.95,12809.5,10696.5,12808.96,2364,2364
14448,14752,12488,12783,304,295,57882,2410,55472,0.9583635672575239,14597.68,12630.64,14597.18,12630.14,2366,2365
14208,14334,12500,12660,126,160,12404,1615,10789,0.8698000644953241,14259.86,12570.57,14259.55,12570.25,2367,2366
10013,10451,12501,12950,438,449,132581,5697,126884,0.957030042012053,10246.59,12719.23,10246.01,12718.78,2368,2367
5363,5894,12503,13001,531,498,135671,1943,133728,0.9856785901187431,5628.16,12798.73,5627.65,12798.21,2370,2368
9346,9851,12504,12892,505,388,131342,1886,129456,0.98564054148711,9586.29,12703.02,9585.85,12702.53,2369,2369
11207,11614,12516,13361,407,845,185980,0,185980,1.0,11406.86,12971.0,11406.31,12970.33,2371,2370
6911,7213,12519,12876,302,357,53226,0,53226,1.0,7087.85,12691.25,7087.04,12691.01,2372,2371
7326,7659,12520,12729,333,209,47584,0,47584,1.0,7479.48,12608.67,7479.02,12608.3,2373,2372
6244,6895,12537,12858,651,321,87729,4147,83582,0.9527294281252493,6513.76,12688.72,6513.74,12688.31,2374,2373
14245,14475,12538,12781,230,243,34593,0,34593,1.0,14356.16,12658.4,14355.68,12657.92,2375,2374
3017,3328,12540,12928,311,388,65341,1198,64143,0.9816654168133331,3176.72,12724.5,3176.23,12724.1,2376,2375
4900,5095,12551,12707,195,156,22974,0,22974,1.0,4999.81,12628.09,4999.28,12627.69,2377,2376
7650,7978,12554,12790,328,236,44612,2540,42072,0.9430646462835112,7807.47,12677.01,7807.06,12676.49,2378,2377
4688,4919,12561,12751,231,190,30895,0,30895,1.0,4815.73,12652.08,4815.16,12651.62,2379,2378
3766,4271,12563,13116,505,553,151100,630,150470,0.9958305757776307,4007.37,12819.43,4006.67,12818.99,2380,2379
3308,3566,12575,12782,258,207,31809,2515,29294,0.9209343267628659,3446.96,12683.61,3446.36,12683.09,2381,2380
5158,5404,12577,12813,246,236,33775,0,33775,1.0,5269.39,12702.03,5269.04,12701.52,2382,2381
13444,13733,12578,13026,289,448,83998,0,83998,1.0,13592.21,12820.45,13591.65,12819.72,2383,2382
15132,15563,12580,12936,431,356,78059,0,78059,1.0,15362.95,12734.16,15362.21,12733.6,2384,2383
15517,15668,12582,12775,151,193,15855,0,15855,1.0,15597.1,12701.49,15596.9,12700.21,2386,2384
6170,6322,12592,12794,152,202,18974,0,18974,1.0,6247.32,12675.08,6246.77,12674.92,2385,2385
14579,14938,12610,12953,359,343,70490,0,70490,1.0,14745.18,12774.98,14744.72,12774.53,2387,2386
7158,7382,12615,12935,224,320,39644,0,39644,1.0,7268.11,12773.7,7267.64,12773.19,2389,2387
12224,12438,12615,12827,214,212,30697,2161,28536,0.929602241261361,12339.62,12726.07,12339.0,12725.54,2388,2388
7977,8188,12627,12795,211,168,19457,0,19457,1.0,8084.53,12717.4,8084.0,12716.86,2391,2389
10388,10547,12627,12877,159,250,26220,1653,24567,0.9369565217391305,10478.96,12758.6,10478.34,12758.11,2390,2390
13705,13931,12627,12996,226,369,48857,218,48639,0.9955379986491188,13804.08,12820.43,13803.56,12819.81,2392,2391
14102,14250,12629,12761,148,132,10715,0,10715,1.0,14184.97,12692.07,14184.17,12691.55,2393,2392
3403,3876,12631,13314,473,683,124348,2469,121879,0.9801444333644289,3608.13,12937.37,3608.2,12936.62,2395,2393
7493,7783,12633,12857,290,224,32540,42,32498,0.9987092808850645,7643.29,12742.36,7642.75,12741.88,2394,2394
4192,4449,12636,13036,257,400,61149,0,61149,1.0,4325.42,12835.78,4324.9,12835.31,2396,2395
4444,4638,12638,12808,194,170,19234,0,19234,1.0,4540.52,12714.32,4540.14,12713.92,2397,2396
8447,8706,12638,12812,259,174,30057,0,30057,1.0,8580.99,12722.91,8580.44,12722.44,2398,2397
6008,6214,12641,12808,206,167,17552,0,17552,1.0,6119.04,12736.15,6118.31,12735.54,2399,2398
5038,5185,12653,12840,147,187,17777,0,17777,1.0,5107.45,12742.55,5106.93,12742.16,2400,2399
13860,14176,12654,12901,316,247,50561,2873,47688,0.9431775479124226,14014.1,12765.79,14013.74,12765.44,2401,2400
4633,4746,12657,12771,113,114,9664,0,9664,1.0,4686.65,12716.91,4686.2,12716.37,2402,2401
14977,15289,12658,13047,312,389,66335,0,66335,1.0,15139.53,12858.46,15139.13,12858.08,2403,2402
10867,11319,12669,13548,452,879,243212,8605,234607,0.9646193444402414,11086.07,13133.8,11085.58,13133.1,2404,2403
4909,5152,12685,13067,243,382,45245,4134,41111,0.9086307879323682,5026.62,12866.34,5026.11,12866.14,2405,2404
6253,6735,12695,12974,482,279,70136,1625,68511,0.9768307288696247,6524.13,12832.22,6523.01,12831.78,2406,2405
4728,4960,12706,12941,232,235,24865,830,24035,0.9666197466318118,4854.15,12804.28,4853.48,12804.19,2407,2406
7327,7715,12708,13027,388,319,75006,2735,72271,0.9635362504332987,7513.75,12865.52,7513.27,12865.18,2408,2407
4379,4669,12709,13020,290,311,45985,0,45985,1.0,4502.46,12858.28,4502.67,12857.67,2409,2408
6681,6929,12709,13009,248,300,45513,1134,44379,0.9750840419220882,6803.32,12867.34,6803.22,12867.04,2410,2409
14224,14493,12713,13022,269,309,51484,0,51484,1.0,14355.29,12870.18,14354.85,12869.62,2411,2410
7905,8226,12715,13074,321,359,58127,2268,55859,0.9609819877165516,8078.56,12894.7,8078.03,12893.87,2412,2411
14145,14298,12715,12913,153,198,18582,0,18582,1.0,14215.06,12817.71,14214.67,12817.1,2413,2412
6882,7078,12724,12978,196,254,27065,428,26637,0.9841862183631997,6967.1,12840.42,6966.48,12840.16,2414,2413
3204,3464,12726,13146,260,420,57859,1174,56685,0.979709293281944,3323.06,12934.8,3322.48,12934.22,2415,2414
8392,8623,12737,12998,231,261,31234,0,31234,1.0,8504.54,12889.67,8503.95,12888.72,2417,2415
9734,10098,12738,13091,364,353,89906,0,89906,1.0,9901.21,12912.37,9900.75,12911.91,2416,2416
4574,4765,12744,12995,191,251,17028,0,17028,1.0,4665.52,12855.34,4664.73,12855.24,2418,2417
12028,12321,12747,13098,293,351,61991,0,61991,1.0,12182.58,12907.06,12181.89,12906.65,2419,2418
15372,15756,12748,13122,384,374,87499,1080,86419,0.9876570017943063,15587.06,12927.62,15586.31,12927.04,2420,2419
5831,6053,12753,12930,222,177,28030,1124,26906,0.9599001070281841,5934.71,12842.07,5934.29,12841.65,2421,2420
8164,8434,12762,13005,270,243,23711,1765,21946,0.9255619754544304,8314.48,12880.17,8313.6,12879.48,2422,2421
4575,4848,12767,13072,273,305,35394,0,35394,1.0,4714.65,12952.24,4714.29,12950.81,2424,2422
6030,6251,12768,12914,221,146,20057,1585,18472,0.9209752206212295,6129.4,12836.0,6129.18,12835.48,2423,2423
11783,12048,12775,13034,265,259,42733,0,42733,1.0,11916.6,12885.94,11916.12,12885.63,2425,2424
5074,5253,12776,13102,179,326,31771,580,31191,0.9817443580623839,5175.56,12930.72,5174.87,12930.51,2426,2425
5187,5426,12778,13062,239,284,34276,0,34276,1.0,5313.88,12894.58,5312.54,12894.36,2429,2426
7700,8036,12778,13020,336,242,47188,0,47188,1.0,7870.18,12887.42,7869.84,12887.11,2427,2427
14457,14659,12779,12975,202,196,16834,0,16834,1.0,14539.5,12866.03,14539.86,12866.38,2428,2428
14564,15066,12801,13247,502,446,141625,0,141625,1.0,14812.05,13035.07,14811.59,13034.55,2430,2429
13078,13206,12803,12908,128,105,8664,0,8664,1.0,13140.68,12863.38,13140.22,12862.73,2431,2430
13183,13504,12812,13139,321,327,63140,2,63138,0.9999683243585683,13352.73,12953.14,13352.18,12952.85,2432,2431
7056,7192,12817,12966,136,149,13271,0,13271,1.0,7131.5,12888.58,7130.86,12888.15,2433,2432
8984,9511,12825,13280,527,455,150469,0,150469,1.0,9255.74,13045.28,9255.29,13044.75,2434,2433
5913,6286,12829,13048,373,219,41106,3603,37503,0.9123485622536855,6119.82,12950.08,6119.2,12949.33,2435,2434
9492,9763,12829,13027,271,198,42896,0,42896,1.0,9634.27,12926.69,9633.67,12926.28,2436,2435
14003,14153,12832,13012,150,180,17064,955,16109,0.9440342240975153,14084.05,12913.07,14083.46,12912.75,2437,2436
12451,12815,12833,13239,364,406,104380,0,104380,1.0,12629.36,13035.95,12628.92,13035.43,2438,2437
10262,10631,12840,13247,369,407,92561,4071,88490,0.9560181934075906,10450.68,13043.75,10450.18,13043.26,2439,2438
8630,8809,12843,12987,179,144,15335,0,15335,1.0,8733.1,12907.32,8732.35,12906.86,2440,2439
7229,7466,12847,13091,237,244,33159,0,33159,1.0,7342.79,12977.11,7342.45,12976.67,2441,2440
8170,8379,12851,13100,209,249,32786,1208,31578,0.96315500518514,8272.85,12991.37,8272.21,12990.57,2442,2441
13841,14079,12859,13102,238,243,28990,3296,25694,0.8863056226284926,13955.7,12981.44,13955.42,12981.07,2443,2442
6228,6478,12864,13076,250,212,29175,0,29175,1.0,6350.87,12979.86,6350.24,12979.2,2444,2443
13068,13334,12868,13299,266,431,73131,0,73131,1.0,13197.54,13111.84,13196.93,13110.74,2446,2444
4779,4974,12870,13033,195,163,20235,1098,19137,0.9457375833951075,4884.03,12961.63,4883.45,12961.08,2445,2445
3628,3777,12883,13077,149,194,15027,0,15027,1.0,3702.97,12973.83,3702.44,12973.47,2447,2446
8595,8805,12891,13078,210,187,19438,0,19438,1.0,8691.69,12989.59,8691.33,12989.11,2448,2447
11876,12156,12893,13412,280,519,92973,47,92926,0.9994944768911405,12009.6,13176.26,12009.15,13175.57,2449,2448
6918,7122,12900,13036,204,136,18281,1151,17130,0.9370384552267381,7023.06,12973.7,7022.59,12973.15,2450,2449
14104,14642,12901,13310,538,409,129745,486,129259,0.9962541909129446,14396.29,13106.86,14395.64,13106.27,2451,2450
9949,10351,12902,13258,402,356,93120,0,93120,1.0,10154.14,13089.06,10153.86,13088.26,2453,2451
5404,5837,12903,13198,433,295,72894,3569,69325,0.9510384942519274,5629.79,13046.23,5629.23,13045.65,2452,2452
14083,14238,12907,13039,155,132,11479,0,11479,1.0,14172.18,12972.3,14171.24,12972.09,2454,2453
4060,4204,12914,13025,144,111,10913,0,10913,1.0,4129.31,12969.42,4128.86,12968.91,2455,2454
6439,6695,12916,13135,256,219,34643,0,34643,1.0,6575.86,13014.89,6575.14,13014.56,2456,2455
12015,12511,12919,13566,496,647,160777,1020,159757,0.9936558089776523,12277.76,13236.7,12277.07,13236.67,2457,2456
13566,14045,12922,13367,479,445,99136,2475,96661,0.9750342963202066,13804.14,13135.83,13803.12,13135.49,2458,2457
7633,8049,12924,13241,416,317,78794,0,78794,1.0,7845.48,13068.5,7845.08,13068.15,2459,2458
7094,7259,12927,13084,165,157,17471,0,17471,1.0,7178.16,13006.46,7177.61,13005.99,2460,2459
5788,6025,12929,13138,237,209,27196,0,27196,1.0,5913.35,13028.48,5912.85,13028.05,2461,2460
11572,11920,12932,13390,348,458,84487,4170,80317,0.950643294234616,11783.87,13167.41,11783.2,13166.97,2462,2461
10799,10943,12937,13114,144,177,18403,0,18403,1.0,10868.29,13025.41,10867.8,13024.94,2463,2462
3652,3994,12942,13299,342,357,63108,314,62794,0.9950244026113964,3800.46,13113.81,3800.07,13113.51,2464,2463
4333,4632,12951,13151,299,200,33704,0,33704,1.0,4476.91,13048.83,4476.41,13048.39,2465,2464
6683,6927,12955,13114,244,159,22873,0,22873,1.0,6807.36,13026.53,6806.87,13026.12,2466,2465
8376,8649,12957,13197,273,240,41165,2867,38298,0.9303534556054901,8506.33,13068.28,8506.08,13067.76,2467,2466
4139,4425,12961,13220,286,259,34464,1105,33359,0.9679375580315692,4279.91,13101.89,4279.24,13101.1,2468,2467
6160,6331,12973,13136,171,163,14869,0,14869,1.0,6244.35,13062.3,6243.87,13061.67,2469,2468
7454,7654,12975,13156,200,181,24650,0,24650,1.0,7548.84,13064.06,7548.35,13063.58,2470,2469
5110,5640,12981,13406,530,425,109642,5823,103819,0.9468907900257201,5370.22,13173.62,5369.87,13173.62,2471,2470
4920,5136,12985,13132,216,147,16353,2065,14288,0.8737234758148352,5021.7,13046.99,5021.32,13046.97,2472,2471
12703,13250,12997,13485,547,488,155735,5699,150036,0.9634057854689055,12949.15,13251.98,12948.79,13251.52,2473,2472
14042,14177,13001,13132,135,131,9191,0,9191,1.0,14096.75,13064.93,14096.67,13064.45,2474,2473
9328,9742,13006,13458,414,452,112024,0,112024,1.0,9531.16,13213.89,9530.72,13213.62,2475,2474
3334,3467,13009,13122,133,113,8231,833,7398,0.8987972299842061,3397.35,13069.07,3396.94,13068.5,2476,2475
13457,13702,13012,13253,245,241,37887,1674,36213,0.955815979095732,13569.27,13125.22,13568.83,13124.77,2477,2476
4027,4224,13016,13158,197,142,16928,0,16928,1.0,4134.21,13088.99,4133.42,13088.43,2478,2477
6830,7143,13016,13219,313,203,42305,1675,40630,0.9604065713272663,7009.19,13111.97,7008.45,13111.52,2479,2478
4653,4842,13021,13339,189,318,40045,0,40045,1.0,4754.17,13178.6,4753.55,13178.34,2480,2479
4779,4970,13021,13235,191,214,25984,2079,23905,0.919989224137931,4878.9,13117.2,4878.28,13116.6,2481,2480
8604,8868,13025,13296,264,271,40043,0,40043,1.0,8722.48,13153.7,8722.15,13153.33,2483,2481
13331,13503,13026,13227,172,201,16570,1131,15439,0.931744115872058,13413.27,13146.52,13413.22,13145.29,2482,2482
14824,15314,13026,13444,490,418,109761,0,109761,1.0,15064.03,13242.92,15063.53,13242.37,2484,2483
5986,6176,13038,13179,190,141,18886,421,18465,0.977708355395531,6075.88,13102.2,6075.44,13101.76,2485,2484
5684,5903,13044,13245,219,201,19572,1969,17603,0.8993970978949519,5804.3,13147.8,5803.48,13147.38,2489,2485
7138,7677,13044,13480,539,436,126909,0,126909,1.0,7362.06,13227.3,7362.33,13226.88,2486,2486
7977,8533,13044,13473,556,429,93358,0,93358,1.0,8282.68,13199.35,8281.97,13199.47,2487,2487
8801,9102,13046,13267,301,221,33164,1444,31720,0.9564588107586539,8946.44,13157.23,8946.06,13156.75,2488,2488
6329,6497,13047,13150,168,103,11124,0,11124,1.0,6419.02,13099.61,6418.38,13099.08,2490,2489
6495,6896,13058,13301,401,243,58754,0,58754,1.0,6698.33,13169.05,6697.91,13168.65,2491,2490
4264,4709,13068,13604,445,536,131682,3655,128027,0.9722437387038472,4531.62,13318.46,4531.01,13318.26,2492,2491
3247,3640,13069,13479,393,410,107825,0,107825,1.0,3428.5,13272.48,3428.01,13271.79,2493,2492
9604,10000,13071,13534,396,463,109084,0,109084,1.0,9777.61,13285.31,9777.21,13284.86,2494,2493
6035,6326,13074,13298,291,224,29184,0,29184,1.0,6180.73,13188.84,6180.09,13188.31,2496,2494
3915,4245,13076,13396,330,320,56889,22,56867,0.9996132820053086,4066.43,13232.24,4065.99,13231.74,2495,2495
4700,5172,13085,13535,472,450,101775,1862,99913,0.981704740849914,4965.65,13312.92,4964.85,13312.62,2497,2496
6278,6547,13085,13340,269,255,34533,0,34533,1.0,6413.57,13213.26,6412.92,13212.55,2498,2497
7618,8018,13104,13418,400,314,72844,0,72844,1.0,7813.96,13268.58,7813.34,13267.94,2499,2498
10751,10885,13107,13242,134,135,14323,0,14323,1.0,10825.87,13174.66,10825.29,13174.08,2500,2499
5715,6235,13116,13525,520,409,106029,1519,104510,0.98567373077177,5976.53,13353.04,5975.91,13352.54,2502,2500
13856,14121,13118,13366,265,248,32931,0,32931,1.0,14006.53,13243.18,14005.65,13242.88,2501,2501
2985,3218,13127,13414,233,287,40547,0,40547,1.0,3094.59,13282.18,3094.45,13281.32,2503,2502
3643,3982,13127,13365,339,238,29224,89,29135,0.9969545578976184,3867.74,13267.73,3866.6,13267.22,2504,2503
3173,3271,13136,13339,98,203,13173,0,13173,1.0,3224.75,13226.18,3224.44,13226.13,2505,2504
10560,10774,13143,13310,214,167,22005,510,21495,0.9768234492160872,10686.2,13218.95,10685.46,13218.6,2506,2505
10222,10547,13155,13419,325,264,51615,0,51615,1.0,10367.98,13297.16,10367.67,13296.47,2507,2506
8491,8792,13159,13345,301,186,29640,2060,27580,0.9304993252361673,8629.68,13262.42,8629.33,13261.89,2508,2507
6802,7283,13160,13571,481,411,111932,2431,109501,0.9782814565986492,7039.16,13351.36,7038.74,13351.02,2509,2508
5637,5917,13172,13328,280,156,26515,2059,24456,0.9223458419762398,5778.04,13249.51,5777.35,13248.83,2510,2509
14016,14519,13181,13817,503,636,178414,0,178414,1.0,14235.5,13454.47,14234.84,13454.32,2511,2510
12444,12815,13183,13646,371,463,104330,0,104330,1.0,12627.28,13401.48,12626.77,13401.05,2512,2511
8007,8449,13193,13524,442,331,59163,0,59163,1.0,8224.6,13351.24,8224.37,13350.88,2513,2512
8777,9022,13195,13373,245,178,23989,0,23989,1.0,8890.75,13281.72,8890.59,13281.43,2515,2513
9781,10268,13195,13751,487,556,167959,5564,162395,0.966872867783209,10026.88,13459.36,10026.65,13459.29,2514,2514
11249,11399,13198,13489,150,291,23708,0,23708,1.0,11320.08,13327.77,11319.47,13328.08,2517,2515
13329,13518,13198,13334,189,136,15761,0,15761,1.0,13417.44,13264.04,13417.02,13263.44,2516,2516
13600,13805,13207,13437,205,230,26048,1410,24638,0.9458691646191646,13697.51,13313.8,13697.04,13313.58,2518,2517
8994,9298,13210,13496,304,286,46644,0,46644,1.0,9139.44,13360.19,9139.03,13359.64,2519,2518
4179,4479,13211,13730,300,519,63294,4513,58781,0.9286978228584069,4337.44,13449.84,4336.9,13449.59,2521,2519
11364,11726,13212,13481,362,269,54377,2129,52248,0.9608474171064972,11562.94,13357.35,11562.17,13356.99,2520,2520
5004,5483,13214,13684,479,470,115390,1880,113510,0.9837074269867406,5257.53,13435.85,5256.96,13435.41,2522,2521
6123,6399,13220,13432,276,212,41959,0,41959,1.0,6272.1,13329.5,6271.49,13328.96,2523,2522
10742,10979,13227,13437,237,210,30708,0,30708,1.0,10853.75,13331.86,10853.28,13331.35,2524,2523
6385,6854,13228,13665,469,437,126714,0,126714,1.0,6607.7,13427.06,6607.24,13426.64,2525,2524
13158,13409,13231,13496,251,265,31960,1255,30705,0.9607321652065082,13276.91,13380.08,13276.6,13379.3,2526,2525
14463,14851,13235,13552,388,317,92132,0,92132,1.0,14658.44,13388.97,14657.9,13388.51,2527,2526
9158,9382,13242,13414,224,172,20087,0,20087,1.0,9278.86,13310.74,9278.33,13310.53,2528,2527
13256,13645,13244,13533,389,289,42792,678,42114,0.9841559169938306,13455.47,13388.08,13455.26,13387.86,2529,2528
10423,10863,13247,13933,440,686,216621,0,216621,1.0,10634.68,13594.78,10634.21,13594.57,2530,2529
14810,15050,13255,13579,240,324,39530,0,39530,1.0,14927.96,13445.62,14927.18,13444.69,2531,2530
8386,8636,13259,13472,250,213,30159,0,30159,1.0,8518.34,13387.63,8517.72,13386.92,2532,2531
5495,5743,13263,13439,248,176,23330,565,22765,0.9757822546078011,5627.32,13355.21,5626.6,13354.71,2533,2532
4009,4279,13278,13820,270,542,66565,6887,59678,0.8965372192593706,4154.24,13520.04,4153.98,13520.37,2535,2533
7013,8365,13279,14021,1352,742,514318,0,514318,1.0,7652.33,13642.18,7652.03,13641.85,2534,2534
7950,8143,13282,13499,193,217,25737,0,25737,1.0,8046.58,13394.13,8046.06,13393.6,2536,2535
12276,12639,13283,13671,363,388,67101,0,67101,1.0,12435.56,13515.9,12435.32,13515.18,2537,2536
2945,3453,13296,13756,508,460,118856,707,118149,0.994051625496399,3205.11,13546.41,3204.29,13546.14,2538,2537
4657,4824,13305,13502,167,197,17171,0,17171,1.0,4723.68,13395.99,4723.5,13395.41,2539,2538
8777,9079,13306,13535,302,229,37153,0,37153,1.0,8930.5,13419.7,8929.87,13419.14,2540,2539
11648,11911,13311,13651,263,340,52314,0,52314,1.0,11781.46,13478.79,11780.88,13478.25,2542,2540
3427,4098,13314,13898,671,584,157234,3583,153651,0.977212307770584,3778.05,13597.26,3777.54,13596.91,2541,2541
3664,4168,13316,13845,504,529,81054,1566,79488,0.9806795469686875,3974.23,13536.99,3973.27,13536.41,2543,2542
8578,8904,13319,13626,326,307,42350,0,42350,1.0,8758.2,13460.8,8757.42,13459.97,2544,2543
13697,14069,13321,13667,372,346,65252,0,65252,1.0,13882.7,13486.75,13882.25,13486.37,2545,2544
11903,12100,13346,13536,197,190,24049,0,24049,1.0,11999.58,13446.29,11999.04,13445.59,2546,2545
13619,13855,13352,13566,236,214,23415,0,23415,1.0,13724.99,13441.52,13724.64,13441.16,2547,2546
5573,6293,13360,13892,720,532,178621,1184,177437,0.9933714400882315,5954.83,13638.32,5953.71,13637.5,2548,2547
10786,11058,13362,13786,272,424,68380,0,68380,1.0,10907.18,13571.29,10906.88,13570.69,2549,2548
9232,9671,13381,13710,439,329,89952,0,89952,1.0,9459.71,13543.01,9459.07,13542.43,2550,2549
13485,13638,13383,13533,153,150,13548,0,13548,1.0,13562.48,13452.03,13561.89,13451.74,2551,2550
5440,5664,13384,13596,224,212,22171,1960,20211,0.9115962293085562,5564.3,13477.6,5563.52,13477.07,2552,2551
10088,10488,13385,13833,400,448,100122,996,99126,0.9900521363935998,10308.92,13604.43,10308.52,13603.86,2553,2552
8044,8366,13410,13635,322,225,34307,0,34307,1.0,8194.77,13519.94,8194.65,13519.31,2554,2553
5367,5556,13414,13605,189,191,19724,2769,16955,0.8596126546339485,5462.5,13520.26,5461.89,13519.71,2556,2554
12739,13179,13414,13738,440,324,70326,0,70326,1.0,13001.16,13548.55,13000.1,13548.0,2555,2555
6110,6466,13420,13720,356,300,59068,0,59068,1.0,6305.39,13552.93,6304.61,13552.49,2557,2556
9038,9362,13423,13789,324,366,68095,0,68095,1.0,9207.03,13618.2,9206.45,13617.52,2560,2557
14716,15221,13425,13960,505,535,130808,0,130808,1.0,14986.96,13675.9,14985.85,13674.95,2558,2558
6604,7112,13428,13732,508,304,92212,0,92212,1.0,6865.88,13584.55,6865.12,13584.21,2559,2559
11184,11418,13429,13750,234,321,45181,2160,43021,0.9521922932206016,11317.73,13588.25,11317.07,13587.7,2561,2560
13310,13537,13434,13649,227,215,26163,0,26163,1.0,13420.44,13549.83,13420.11,13549.12,2562,2561
11411,11673,13436,13628,262,192,38882,1726,37156,0.9556092793580577,11533.08,13533.42,11532.68,13532.97,2563,2562
8414,8927,13444,13781,513,337,85026,0,85026,1.0,8654.8,13603.41,8654.67,13603.12,2564,2563
8815,9113,13447,13719,298,272,42875,0,42875,1.0,8972.74,13614.86,8971.61,13613.64,2565,2564
4898,5257,13458,13773,359,315,57917,5014,52903,0.9134278363865531,5059.77,13647.6,5059.45,13647.05,2566,2565
4671,4998,13463,13856,327,393,56835,1222,55613,0.9784991642473828,4821.84,13629.55,4821.28,13629.34,2567,2566
13139,13321,13484,13618,182,134,15051,0,15051,1.0,13218.45,13547.56,13218.11,13547.16,2568,2567
4192,4346,13487,13776,154,289,30298,49,30249,0.9983827315334346,4278.93,13632.69,4278.28,13632.1,2569,2568
4351,4823,13488,14139,472,651,90025,0,90025,1.0,4544.8,13816.11,4545.16,13814.93,2574,2569
8274,8482,13493,13739,208,246,32230,0,32230,1.0,8372.18,13617.03,8371.7,13616.54,2571,2570
13477,13697,13493,13663,220,170,19377,0,19377,1.0,13592.04,13574.71,13591.28,13574.31,2570,2571
13815,14068,13495,13848,253,353,51165,0,51165,1.0,13958.27,13676.2,13957.9,13675.48,2572,2572
12016,12366,13497,13817,350,320,77299,0,77299,1.0,12200.6,13657.72,12199.87,13657.04,2573,2573
14498,14875,13513,13791,377,278,65099,0,65099,1.0,14695.9,13647.85,14695.36,13647.36,2575,2574
3345,3806,13519,13911,461,392,90120,2470,87650,0.9725920994229915,3572.72,13706.91,3572.3,13706.57,2576,2575
10910,11242,13519,13909,332,390,90432,0,90432,1.0,11095.85,13720.46,11095.21,13719.96,2577,2576
9630,9834,13520,13672,204,152,19392,0,19392,1.0,9725.72,13594.87,9725.44,13594.37,2578,2577
5316,5560,13526,13800,244,274,40084,1740,38344,0.9565911585670093,5440.48,13668.57,5439.87,13667.83,2579,2578
11810,12055,13526,13839,245,313,51106,0,51106,1.0,11944.4,13659.75,11943.72,13659.6,2580,2579
14348,14676,13529,14007,328,478,89325,0,89325,1.0,14512.38,13796.08,14511.67,13795.23,2581,2580
4330,4608,13543,13817,278,274,39436,1598,37838,0.9594786489501977,4482.32,13683.03,4481.59,13682.61,2582,2581
11582,11908,13552,13842,326,290,40540,0,40540,1.0,11749.61,13697.18,11749.08,13696.7,2583,2582
12649,13102,13554,13795,453,241,47593,145,47448,0.99695333347341,12857.7,13667.5,12857.94,13667.34,2584,2583
5477,5840,13560,13941,363,381,55640,0,55640,1.0,5647.35,13743.87,5646.94,13743.74,2585,2584
13588,13814,13570,13798,226,228,32898,0,32898,1.0,13691.42,13693.85,13691.03,13693.19,2586,2585
13105,13367,13582,13781,262,199,31118,3593,27525,0.8845362812520084,13237.04,13668.28,13236.52,13667.92,2587,2586
13293,13611,13587,13964,318,377,60465,0,60465,1.0,13452.13,13791.93,13451.75,13791.22,2588,2587
9695,9962,13596,13829,267,233,32152,1609,30543,0.9499564568300572,9820.49,13715.67,9820.09,13715.15,2589,2588
14185,14458,13601,13877,273,276,37545,722,36823,0.9807697429750966,14330.88,13760.64,14330.11,13759.79,2590,2589
13252,13475,13605,13811,223,206,17042,0,17042,1.0,13371.39,13706.26,13370.72,13705.88,2592,2590
11384,11660,13606,13813,276,207,38279,0,38279,1.0,11521.11,13706.04,11520.59,13705.52,2591,2591
5206,5399,13607,13836,193,229,24602,1229,23373,0.9500447118120477,5306.38,13745.66,5305.88,13744.81,2593,2592
6216,6633,13612,13896,417,284,78248,0,78248,1.0,6430.26,13758.71,6429.67,13758.22,2594,2593
14183,14319,13618,13726,136,108,8586,0,8586,1.0,14246.79,13670.26,14246.39,13669.71,2595,2594
12405,12663,13632,13813,258,181,24948,0,24948,1.0,12539.33,13727.05,12538.81,13726.5,2597,2595
9624,9774,13633,13738,150,105,7894,0,7894,1.0,9687.02,13685.03,9687.06,13684.38,2596,2596
12307,12475,13634,13784,168,150,15599,0,15599,1.0,12387.87,13715.86,12387.41,13715.21,2598,2597
2932,3317,13635,13914,385,279,48973,1632,47341,0.9666755150797378,3080.22,13770.2,3080.34,13769.68,2599,2598
8470,8741,13638,13819,271,181,18927,0,18927,1.0,8609.53,13728.84,8608.75,13728.19,2600,2599
9513,9713,13654,13876,200,222,23292,0,23292,1.0,9624.06,13775.66,9623.39,13774.93,2602,2600
4783,4968,13655,14070,185,415,43476,4178,39298,0.9039010028521484,4880.82,13873.44,4880.09,13872.74,2601,2601
6676,6901,13665,13803,225,138,16698,0,16698,1.0,6780.57,13735.57,6780.23,13734.95,2603,2602
9440,9567,13671,13791,127,120,10311,0,10311,1.0,9504.59,13725.25,9504.06,13724.82,2604,2603
12623,13041,13673,13963,418,290,62392,2903,59489,0.9534715989229389,12846.84,13814.57,12845.85,13813.9,2605,2604
11237,11519,13680,13886,282,206,33507,0,33507,1.0,11357.16,13799.42,11357.01,13798.75,2606,2605
6496,7221,13690,14190,725,500,213519,0,213519,1.0,6873.24,13928.78,6872.57,13928.18,2607,2606
8894,9170,13691,13916,276,225,36321,0,36321,1.0,9049.48,13785.84,9048.69,13785.42,2608,2607
8360,8855,13692,14180,495,488,118897,0,118897,1.0,8606.49,13933.79,8605.91,13933.25,2609,2608
13720,14009,13694,14005,289,311,42619,0,42619,1.0,13864.96,13849.73,13864.43,13849.15,2610,2609
9335,9485,13698,13849,150,151,12897,0,12897,1.0,9401.05,13765.1,9400.74,13764.8,2611,2610
12984,13224,13706,13911,240,205,18696,2852,15844,0.847454000855798,13114.94,13785.94,13113.29,13786.48,2612,2611
9954,10348,13710,13931,394,221,44218,0,44218,1.0,10162.29,13810.88,10161.51,13810.26,2613,2612
13924,14429,13710,14159,505,449,121252,2323,118929,0.9808415531290205,14195.7,13956.28,14195.04,13955.6,2614,2613
4948,5206,13713,13941,258,228,31645,0,31645,1.0,5062.16,13817.41,5061.84,13817.26,2615,2614
9804,10239,13713,14150,435,437,90653,0,90653,1.0,10012.96,13949.36,10012.59,13948.79,2616,2615
3339,3653,13719,14018,314,299,33038,0,33038,1.0,3519.94,13862.12,3518.99,13861.27,2617,2616
8675,9063,13731,14021,388,290,63299,0,63299,1.0,8878.88,13881.23,8878.18,13880.6,2618,2617
11538,11882,13734,13978,344,244,47138,1513,45625,0.9679027536170394,11697.35,13858.13,11697.05,13857.61,2619,2618
3255,3599,13737,14057,344,320,43303,969,42334,0.9776227974967092,3415.52,13905.2,3415.18,13904.74,2620,2619
5669,6048,13755,14094,379,339,62605,1160,61445,0.9814711285041131,5849.78,13900.39,5849.64,13900.08,2621,2620
9124,9401,13764,13935,277,171,33074,0,33074,1.0,9255.32,13850.51,9254.85,13850.04,2622,2621
12467,12764,13764,13908,297,144,26003,934,25069,0.9640810675691266,12610.03,13835.07,12609.76,13834.66,2623,2622
11900,12223,13765,13916,323,151,28816,0,28816,1.0,12060.94,13839.7,12060.42,13839.15,2624,2623
2988,3305,13767,14077,317,310,50550,1751,48799,0.9653610286844708,3140.22,13928.32,3139.97,13927.64,2625,2624
12978,13302,13767,14055,324,288,48561,0,48561,1.0,13144.45,13907.34,13143.89,13906.88,2626,2625
4068,4369,13771,13973,301,202,37853,13,37840,0.9996565661902623,4212.59,13871.22,4212.17,13870.75,2627,2626
2856,3005,13772,14094,149,322,30439,0,30439,1.0,2928.86,13944.83,2928.21,13944.27,2632,2627
5130,5290,13772,14028,160,256,23448,1177,22271,0.9498038212214261,5210.35,13890.36,5209.82,13890.15,2630,2628
4703,4850,13773,14014,147,241,19770,2299,17471,0.8837126960040466,4782.79,13874.19,4782.25,13874.05,2628,2629
10297,10593,13773,14006,296,233,33160,0,33160,1.0,10448.24,13903.78,10447.42,13902.93,2629,2630
7836,8453,13774,14140,617,366,126459,0,126459,1.0,8170.82,13931.38,8170.09,13930.87,2631,2631
10835,11033,13774,13935,198,161,18383,0,18383,1.0,10920.22,13863.19,10919.72,13862.39,2633,2632
12220,12470,13780,13964,250,184,29911,1221,28690,0.959178897395607,12341.18,13860.85,12340.61,13860.43,2634,2633
9399,9714,13782,14019,315,237,41726,0,41726,1.0,9557.24,13905.15,9556.64,13904.61,2635,2634
13424,13890,13782,14148,466,366,91561,1434,90127,0.9843383099791396,13646.92,13951.7,13646.5,13951.32,2636,2635
5343,5971,13793,14207,628,414,120213,3036,117177,0.9747448279304235,5595.22,14008.88,5595.56,14008.83,2637,2636
11275,11548,13802,14041,273,239,40350,751,39599,0.9813878562577447,11417.06,13938.9,11416.74,13938.19,2638,2637
9654,9900,13809,14043,246,234,32569,0,32569,1.0,9774.38,13921.07,9773.87,13920.61,2639,2638
4524,4788,13811,14084,264,273,44279,1040,43239,0.9765125680345085,4655.82,13957.38,4655.36,13956.87,2640,2639
12029,12248,13819,14059,219,240,30274,0,30274,1.0,12146.89,13957.7,12146.56,13956.86,2641,2640
5150,5439,13824,14173,289,349,50795,2272,48523,0.9552711881090659,5300.57,14006.28,5299.92,14005.62,2642,2641
3802,4085,13825,14058,283,233,38562,0,38562,1.0,3939.41,13932.68,3938.96,13932.19,2643,2642
7200,7771,13830,14208,571,378,137489,0,137489,1.0,7466.8,14013.28,7466.42,14012.79,2644,2643
3623,3987,13832,14160,364,328,66345,0,66345,1.0,3777.88,14011.47,3777.7,14010.96,2645,2644
12333,12685,13832,14110,352,278,47813,2833,44980,0.9407483320435864,12515.63,13977.71,12515.01,13977.1,2646,2645
5912,6267,13837,14186,355,349,59246,100,59146,0.998312122337373,6081.94,13975.94,6081.25,13975.84,2647,2646
3227,3406,13838,14052,179,214,16163,1334,14829,0.9174658169894203,3303.69,13955.82,3303.59,13955.36,2649,2647
11765,12056,13838,14049,291,211,34906,2164,32742,0.9380049275196242,11905.96,13945.93,11905.66,13945.58,2648,2648
11036,11303,13845,14023,267,178,30310,0,30310,1.0,11183.86,13938.91,11183.21,13938.4,2650,2649
10098,10637,13857,14232,539,375,75130,0,75130,1.0,10387.6,14020.67,10387.25,14020.35,2651,2650
10550,10758,13861,13992,208,131,16982,567,16415,0.9666117065127783,10656.59,13924.78,10655.97,13924.23,2652,2651
6250,6787,13864,14249,537,385,119444,0,119444,1.0,6491.2,14061.27,6490.94,14060.84,2653,2652
12626,12823,13871,14013,197,142,20218,0,20218,1.0,12722.41,13942.45,12721.94,13941.99,2654,2653
9009,9264,13876,14111,255,235,30338,729,29609,0.9759707297778364,9142.01,13998.38,9141.5,13997.88,2656,2654
4891,5198,13877,14127,307,250,48571,3620,44951,0.9254699306170349,5052.9,14009.69,5052.32,14009.15,2655,2655
11523,11707,13880,14049,184,169,16654,1351,15303,0.9188783475441336,11605.87,13977.19,11605.29,13976.41,2657,2656
9211,9531,13884,14110,320,226,46958,232,46726,0.9950594147962009,9382.91,13994.02,9382.32,13993.51,2658,2657
4187,4370,13889,13991,183,102,10733,909,9824,0.9153079288176651,4290.23,13939.76,4289.32,13939.4,2659,2658
8253,8581,13894,14277,328,383,63228,0,63228,1.0,8430.73,14099.06,8430.16,14098.48,2660,2659
10846,11081,13895,14066,235,171,24873,0,24873,1.0,10956.28,13984.76,10955.96,13984.21,2661,2660
12942,13428,13923,14374,486,451,96033,0,96033,1.0,13164.27,14110.84,13163.8,14110.54,2662,2661
6773,7369,13926,14542,596,616,174112,0,174112,1.0,7058.67,14253.04,7058.3,14252.44,2665,2662
10697,10861,13926,14018,164,92,11535,0,11535,1.0,10788.5,13974.78,10787.76,13974.29,2663,2663
12722,13036,13927,14283,314,356,56145,0,56145,1.0,12891.84,14085.44,12890.78,14085.53,2664,2664
12135,12472,13932,14157,337,225,41227,4068,37159,0.9013268003977976,12286.43,14056.81,12286.13,14056.21,2666,2665
7769,8063,13937,14128,294,191,42214,0,42214,1.0,7916.69,14032.78,7916.18,14032.29,2667,2666
4303,4427,13942,14113,124,171,13768,0,13768,1.0,4369.32,14043.13,4368.75,14042.36,2668,2667
5995,6327,13945,14208,332,263,47616,0,47616,1.0,6180.66,14107.34,6180.03,14106.61,2669,2668
3992,4356,13951,14117,364,166,33813,1474,32339,0.9564072989678526,4155.58,14034.78,4155.9,14034.14,2670,2669
11674,11884,13958,14162,210,204,27169,0,27169,1.0,11783.51,14070.66,11782.75,14069.89,2671,2670
13344,13663,13965,14219,319,254,29045,0,29045,1.0,13505.45,14101.72,13504.83,14101.18,2672,2671
4736,5259,13978,14490,523,512,135689,6923,128766,0.9489789150189035,4994.15,14258.31,4993.6,14257.49,2673,2672
10688,10906,13986,14195,218,209,25327,17,25310,0.9993287795633119,10817.17,14097.22,10816.03,14096.3,2674,2673
11437,11615,13986,14152,178,166,18896,1825,17071,0.9034187129551228,11525.93,14071.56,11525.41,14070.99,2675,2674
9788,9979,13987,14165,191,178,17321,0,17321,1.0,9876.86,14060.92,9876.45,14060.85,2676,2675
10585,10777,13987,14200,192,213,23890,1323,22567,0.9446211804102135,10676.0,14108.22,10675.59,14107.56,2677,2676
3379,3699,13991,14491,320,500,72536,1482,71054,0.9795687658541965,3542.67,14230.69,3542.32,14229.85,2678,2677
3070,3274,13994,14266,204,272,35757,0,35757,1.0,3185.06,14140.76,3184.38,14140.25,2679,2678
10899,11286,13995,14223,387,228,46050,0,46050,1.0,11072.64,14089.81,11072.3,14089.36,2680,2679
11878,12156,13996,14178,278,182,30132,0,30132,1.0,11996.77,14081.93,11996.8,14081.6,2681,2680
12478,12813,14001,14282,335,281,57003,0,57003,1.0,12666.37,14139.36,12665.7,14139.19,2682,2681
9514,9837,14002,14217,323,215,42494,0,42494,1.0,9693.33,14093.67,9692.7,14093.26,2683,2682
3241,3572,14003,14461,331,458,79040,676,78364,0.9914473684210526,3369.72,14251.44,3369.39,14250.99,2684,2683
13661,14057,14005,14527,396,522,126192,96,126096,0.99923925446938,13859.02,14262.98,13858.55,14262.51,2685,2684
8684,9229,14007,14333,545,326,88374,101,88273,0.9988571299250911,8983.54,14139.62,8982.84,14139.38,2687,2685
13926,14258,14007,14267,332,260,44481,0,44481,1.0,14080.57,14139.0,14080.24,14138.47,2686,2686
3561,3683,14016,14172,122,156,10818,0,10818,1.0,3620.16,14093.5,3619.72,14093.03,2688,2687
11595,11724,14021,14177,129,156,12905,0,12905,1.0,11666.91,14100.25,11666.34,14099.77,2689,2688
11260,11529,14026,14350,269,324,51093,0,51093,1.0,11402.08,14171.26,11401.53,14170.88,2690,2689
4449,4679,14028,14221,230,193,23435,0,23435,1.0,4555.1,14117.13,4554.68,14116.7,2691,2690
2931,3093,14030,14227,162,197,23595,0,23595,1.0,3017.14,14130.35,3016.58,14129.81,2692,2691
9212,9426,14042,14241,214,199,29851,799,29052,0.9732337275133162,9323.97,14144.58,9323.38,14144.01,2693,2692
7696,8106,14053,14603,410,550,143215,0,143215,1.0,7883.94,14342.54,7883.53,14341.91,2694,2693
3906,4076,14057,14313,170,256,26125,317,25808,0.987866028708134,3989.54,14184.68,3989.09,14184.2,2695,2694
4037,4337,14058,14259,300,201,34122,4442,29680,0.8698200574409471,4209.65,14150.79,4208.78,14150.33,2696,2695
10231,10534,14059,14244,303,185,38854,0,38854,1.0,10376.37,14151.58,10375.92,14151.05,2697,2696
4661,4835,14065,14371,174,306,31715,318,31397,0.9899731988018288,4751.08,14194.76,4750.55,14194.66,2698,2697
12272,12535,14067,14251,263,184,29608,917,28691,0.9690286409078628,12401.85,14158.94,12401.36,14158.42,2699,2698
7979,8426,14069,14366,447,297,52137,0,52137,1.0,8210.26,14204.12,8209.76,14203.72,2700,2699
2813,2946,14080,14231,133,151,15221,0,15221,1.0,2881.47,14153.8,2880.96,14153.34,2702,2700
9412,9779,14080,14338,367,258,58472,0,58472,1.0,9587.39,14214.11,9586.89,14213.63,2701,2701
4443,4741,14089,14437,298,348,62050,3414,58636,0.9449798549556809,4599.51,14296.5,4599.05,14295.54,2703,2702
5075,5567,14095,14473,492,378,98034,3214,94820,0.9672154558622519,5372.14,14273.9,5370.77,14273.79,2704,2703
5700,5948,14096,14300,248,204,31865,435,31430,0.9863486584026361,5809.04,14185.65,5808.62,14185.3,2705,2704
6299,6528,14097,14331,229,234,18931,0,18931,1.0,6412.35,14230.18,6411.48,14229.16,2708,2705
7474,7754,14097,14509,280,412,73094,0,73094,1.0,7621.8,14297.77,7621.24,14297.37,2707,2706
9816,10215,14097,14364,399,267,45588,0,45588,1.0,10017.08,14223.11,10016.65,14222.78,2706,2707
13057,13576,14102,14491,519,389,130604,0,130604,1.0,13325.36,14301.45,13324.84,14301.08,2709,2708
4282,4465,14107,14320,183,213,27744,0,27744,1.0,4383.61,14213.66,4383.01,14213.22,2710,2709
10975,11327,14107,14338,352,231,50960,1976,48984,0.9612244897959183,11168.5,14211.39,11167.72,14211.06,2711,2710
11978,12181,14115,14305,203,190,24924,0,24924,1.0,12079.31,14201.31,12078.81,14200.83,2712,2711
3662,3885,14118,14233,223,115,13170,0,13170,1.0,3750.91,14167.64,3751.11,14167.16,2713,2712
11513,11715,14121,14263,202,142,16469,1664,14805,0.8989616855911106,11599.94,14194.26,11599.82,14193.63,2714,2713
7978,8326,14124,14490,348,366,46960,0,46960,1.0,8149.8,14337.52,8148.79,14336.22,2736,2714
10076,10290,14130,14282,214,152,22030,0,22030,1.0,10181.08,14199.78,10180.64,14199.34,2715,2715
5947,6426,14140,14475,479,335,99976,240,99736,0.9975994238617268,6168.02,14310.53,6167.86,14309.78,2717,2716
14220,14387,14142,14286,167,144,15903,1077,14826,0.9322769288813432,14298.01,14213.33,14297.64,14212.83,2716,2717
11650,12015,14145,14376,365,231,54488,0,54488,1.0,11828.88,14247.25,11828.4,14246.84,2718,2718
12118,12299,14145,14319,181,174,20177,0,20177,1.0,12210.18,14236.47,12209.55,14235.83,2719,2719
3870,4002,14150,14357,132,207,10692,714,9978,0.9332210998877666,3926.53,14277.99,3925.97,14276.74,2720,2720
3609,3769,14158,14438,160,280,21532,19,21513,0.9991175924205833,3693.89,14286.07,3693.38,14285.75,2721,2721
3740,3893,14159,14339,153,180,15439,0,15439,1.0,3818.54,14243.98,3817.96,14243.6,2722,2722
8465,9132,14166,14573,667,407,183405,0,183405,1.0,8813.55,14367.64,8812.96,14367.14,2723,2723
10546,10866,14168,14365,320,197,46888,0,46888,1.0,10713.93,14269.71,10713.38,14269.02,2724,2724
13494,13738,14169,14454,244,285,51231,0,51231,1.0,13619.72,14326.05,13619.22,14325.43,2725,2725
7273,7545,14170,14516,272,346,62032,549,61483,0.9911497291720403,7408.22,14355.17,7407.76,14354.52,2726,2726
10845,11024,14174,14355,179,181,23687,0,23687,1.0,10926.95,14271.17,10926.53,14270.59,2727,2727
4001,4253,14182,14405,252,223,37306,2037,35269,0.9453975231866187,4132.58,14301.74,4132.02,14301.17,2728,2728
9059,9519,14182,14615,460,433,120848,0,120848,1.0,9283.15,14393.26,9282.79,14392.87,2729,2729
5550,5716,14184,14326,166,142,17815,286,17529,0.98394611282627,5629.97,14255.06,5629.65,14254.44,2730,2730
9762,10098,14190,14411,336,221,41072,0,41072,1.0,9918.13,14312.32,9917.72,14311.77,2731,2731
12672,13057,14192,14521,385,329,65604,0,65604,1.0,12842.48,14350.73,12842.22,14350.28,2732,2732
2896,3046,14195,14411,150,216,25243,0,25243,1.0,2970.26,14303.09,2969.76,14302.61,2733,2733
11954,12890,14205,15184,936,979,593237,575,592662,0.9990307415080314,12434.78,14715.6,12434.17,14715.17,2734,2734
6474,6811,14208,14466,337,258,64318,0,64318,1.0,6653.19,14339.67,6652.6,14339.15,2735,2735
8375,8677,14211,14618,302,407,51373,0,51373,1.0,8504.21,14445.21,8503.77,14444.04,2739,2736
3013,3401,14212,14521,388,309,48618,364,48254,0.9925130610062117,3169.98,14350.95,3170.09,14350.91,2737,2737
5493,5949,14213,14539,456,326,58107,2788,55319,0.9520195501402585,5674.85,14376.47,5675.19,14375.55,2738,2738
10415,10610,14216,14477,195,261,36248,0,36248,1.0,10512.33,14349.03,10511.66,14348.49,2740,2739
10213,10457,14220,14405,244,185,29199,0,29199,1.0,10344.25,14311.58,10343.64,14311.1,2741,2740
12565,12721,14237,14341,156,104,11203,0,11203,1.0,12639.33,14286.01,12638.96,14285.56,2742,2741
11490,11772,14243,14427,282,184,22700,0,22700,1.0,11631.76,14321.06,11631.41,14320.79,2743,2742
5635,5953,14246,14652,318,406,52277,747,51530,0.9857107332096333,5784.73,14491.52,5784.69,14490.02,2744,2743
11149,11435,14246,14492,286,246,47120,0,47120,1.0,11300.58,14375.5,11300.14,14374.96,2745,2744
4178,4449,14248,14451,271,203,21699,529,21170,0.9756209963592792,4285.76,14354.74,4285.93,14354.2,2746,2745
9425,9648,14261,14516,223,255,38343,0,38343,1.0,9537.74,14391.38,9537.13,14390.85,2747,2746
11780,12112,14273,14613,332,340,57338,0,57338,1.0,11967.71,14411.32,11966.93,14411.11,2748,2747
11003,11155,14280,14409,152,129,12759,0,12759,1.0,11084.77,14339.94,11084.16,14339.52,2749,2748
5824,6278,14283,14723,454,440,106728,1366,105362,0.9872011093621168,6034.6,14533.84,6034.06,14533.08,2751,2749
3735,3945,14284,14455,210,171,22452,792,21660,0.9647247461250668,3834.33,14373.71,3833.92,14373.17,2750,2750
9637,9835,14307,14482,198,175,21386,0,21386,1.0,9718.51,14390.95,9718.25,14390.49,2752,2751
6252,6632,14313,14873,380,560,121067,0,121067,1.0,6426.69,14604.04,6426.28,14603.79,2753,2752
11423,11693,14315,14551,270,236,48337,0,48337,1.0,11547.99,14436.95,11547.59,14436.41,2754,2753
10070,10444,14319,14557,374,238,47592,0,47592,1.0,10265.5,14432.54,10264.94,14432.07,2755,2754
4302,4549,14322,14520,247,198,32488,831,31657,0.9744213247968481,4422.28,14428.36,4421.82,14427.82,2757,2755
3780,4161,14323,14827,381,504,121605,142,121463,0.9988322848567082,3970.67,14567.67,3970.17,14567.22,2756,2756
8168,8512,14332,14705,344,373,68522,0,68522,1.0,8336.47,14532.09,8336.06,14531.51,2758,2757
10582,11102,14337,14812,520,475,160378,0,160378,1.0,10870.02,14542.92,10869.39,14542.56,2759,2758
2804,2976,14357,14573,172,216,22491,0,22491,1.0,2901.78,14452.07,2901.16,14451.7,2760,2759
9711,10320,14357,14696,609,339,91232,0,91232,1.0,10027.03,14514.2,10026.41,14513.73,2761,2760
2957,3115,14370,14514,158,144,13478,349,13129,0.9741059504377504,3035.04,14441.43,3034.45,14440.84,2762,2761
11638,11956,14376,14677,318,301,50981,2440,48541,0.9521390321884624,11792.78,14531.57,11792.38,14531.13,2763,2762
12760,13177,14377,14723,417,346,103283,0,103283,1.0,12969.72,14554.22,12969.22,14553.68,2764,2763
7138,7337,14382,14572,199,190,26112,887,25225,0.966030943627451,7244.2,14474.14,7243.63,14473.6,2765,2764
11029,11455,14385,14798,426,413,94977,0,94977,1.0,11212.67,14588.88,11212.12,14588.34,2766,2765
6879,7175,14386,14598,296,212,37308,0,37308,1.0,7049.86,14491.62,7049.06,14491.27,2767,2766
4659,4992,14388,14878,333,490,86812,1175,85637,0.9864650048380408,4846.75,14583.15,4846.4,14583.13,2768,2767
5173,5549,14389,14693,376,304,69029,0,69029,1.0,5381.83,14527.35,5381.01,14526.88,2769,2768
4970,5270,14394,14688,300,294,46031,1699,44332,0.9630900914601029,5133.99,14539.01,5133.6,14538.62,2771,2769
13508,13904,14394,14823,396,429,86310,0,86310,1.0,13711.54,14598.11,13710.84,14597.61,2770,2770
4108,4217,14397,14526,109,129,9957,0,9957,1.0,4165.03,14457.72,4164.46,14457.25,2772,2771
6523,6863,14406,14830,340,424,102229,0,102229,1.0,6699.52,14616.16,6699.09,14615.66,2773,2772
13837,14119,14410,14708,282,298,44647,960,43687,0.9784979953860282,13976.93,14572.23,13976.72,14571.55,2774,2773
3202,3638,14425,14857,436,432,95663,697,94966,0.9927140064601779,3422.88,14618.67,3422.08,14618.58,2775,2774
3211,3444,14426,14587,233,161,18861,0,18861,1.0,3296.71,14496.66,3297.21,14495.92,2776,2775
4524,4667,14432,14599,143,167,17822,117,17705,0.9934350802379082,4599.36,14505.42,4598.85,14505.04,2777,2776
3616,3783,14434,14655,167,221,24518,318,24200,0.987029937189004,3717.4,14537.19,3716.73,14536.79,2778,2777
4217,4325,14435,14532,108,97,8135,0,8135,1.0,4264.76,14484.15,4264.39,14483.64,2779,2778
8019,8237,14440,14651,218,211,26677,0,26677,1.0,8124.4,14555.0,8123.96,14554.43,2780,2779
2905,3243,14444,14942,338,498,95384,2588,92796,0.9728675668875283,3087.36,14687.49,3086.96,14687.09,2781,2780
13285,13646,14445,14833,361,388,72570,0,72570,1.0,13471.06,14677.4,13470.45,14676.51,2782,2781
13165,13486,14450,14655,321,205,42039,0,42039,1.0,13330.14,14545.21,13329.69,14544.58,2783,2782
7551,7754,14460,14607,203,147,13744,0,13744,1.0,7667.22,14519.65,7666.47,14519.32,2784,2783
10368,10749,14467,14692,381,225,54084,0,54084,1.0,10571.65,14573.85,10571.0,14573.36,2785,2784
4455,4602,14474,14685,147,211,17330,0,17330,1.0,4521.06,14596.66,4520.52,14595.96,2786,2785
3151,3276,14480,14661,125,181,11161,777,10384,0.9303825822058955,3210.66,14568.67,3210.28,14568.24,2787,2786
7297,7530,14481,14628,233,147,25845,0,25845,1.0,7414.31,14560.39,7413.78,14559.82,2788,2787
9365,10242,14481,15007,877,526,298628,0,298628,1.0,9821.18,14743.69,9820.61,14743.18,2789,2788
8381,9125,14485,14905,744,420,181396,0,181396,1.0,8769.25,14693.94,8768.35,14693.54,2790,2789
4218,4374,14497,14663,156,166,13503,0,13503,1.0,4281.88,14579.12,4281.6,14578.28,2791,2790
4942,5066,14498,14744,124,246,15438,0,15438,1.0,4999.92,14627.23,4999.31,14626.46,2792,2791
4307,4485,14502,14657,178,155,15173,0,15173,1.0,4394.4,14576.22,4393.95,14575.76,2793,2792
7522,7713,14505,14807,191,302,44590,0,44590,1.0,7612.08,14666.84,7611.55,14666.24,2795,2793
5535,5660,14506,14672,125,166,12692,0,12692,1.0,5598.35,14578.15,5597.89,14577.86,2794,2794
4141,4236,14512,14674,95,162,10752,0,10752,1.0,4187.3,14592.03,4186.83,14591.62,2796,2795
4560,4900,14519,14945,340,426,78272,3496,74776,0.955335241210139,4725.87,14749.21,4725.4,14748.59,2798,2796
7103,7548,14522,14910,445,388,108807,0,108807,1.0,7318.65,14723.79,7318.07,14723.16,2797,2797
3536,3721,14536,14745,185,209,24804,684,24120,0.9724238026124818,3633.43,14660.18,3632.81,14659.43,2799,2798
7697,7985,14538,14782,288,244,52138,0,52138,1.0,7835.52,14665.84,7835.06,14665.31,2801,2799
11259,11812,14538,14936,553,398,133266,0,133266,1.0,11540.88,14724.43,11540.34,14723.94,2800,2800
6826,7126,14540,14792,300,252,56512,29,56483,0.9994868346545867,6980.78,14671.71,6980.21,14671.26,2802,2801
9125,9368,14542,14707,243,165,29635,0,29635,1.0,9249.56,14624.21,9249.0,14623.69,2803,2802
10156,10920,14543,15796,764,1253,540851,0,540851,1.0,10498.74,15116.32,10498.34,15116.17,2804,2803
7952,8289,14556,14974,337,418,95222,1327,93895,0.986064144840478,8099.21,14780.0,8098.82,14779.07,2805,2804
8903,9382,14561,15489,479,928,251527,0,251527,1.0,9127.17,15090.99,9126.86,15089.82,2806,2805
4357,4488,14594,14722,131,128,9194,0,9194,1.0,4422.88,14661.82,4422.46,14661.15,2807,2806
5450,5606,14602,14790,156,188,16214,0,16214,1.0,5525.63,14701.62,5525.15,14701.03,2808,2807
5592,5854,14608,14804,262,196,30636,0,30636,1.0,5722.12,14704.06,5721.6,14703.39,2809,2808
4969,5147,14620,14843,178,223,17407,0,17407,1.0,5055.69,14720.12,5054.99,14720.0,2810,2809
11632,12146,14620,15027,514,407,145019,0,145019,1.0,11911.62,14831.96,11910.98,14831.46,2811,2810
5744,6000,14625,14820,256,195,27640,0,27640,1.0,5888.31,14741.45,5887.51,14740.92,2812,2811
5974,6333,14627,14940,359,313,64227,0,64227,1.0,6157.99,14766.14,6157.35,14765.84,2813,2812
5215,5482,14628,14803,267,175,28333,0,28333,1.0,5345.06,14716.07,5344.79,14715.51,2814,2813
4226,4402,14631,14803,176,172,19624,0,19624,1.0,4301.79,14718.73,4301.46,14718.15,2815,2814
5005,5273,14635,14830,268,195,14929,0,14929,1.0,5171.47,14721.99,5168.85,14722.65,2816,2815
3715,3923,14638,14817,208,179,21060,0,21060,1.0,3808.84,14732.79,3808.53,14732.35,2817,2816
4103,4234,14659,14827,131,168,15623,0,15623,1.0,4171.23,14736.51,4170.65,14736.13,2818,2817
8220,8478,14666,15065,258,399,60287,0,60287,1.0,8334.28,14858.63,8333.88,14858.33,2819,2818
4427,4573,14667,14806,146,139,13896,0,13896,1.0,4502.32,14739.23,4502.0,14738.55,2820,2819
3207,3592,14697,15103,385,406,96073,974,95099,0.9898618758652274,3412.53,14906.04,3412.18,14905.27,2821,2820
5486,5725,14704,14901,239,197,27664,1402,26262,0.9493204164256795,5598.48,14819.9,5598.05,14819.24,2822,2821
3932,4126,14719,14903,194,184,21696,0,21696,1.0,4037.66,14818.06,4037.14,14817.48,2824,2822
9312,9633,14719,15261,321,542,98741,0,98741,1.0,9474.24,15008.64,9473.61,15008.29,2823,2823
4314,4468,14720,14840,154,120,9486,0,9486,1.0,4398.96,14781.96,4398.22,14781.56,2825,2824
3562,3953,14727,15032,391,305,80755,1012,79743,0.9874682682186862,3734.26,14884.26,3733.82,14883.61,2827,2825
11034,11447,14729,15105,413,376,116307,0,116307,1.0,11225.91,14923.76,11225.47,14923.22,2826,2826
5018,5309,14731,14932,291,201,23407,1705,21702,0.927158542316401,5190.0,14825.86,5188.39,14825.18,2828,2827
5217,5498,14736,14971,281,235,37095,701,36394,0.981102574470953,5368.85,14869.0,5368.27,14868.32,2829,2828
7490,7979,14743,15044,489,301,92518,1111,91407,0.9879915259733241,7757.62,14889.93,7756.92,14889.4,2830,2829
4049,4781,14763,15197,732,434,187442,0,187442,1.0,4411.65,14974.6,4411.07,14973.96,2831,2830
13187,13451,14763,14971,264,208,32044,0,32044,1.0,13309.89,14885.35,13309.53,14884.59,2832,2831
6741,7163,14767,15084,422,317,89462,756,88706,0.9915494846974134,6939.51,14898.35,6939.01,14897.97,2833,2832
8457,8854,14769,15021,397,252,54267,0,54267,1.0,8656.73,14889.51,8656.28,14889.07,2834,2833
2678,2989,14771,15092,311,321,64431,0,64431,1.0,2826.59,14924.67,2826.11,14924.24,2835,2834
6074,6817,14771,15309,743,538,245427,0,245427,1.0,6452.96,15024.63,6452.44,15024.18,2836,2835
10838,11050,14774,15004,212,230,38591,0,38591,1.0,10949.94,14881.53,10949.39,14881.09,2837,2836
4066,4248,14775,14912,182,137,13204,0,13204,1.0,4166.81,14853.1,4166.2,14852.5,2838,2837
5627,6025,14776,15390,398,614,152536,0,152536,1.0,5840.88,15049.82,5840.53,15049.29,2839,2838
4853,5863,14799,15758,1010,959,386700,4513,382187,0.988329454357383,5435.85,15207.34,5435.17,15207.09,2840,2839
2833,3414,14811,15312,581,501,125801,2686,123115,0.978648818371873,3124.86,15058.39,3124.22,15057.82,2841,2840
7142,7364,14813,15058,222,245,32823,0,32823,1.0,7255.09,14935.18,7254.37,14934.58,2842,2841
8712,9020,14831,15083,308,252,43598,0,43598,1.0,8854.67,14958.27,8854.38,14957.51,2843,2842
7307,7685,14855,15105,378,250,56406,0,56406,1.0,7498.0,14993.89,7497.45,14993.42,2844,2843
9210,9399,14856,15215,189,359,38879,0,38879,1.0,9306.29,15036.52,9305.93,15036.24,2845,2844
5965,6091,14861,15040,126,179,14159,0,14159,1.0,6033.72,14946.76,6033.14,14946.28,2846,2845
3863,4097,14870,15104,234,234,32250,0,32250,1.0,3987.27,14991.44,3986.71,14990.95,2848,2846
9569,9984,14870,15222,415,352,91778,0,91778,1.0,9743.28,15058.61,9742.92,15057.9,2847,2847
8063,8301,14905,15245,238,340,32806,0,32806,1.0,8198.98,15049.62,8197.63,15050.34,2849,2848
11350,11817,14913,15232,467,319,93479,0,93479,1.0,11582.97,15067.7,11582.45,15067.16,2850,2849
4561,4963,14918,15457,402,539,104068,649,103419,0.9937636929699811,4778.8,15183.86,4778.33,15183.21,2851,2850
7832,8151,14939,15242,319,303,55897,13,55884,0.9997674293790364,8006.14,15075.16,8005.64,15074.81,2852,2851
8352,8715,14941,15212,363,271,54674,0,54674,1.0,8552.23,15068.15,8551.57,15067.63,2853,2852
3388,3794,14943,15239,406,296,53723,0,53723,1.0,3589.48,15106.45,3589.05,15105.63,2855,2853
6850,7379,14960,15321,529,361,115904,0,115904,1.0,7137.53,15135.14,7136.9,15134.66,2854,2854
10792,11089,14963,15236,297,273,46542,0,46542,1.0,10937.23,15093.9,10936.76,15093.3,2856,2855
11903,12254,14966,15292,351,326,54896,0,54896,1.0,12066.49,15132.46,12066.12,15131.81,2857,2856
10669,10831,14976,15098,162,122,14198,0,14198,1.0,10753.06,15036.17,10752.51,15035.67,2858,2857
2384,2785,14982,15399,401,417,100123,0,100123,1.0,2577.0,15181.2,2576.49,15180.77,2859,2858
9847,10280,14985,15307,433,322,88425,0,88425,1.0,10062.63,15132.61,10062.05,15132.24,2860,2859
5988,6271,15000,15296,283,296,44681,0,44681,1.0,6109.26,15157.8,6108.77,15157.17,2861,2860
7633,7899,15002,15162,266,160,24069,0,24069,1.0,7756.73,15098.2,7756.41,15097.38,2862,2861
3848,4119,15007,15400,271,393,59239,1270,57969,0.978561420685697,3984.8,15203.82,3984.25,15203.24,2863,2862
3571,4133,15014,15620,562,606,179616,0,179616,1.0,3810.18,15368.62,3810.09,15368.21,2864,2863
8686,8941,15023,15295,255,272,40248,0,40248,1.0,8823.03,15159.29,8822.34,15158.75,2865,2864
11703,11978,15026,15328,275,302,59078,0,59078,1.0,11852.78,15181.16,11852.22,15180.63,2866,2865
10974,11226,15034,15405,252,371,49736,0,49736,1.0,11102.97,15241.98,11102.39,15240.93,2868,2866
8223,8638,15037,15339,415,302,63851,0,63851,1.0,8443.91,15202.33,8443.12,15201.69,2867,2867
6618,6907,15049,15398,289,349,55835,0,55835,1.0,6758.69,15209.49,6758.09,15209.21,2869,2868
7301,8063,15058,15468,762,410,160884,0,160884,1.0,7632.36,15247.79,7632.12,15247.25,2870,2869
11143,11460,15060,15341,317,281,54037,0,54037,1.0,11317.8,15196.95,11317.11,15196.4,2871,2870
4861,5032,15073,15244,171,171,17687,0,17687,1.0,4937.72,15161.3,4937.37,15160.77,2872,2871
4091,4280,15082,15225,189,143,17042,0,17042,1.0,4189.99,15149.12,4189.45,15148.61,2873,2872
2726,3083,15084,15329,357,245,54371,0,54371,1.0,2891.0,15210.08,2890.63,15209.57,2874,2873
4081,4435,15096,15536,354,440,56524,0,56524,1.0,4263.62,15329.17,4262.73,15328.19,2875,2874
12253,12771,15111,15397,518,286,91667,412,91255,0.9955054708891967,12510.51,15240.26,12510.07,15239.66,2876,2875
4525,4736,15120,15539,211,419,51249,545,50704,0.9893656461589494,4619.27,15335.07,4618.75,15334.58,2877,2876
4285,4568,15123,15449,283,326,53763,655,53108,0.9878169000985808,4448.24,15284.01,4447.48,15283.37,2878,2877
2389,3718,15136,16080,1329,944,681553,0,681553,1.0,3163.98,15602.72,3162.97,15601.99,2879,2878
8085,8421,15148,15365,336,217,41357,0,41357,1.0,8249.15,15260.37,8248.78,15259.98,2880,2879
5125,5458,15159,15521,333,362,75221,0,75221,1.0,5299.54,15319.88,5299.01,15319.55,2881,2880
10116,10334,15166,15323,218,157,18050,0,18050,1.0,10219.55,15263.51,10219.3,15262.7,2882,2881
8630,8999,15170,15475,369,305,52884,0,52884,1.0,8797.22,15327.08,8796.97,15326.68,2883,2882
4362,5673,15179,16415,1311,1236,844544,47,844497,0.9999443486662625,5052.89,15882.27,5052.32,15881.37,2884,2883
12128,12376,15179,15446,248,267,45702,2538,43164,0.944466325324931,12232.38,15321.16,12231.98,15320.68,2885,2884
11421,11614,15183,15368,193,185,23693,0,23693,1.0,11519.75,15285.2,11519.13,15284.59,2886,2885
9308,9581,15196,15390,273,194,36211,0,36211,1.0,9442.88,15286.37,9442.6,15285.99,2887,2886
2960,3188,15200,15365,228,165,24168,0,24168,1.0,3087.25,15290.0,3086.56,15289.49,2888,2887
9566,10023,15207,15574,457,367,115960,0,115960,1.0,9792.97,15378.72,9792.5,15378.28,2889,2888
11580,11806,15208,15360,226,152,21326,0,21326,1.0,11688.18,15291.34,11687.58,15290.77,2890,2889
6067,6476,15226,15620,409,394,98217,0,98217,1.0,6274.5,15416.01,6274.0,15415.54,2891,2890
11928,12145,15229,15475,217,246,35678,0,35678,1.0,12039.88,15360.71,12039.24,15360.02,2894,2891
5825,6135,15231,15609,310,378,70771,0,70771,1.0,5991.18,15431.53,5990.59,15431.04,2892,2892
10794,11066,15231,15483,272,252,39059,0,39059,1.0,10932.52,15351.81,10932.03,15351.43,2893,2893
6361,6538,15243,15434,177,191,20351,0,20351,1.0,6448.67,15326.49,6448.19,15326.14,2895,2894
9967,10321,15248,15599,354,351,84857,0,84857,1.0,10138.65,15431.05,10138.12,15430.38,2896,2895
6461,6656,15260,15474,195,214,26199,0,26199,1.0,6564.64,15385.64,6563.99,15384.64,2897,2896
11147,11318,15281,15518,171,237,24048,0,24048,1.0,11236.01,15398.56,11235.48,15398.03,2898,2897
4052,4278,15283,15591,226,308,40200,0,40200,1.0,4154.88,15440.41,4154.35,15439.87,2899,2898
11231,11496,15299,15553,265,254,40692,0,40692,1.0,11379.07,15438.09,11378.47,15437.72,2900,2899
8455,8877,15312,15642,422,330,78520,0,78520,1.0,8673.14,15473.29,8672.47,15472.61,2901,2900
8325,8564,15327,15541,239,214,22328,0,22328,1.0,8466.07,15419.63,8465.33,15419.22,2902,2901
9275,9637,15329,15564,362,235,47588,0,47588,1.0,9443.32,15436.0,9443.12,15435.65,2903,2902
11595,11826,15346,15507,231,161,28703,680,28023,0.9763090966101104,11710.26,15421.57,11709.7,15421.04,2904,2903
11475,11608,15355,15534,133,179,19265,0,19265,1.0,11540.11,15440.22,11539.52,15439.68,2905,2904
10940,11176,15380,15573,236,193,26823,0,26823,1.0,11059.22,15471.47,11058.53,15471.14,2906,2905
10528,10961,15397,15729,433,332,106118,0,106118,1.0,10756.29,15568.71,10755.77,15568.18,2907,2906
4771,4962,15411,15703,191,292,39005,0,39005,1.0,4868.31,15554.23,4867.88,15553.79,2908,2907
4379,4567,15431,15614,188,183,17104,0,17104,1.0,4463.27,15506.0,4462.81,15505.73,2909,2908
6045,6697,15458,15792,652,334,122096,0,122096,1.0,6413.89,15635.41,6412.76,15634.67,2910,2909
4417,4632,15464,15659,215,195,17771,0,17771,1.0,4527.9,15562.97,4527.14,15562.59,2911,2910
5342,5602,15471,15857,260,386,59534,0,59534,1.0,5471.47,15657.76,5470.92,15657.27,2912,2911
4108,4421,15484,15788,313,304,60648,0,60648,1.0,4281.69,15633.88,4281.03,15633.45,2913,2912
10939,11229,15490,15671,290,181,29928,0,29928,1.0,11078.71,15583.89,11078.37,15583.29,2914,2913
11148,11520,15505,15657,372,152,34316,0,34316,1.0,11345.4,15590.8,11344.42,15590.08,2916,2914
9849,10183,15506,15739,334,233,51248,0,51248,1.0,10011.3,15645.74,10010.97,15644.86,2915,2915
3749,3957,15524,15668,208,144,19737,0,19737,1.0,3859.97,15599.09,3859.34,15598.58,2917,2916
5700,6059,15553,15844,359,291,70359,2055,68304,0.9707926491280433,5889.2,15686.4,5888.6,15685.99,2918,2917
2450,2885,15557,15950,435,393,115068,0,115068,1.0,2664.12,15742.75,2663.56,15742.27,2919,2918
3580,4392,15588,16270,812,682,293648,3691,289957,0.9874305290688171,3953.34,15961.95,3953.04,15961.29,2920,2919
6014,6284,15604,15816,270,212,21568,0,21568,1.0,6144.74,15723.05,6143.87,15722.53,2921,2920
10436,10641,15609,15751,205,142,15183,0,15183,1.0,10530.24,15695.91,10529.95,15695.26,2922,2921
3902,4242,15617,15943,340,326,73866,0,73866,1.0,4057.02,15764.23,4056.59,15763.82,2923,2922
9575,9798,15712,15972,223,260,33749,0,33749,1.0,9690.96,15836.96,9690.46,15836.52,2924,2923
5850,6213,15733,16092,363,359,88094,0,88094,1.0,6026.22,15919.72,6025.7,15919.09,2925,2924
5500,5922,15735,16135,422,400,104904,0,104904,1.0,5711.6,15938.83,5711.03,15938.35,2926,2925
4233,4479,15862,16288,246,426,65080,0,65080,1.0,4368.89,16105.43,4368.35,16104.57,2927,2926
4458,4805,15900,16309,347,409,85341,0,85341,1.0,4601.48,16150.6,4601.04,16149.82,2928,2927
6102,6305,15912,16167,203,255,31712,0,31712,1.0,6214.86,16054.89,6214.24,16054.16,2929,2928
6290,6480,15977,16164,190,187,24928,0,24928,1.0,6373.82,16072.51,6373.53,16072.09,2930,2929
5803,6082,16070,16269,279,199,38924,0,38924,1.0,5956.66,16167.16,5956.01,16166.61,2931,2930
6067,6198,16087,16195,131,108,9291,0,9291,1.0,6118.67,16144.73,6118.51,16144.23,2932,2931
3675,3922,16116,16315,247,199,30285,0,30285,1.0,3790.74,16214.04,3790.38,16213.59,2933,2932
3828,4249,16197,16436,421,239,61860,0,61860,1.0,4051.3,16319.91,4050.78,16319.31,2934,2933
4085,4567,16241,16650,482,409,127384,0,127384,1.0,4338.51,16440.7,4337.88,16440.3,2935,2934
5199,5496,16267,16456,297,189,27989,0,27989,1.0,5336.04,16367.01,5335.8,16366.57,2936,2935
4615,5000,16273,16629,385,356,77705,0,77705,1.0,4838.99,16444.68,4838.23,16444.19,2937,2936
4535,4701,16301,16449,166,148,15612,0,15612,1.0,4607.44,16363.04,4607.09,16362.56,2938,2937
