ndimage_cellID,x0,x1,y0,y1,length,height,total_area,nuclei_area,cyto_area,c2t_area_ratio,number_nuclei,orig_comX,orig_comY,ndimage_comX,ndimage_comY,orig_cellID
1,0,15008,0,10720,15008,10720,91578755,259484,91319271,0.997166548071111,0,8018.98,5854.09,8018.43,5850.8,1
2,4383,4896,0,599,513,599,183209,0,183209,1.0,0,4623.62,277.23,4623.01,277.0,2
3,4848,5020,0,144,172,144,12764,0,12764,1.0,0,4917.68,49.01,4916.85,49.81,3
4,4830,5411,0,488,581,488,196168,5941,190227,0.9697147343093675,0,5121.9,225.67,5121.47,225.64,4
5,5307,5779,0,301,472,301,93459,0,93459,1.0,0,5518.18,125.15,5517.58,125.33,5
6,5680,6171,0,434,491,434,110081,0,110081,1.0,0,5915.84,167.85,5915.34,167.97,6
7,6033,6497,0,210,464,210,64123,0,64123,1.0,0,6273.79,89.46,6272.95,89.58,7
8,6141,6741,0,818,600,818,253893,1155,252738,0.9954508395268873,1,6467.68,435.02,6466.97,434.89,8
9,6669,7260,0,208,591,208,92599,0,92599,1.0,0,6962.27,83.9,6961.52,84.04,9
10,8094,8794,0,285,700,285,121766,0,121766,1.0,0,8428.06,100.02,8427.61,100.41,10
11,8700,9215,0,660,515,660,170442,0,170442,1.0,0,8919.31,331.57,8919.17,331.77,11
12,8861,9236,0,73,375,73,17379,0,17379,1.0,0,9052.95,26.14,9052.19,26.31,12
13,9018,9443,0,548,425,548,160703,0,160703,1.0,0,9214.98,243.79,9214.49,243.81,13
14,9394,9896,0,286,502,286,103868,0,103868,1.0,0,9623.64,121.48,9623.01,121.9,14
15,9844,9942,0,66,98,66,3384,0,3384,1.0,0,9897.01,28.73,9895.86,28.88,15
16,9622,10511,0,726,889,726,371443,0,371443,1.0,0,10044.15,303.71,10043.09,304.21,16
17,10721,11151,0,200,430,200,45494,0,45494,1.0,0,10947.34,65.28,10946.88,65.61,17
18,11109,11720,0,318,611,318,105399,0,105399,1.0,0,11471.15,108.41,11470.36,108.7,18
19,11695,12459,0,418,764,418,156287,0,156287,1.0,0,12084.01,174.1,12083.86,174.47,19
20,12049,12286,0,84,237,84,9115,0,9115,1.0,0,12182.6,24.93,12181.86,25.16,20
21,10849,11445,63,813,596,750,316983,0,316983,1.0,0,11154.61,438.93,11154.11,438.49,21
22,11382,11832,109,559,450,450,88986,0,88986,1.0,0,11597.86,348.99,11597.52,348.45,22
23,5843,6395,135,692,552,557,143700,19,143681,0.9998677800974252,0,6117.63,387.4,6116.97,386.88,23
24,6607,7011,139,507,404,368,94472,0,94472,1.0,0,6801.98,303.32,6801.71,303.27,24
25,8403,8801,140,559,398,419,100254,0,100254,1.0,0,8627.03,334.42,8626.52,333.8,25
26,8150,8548,174,616,398,442,95953,2218,93735,0.9768845163778099,1,8339.91,403.05,8339.23,402.16,26
27,12576,12680,178,279,104,101,3815,0,3815,1.0,0,12626.57,231.14,12625.93,231.03,27
28,5428,5893,183,455,465,272,69644,0,69644,1.0,0,5711.17,322.85,5709.8,322.46,28
29,11629,12152,191,744,523,553,194585,0,194585,1.0,0,11907.28,459.92,11906.69,459.52,29
30,3987,4409,218,586,422,368,108881,0,108881,1.0,0,4208.57,395.43,4208.12,394.74,31
31,9165,9741,220,1128,576,908,296912,1828,295084,0.9938432936358248,1,9479.48,633.21,9478.96,632.85,32
32,12504,12804,250,693,300,443,66726,0,66726,1.0,0,12650.81,447.53,12650.35,448.07,33
33,5388,5449,282,331,61,49,1786,0,1786,1.0,0,5418.93,308.08,5418.4,307.66,34
34,10137,10647,291,931,510,640,168422,0,168422,1.0,0,10364.83,661.92,10364.31,660.71,35
35,4442,5008,322,829,566,507,104330,4687,99643,0.9550752420205119,0,4689.04,566.05,4688.79,565.58,36
36,5221,5604,323,506,383,183,47753,0,47753,1.0,0,5418.07,419.15,5417.66,418.66,37
37,2591,2983,331,621,392,290,67243,0,67243,1.0,0,2767.23,489.74,2766.74,489.14,38
38,3949,4014,350,437,65,87,3386,0,3386,1.0,0,3986.86,396.04,3986.34,395.42,39
39,12076,12616,370,784,540,414,142384,0,142384,1.0,0,12324.37,565.59,12324.05,564.94,40
40,3663,4138,389,809,475,420,111115,0,111115,1.0,0,3928.71,622.44,3927.78,622.02,41
41,5066,5880,413,791,814,378,159049,0,159049,1.0,0,5463.41,581.66,5462.87,580.99,42
42,3183,3317,433,548,134,115,6808,0,6808,1.0,0,3256.58,499.78,3256.02,499.5,43
43,4613,5119,436,835,506,399,101892,3696,98196,0.9637262984336357,0,4881.51,639.58,4880.75,639.25,44
44,6625,7049,446,776,424,330,79916,362,79554,0.9954702437559437,0,6828.9,607.09,6828.45,606.7,45
45,7922,8092,465,567,170,102,10402,0,10402,1.0,0,8011.29,523.48,8010.5,522.93,46
46,8484,8699,467,649,215,182,24071,0,24071,1.0,0,8593.45,565.7,8592.81,565.46,47
47,2929,3427,479,834,498,355,98276,0,98276,1.0,0,3200.01,644.56,3199.26,643.94,48
48,12742,12812,489,574,70,85,3087,0,3087,1.0,0,12778.12,529.63,12777.69,529.33,49
49,11258,11815,491,1132,557,641,226305,0,226305,1.0,0,11534.76,811.54,11534.04,811.22,51
50,3494,3752,492,741,258,249,29457,0,29457,1.0,0,3628.38,615.17,3627.79,614.76,50
51,4110,4431,500,752,321,252,48371,0,48371,1.0,0,4274.57,634.37,4274.05,633.75,52
52,5889,6242,502,916,353,414,70564,1244,69320,0.9823706139107761,0,6065.97,709.16,6065.34,709.02,53
53,5547,6074,537,1249,527,712,215440,3059,212381,0.985801151132566,1,5787.41,904.74,5787.47,904.04,54
54,4159,4528,547,958,369,411,57279,0,57279,1.0,0,4352.07,788.34,4351.91,786.94,55
55,9590,10180,554,1148,590,594,203386,0,203386,1.0,0,9872.52,851.12,9872.48,850.29,56
56,2561,3233,572,1217,672,645,222545,1290,221255,0.9942034195331282,1,2879.11,851.26,2878.35,850.71,57
57,12265,12661,599,1122,396,523,115821,0,115821,1.0,0,12475.06,871.06,12474.58,870.43,58
58,2038,2720,609,1249,682,640,237770,62,237708,0.9997392438070404,0,2364.64,962.48,2364.4,961.61,59
59,4893,5376,613,1299,483,686,208745,0,208745,1.0,0,5131.87,948.1,5131.67,948.0,60
60,3435,3812,663,1169,377,506,100451,0,100451,1.0,0,3613.66,901.96,3613.09,901.73,61
61,11677,12327,668,1192,650,524,215879,0,215879,1.0,0,11994.14,934.45,11993.7,933.86,62
62,3697,4228,685,1149,531,464,122732,0,122732,1.0,0,3968.45,915.22,3968.0,914.74,63
63,5813,5906,690,755,93,65,2889,0,2889,1.0,0,5852.46,715.63,5852.11,715.31,64
64,5275,5595,694,1293,320,599,107324,0,107324,1.0,0,5433.89,982.22,5433.46,981.45,65
65,3228,3574,705,993,346,288,41556,0,41556,1.0,0,3425.68,837.44,3424.75,837.09,66
66,10897,11367,739,1292,470,553,166272,0,166272,1.0,0,11139.43,1039.24,11138.89,1038.46,67
67,6012,6271,747,1023,259,276,34344,1,34343,0.999970882832518,0,6142.94,877.42,6142.4,877.21,68
68,5311,5421,760,837,110,77,5016,0,5016,1.0,0,5358.9,799.25,5358.61,798.8,69
69,4340,5008,769,1398,668,629,222658,0,222658,1.0,0,4725.84,1044.72,4724.66,1044.41,70
70,9785,10304,827,1230,519,403,92864,0,92864,1.0,0,10074.18,1030.23,10073.34,1030.26,71
71,2893,3505,853,1560,612,707,257326,0,257326,1.0,0,3234.43,1189.25,3233.82,1188.8,72
72,3358,4762,905,2179,1404,1274,1001869,0,1001869,1.0,0,3989.81,1483.72,3990.04,1483.13,73
73,11271,11948,1002,1675,677,673,260842,0,260842,1.0,0,11579.06,1338.85,11578.72,1338.28,74
74,5450,5666,1010,1259,216,249,25138,0,25138,1.0,0,5569.38,1136.17,5568.43,1136.15,75
75,2151,3218,1065,1876,1067,811,485652,0,485652,1.0,0,2638.11,1433.29,2637.92,1432.99,76
76,5234,5797,1127,1579,563,452,104153,3738,100415,0.9641104912964581,2,5518.08,1347.5,5517.43,1346.94,77
77,1789,2218,1152,1525,429,373,87723,0,87723,1.0,0,2021.38,1327.8,2021.11,1327.46,79
78,4927,5319,1205,1707,392,502,98267,0,98267,1.0,0,5092.17,1411.44,5091.71,1410.94,80
79,4737,5048,1271,1819,311,548,83955,0,83955,1.0,0,4897.98,1544.39,4897.63,1543.48,81
80,13371,13607,1275,1528,236,253,35319,0,35319,1.0,0,13476.6,1381.5,13475.92,1381.09,82
81,7657,7922,1277,1562,265,285,32356,1399,30957,0.9567622697490419,0,7781.48,1399.24,7781.51,1399.52,83
82,5193,5262,1322,1404,69,82,2606,0,2606,1.0,0,5223.45,1353.59,5222.77,1353.87,84
83,7825,7923,1322,1466,98,144,9752,0,9752,1.0,0,7873.61,1392.25,7873.16,1391.89,85
84,7635,7672,1325,1357,37,32,822,26,796,0.9683698296836983,0,7654.45,1341.15,7653.9,1340.65,86
85,7501,7657,1337,1473,156,136,12266,0,12266,1.0,0,7575.64,1407.74,7575.36,1407.17,87
86,7630,7665,1347,1403,35,56,1145,404,741,0.6471615720524018,0,7647.03,1372.26,7646.6,1371.97,88
87,7311,7428,1353,1534,117,181,11808,0,11808,1.0,0,7369.7,1448.05,7369.13,1447.49,89
88,11651,12351,1373,2072,700,699,321608,0,321608,1.0,0,11968.36,1731.08,11968.1,1730.29,90
89,4417,5003,1387,2036,586,649,217048,0,217048,1.0,0,4670.51,1724.62,4670.06,1724.53,91
90,7421,7513,1393,1445,92,52,3357,0,3357,1.0,0,7466.43,1420.88,7465.9,1420.44,92
91,7214,7350,1398,1586,136,188,14877,0,14877,1.0,0,7276.58,1490.11,7276.16,1489.53,93
92,7613,7724,1414,1498,111,84,7128,0,7128,1.0,0,7665.07,1457.9,7664.66,1457.39,94
93,1908,2188,1420,1689,280,269,37264,0,37264,1.0,0,2028.08,1545.97,2028.11,1545.86,95
94,7715,7799,1421,1495,84,74,4252,0,4252,1.0,0,7755.63,1457.68,7755.18,1457.21,96
95,7396,7521,1439,1537,125,98,8832,0,8832,1.0,0,7463.87,1482.83,7463.33,1482.39,97
96,7494,7624,1456,1600,130,144,12621,3872,8749,0.6932097298153871,2,7566.27,1530.16,7565.43,1529.9,98
97,7984,8156,1468,1680,172,212,22003,5387,16616,0.7551697495796028,2,8065.86,1562.0,8065.49,1561.88,99
98,7607,7821,1475,1708,214,233,27513,3245,24268,0.8820557554610547,2,7711.72,1588.5,7711.17,1587.8,100
99,7654,7721,1479,1522,67,43,1426,0,1426,1.0,0,7692.02,1506.06,7691.53,1505.18,101
100,7765,7844,1484,1589,79,105,5649,0,5649,1.0,0,7804.15,1536.19,7803.67,1535.67,102
101,7097,7176,1486,1590,79,104,4746,0,4746,1.0,0,7137.08,1537.45,7136.53,1537.02,103
102,6988,7504,1496,1916,516,420,80166,3913,76253,0.951188783274705,3,7268.96,1733.86,7268.23,1733.22,104
103,2833,3405,1503,2046,572,543,205653,0,205653,1.0,0,3133.22,1788.73,3132.62,1788.14,105
104,7500,7545,1513,1567,45,54,1610,0,1610,1.0,0,7521.75,1543.32,7521.26,1542.64,107
105,7307,7353,1527,1579,46,52,1538,0,1538,1.0,0,7332.66,1550.31,7332.16,1549.99,108
106,7346,7392,1528,1586,46,58,1947,0,1947,1.0,0,7369.77,1555.4,7369.17,1554.93,109
107,7268,7354,1548,1614,86,66,3726,0,3726,1.0,0,7309.72,1586.76,7309.25,1586.12,110
108,7809,7902,1552,1643,93,91,5204,0,5204,1.0,0,7856.71,1597.06,7856.16,1596.6,111
109,7158,7234,1571,1656,76,85,3913,0,3913,1.0,0,7196.55,1609.41,7195.78,1609.2,112
110,8098,8276,1578,1726,178,148,16402,0,16402,1.0,0,8182.66,1652.59,8182.24,1652.14,113
111,7233,7276,1583,1635,43,52,1780,0,1780,1.0,0,7252.43,1608.89,7251.96,1608.39,114
112,7053,7166,1587,1709,113,122,7992,0,7992,1.0,0,7113.21,1649.22,7112.69,1648.76,115
113,7598,7628,1588,1618,30,30,692,0,692,1.0,0,7611.9,1603.89,7611.48,1603.34,116
114,1724,2048,1591,1901,324,310,69680,0,69680,1.0,0,1901.49,1740.78,1900.9,1740.49,117
115,2020,2314,1592,1815,294,223,33983,0,33983,1.0,0,2152.63,1702.92,2152.12,1702.57,119
116,7523,7601,1592,1661,78,69,3369,97,3272,0.9712080736123478,0,7558.68,1621.64,7558.26,1621.26,118
117,7364,7730,1597,1865,366,268,44916,450,44466,0.9899812984237243,1,7529.91,1712.38,7529.51,1712.06,120
118,7660,8033,1608,2023,373,415,86435,5136,81299,0.940579626308787,3,7842.84,1815.65,7842.54,1814.91,121
119,7951,8051,1619,1712,100,93,6956,176,6780,0.9746981023576768,0,8002.52,1666.1,8002.0,1665.57,122
120,2250,2839,1625,2051,589,426,123780,0,123780,1.0,0,2565.39,1825.18,2564.72,1824.55,124
121,7156,7242,1625,1681,86,56,2970,0,2970,1.0,0,7202.4,1654.56,7201.77,1654.04,123
122,8223,8342,1649,1809,119,160,11178,0,11178,1.0,0,8284.17,1729.88,8283.71,1729.49,125
123,6953,7092,1650,1788,139,138,10221,0,10221,1.0,0,7034.71,1728.55,7033.98,1728.06,126
124,4163,4209,1654,1727,46,73,2241,0,2241,1.0,0,4183.87,1692.76,4183.43,1692.39,127
125,7193,7246,1661,1711,53,50,1443,0,1443,1.0,0,7217.64,1686.59,7217.33,1686.0,128
126,8029,8114,1664,1730,85,66,2920,0,2920,1.0,0,8064.5,1693.54,8064.24,1693.05,129
127,8317,8478,1667,1828,161,161,11115,0,11115,1.0,0,8385.6,1761.74,8385.26,1761.03,130
128,7897,7955,1672,1722,58,50,1841,0,1841,1.0,0,7927.24,1698.8,7926.78,1698.22,131
129,7157,7201,1679,1720,44,41,1314,0,1314,1.0,0,7177.92,1699.98,7177.49,1699.48,132
130,8054,8142,1680,1758,88,78,4076,0,4076,1.0,0,8104.72,1721.7,8104.03,1721.16,133
131,7213,7269,1682,1728,56,46,1569,0,1569,1.0,0,7243.89,1707.47,7243.2,1706.87,134
132,4132,4544,1698,2371,412,673,190252,281,189971,0.9985230115846351,0,4345.1,2015.84,4344.62,2015.54,135
133,8116,8206,1709,1810,90,101,5138,2526,2612,0.5083690151810043,1,8159.91,1754.29,8159.41,1753.93,136
134,7941,8188,1719,2024,247,305,39092,1756,37336,0.9550803233398137,1,8052.59,1895.6,8052.3,1894.72,137
135,8147,8252,1725,1835,105,110,6500,0,6500,1.0,0,8206.34,1785.92,8205.67,1785.37,138
136,1824,2385,1733,2013,561,280,72478,0,72478,1.0,0,2127.38,1883.72,2125.84,1883.41,139
137,7547,7682,1736,1867,135,131,13206,0,13206,1.0,0,7612.14,1797.11,7611.67,1796.69,140
138,6886,7006,1755,1906,120,151,10939,353,10586,0.9677301398665326,0,6945.72,1826.9,6945.02,1826.64,141
139,7446,7555,1759,1864,109,105,7947,0,7947,1.0,0,7501.28,1809.34,7500.72,1808.96,142
140,8449,8481,1764,1792,32,28,713,0,713,1.0,0,8464.01,1777.54,8463.53,1777.02,143
141,7001,7045,1778,1831,44,53,1849,407,1442,0.7798810167658193,1,7023.26,1805.37,7022.77,1804.85,144
142,3180,3724,1779,2266,544,487,123629,0,123629,1.0,0,3428.89,2017.5,3428.78,2016.94,145
143,8056,8151,1779,1879,95,100,6121,2101,4020,0.6567554321189348,1,8104.07,1833.61,8103.62,1832.96,148
144,8299,8386,1779,1866,87,87,4868,0,4868,1.0,0,8341.52,1822.14,8341.05,1821.64,146
145,7044,7085,1780,1815,41,35,1150,0,1150,1.0,0,7062.83,1797.66,7062.39,1797.18,147
146,8474,8556,1782,1887,82,105,4951,2794,2157,0.4356695617047061,1,8512.05,1832.39,8511.64,1831.96,149
147,1631,1868,1791,2115,237,324,51229,0,51229,1.0,0,1744.53,1959.18,1744.29,1958.62,150
148,8221,8304,1792,1870,83,78,4380,855,3525,0.8047945205479452,1,8263.16,1831.7,8262.6,1831.19,151
149,8530,8671,1799,1947,141,148,12887,139,12748,0.9892139365251804,0,8599.29,1869.7,8598.76,1869.3,152
150,8361,8439,1813,1940,78,127,5312,0,5312,1.0,0,8401.96,1868.17,8401.32,1868.07,153
151,6796,6911,1817,1914,115,97,6804,976,5828,0.8565549676660787,0,6848.43,1858.84,6847.76,1858.52,154
152,8429,8493,1819,1908,64,89,3495,0,3495,1.0,0,8458.9,1859.62,8458.53,1859.26,155
153,8128,8211,1821,1897,83,76,3852,0,3852,1.0,0,8164.99,1864.73,8164.6,1864.06,156
154,7210,7482,1827,2058,272,231,32188,990,31198,0.9692431962221946,0,7362.75,1939.68,7361.93,1939.39,157
155,8179,8226,1829,1862,47,33,996,0,996,1.0,0,8205.64,1843.47,8204.96,1843.02,158
156,10758,11393,1829,2564,635,735,240080,0,240080,1.0,0,11088.44,2195.1,11087.87,2194.69,159
157,7454,7589,1835,1965,135,130,11580,0,11580,1.0,0,7520.04,1902.31,7519.61,1901.71,160
158,8651,8787,1843,1970,136,127,10503,0,10503,1.0,0,8712.81,1911.1,8712.35,1910.61,162
159,6987,7305,1845,2108,318,263,44719,3244,41475,0.927458127417876,2,7122.88,1963.44,7122.4,1963.02,161
160,8286,8343,1846,1896,57,50,1910,0,1910,1.0,0,8315.4,1871.35,8314.83,1870.8,163
161,7554,7741,1847,2017,187,170,22312,1016,21296,0.9544639655790605,1,7649.03,1929.22,7648.47,1928.77,164
162,8167,8297,1849,1978,130,129,9630,0,9630,1.0,0,8230.23,1922.98,8229.74,1922.38,165
163,6731,6815,1852,1920,84,68,3355,0,3355,1.0,0,6775.46,1888.32,6774.94,1887.96,166
164,6960,7033,1853,1927,73,74,3603,0,3603,1.0,0,6996.25,1892.59,6995.69,1891.97,167
165,8333,8386,1860,1928,53,68,2327,670,1657,0.7120756338633434,1,8360.42,1895.84,8359.85,1895.25,168
166,1824,2573,1862,2457,749,595,295105,0,295105,1.0,0,2231.41,2149.3,2231.06,2149.02,169
167,8256,8304,1863,1914,48,51,1721,0,1721,1.0,0,8276.7,1889.15,8276.36,1888.63,170
168,8468,8544,1863,1977,76,114,5871,64,5807,0.9890989609947198,0,8505.54,1920.6,8504.96,1920.13,171
169,4782,5055,1867,2214,273,347,36658,1058,35600,0.9711386327677451,0,4906.22,2045.09,4905.71,2044.64,172
170,6827,6926,1879,1958,99,79,4611,146,4465,0.9683365864237693,1,6880.01,1919.03,6879.36,1918.45,173
171,2510,2908,1883,2296,398,413,63084,0,63084,1.0,0,2708.42,2090.57,2707.43,2090.2,174
172,6918,6969,1887,1956,51,69,2152,0,2152,1.0,0,6942.23,1921.05,6941.78,1920.57,175
173,8407,8477,1890,1967,70,77,3848,0,3848,1.0,0,8440.48,1927.68,8440.02,1927.22,176
174,8289,8352,1892,1980,63,88,3606,30,3576,0.9916805324459235,0,8318.43,1932.52,8317.94,1932.1,177
175,8530,8565,1907,1975,35,68,1449,0,1449,1.0,0,8549.67,1944.17,8549.08,1943.41,178
176,6784,6852,1908,1964,68,56,2727,0,2727,1.0,0,6816.76,1937.98,6816.33,1937.45,179
177,6689,6795,1909,2008,106,99,6334,0,6334,1.0,0,6749.6,1961.65,6749.03,1961.07,180
178,6932,6991,1909,1982,59,73,2327,517,1810,0.7778255264288784,1,6966.81,1949.41,6966.21,1948.75,181
179,4480,4851,1913,2281,371,368,86016,0,86016,1.0,0,4664.1,2108.77,4663.65,2108.08,182
180,8558,8619,1920,2014,61,94,4612,0,4612,1.0,0,8589.5,1965.72,8589.0,1965.27,183
181,8335,8415,1924,1992,80,68,3473,0,3473,1.0,0,8373.41,1956.85,8372.98,1956.38,184
182,8750,8874,1927,2052,124,125,8176,0,8176,1.0,0,8808.76,1994.01,8808.47,1993.5,185
183,11248,11943,1929,2416,695,487,196289,0,196289,1.0,0,11568.64,2181.18,11568.35,2180.85,186
184,12274,12822,1933,2626,548,693,195779,0,195779,1.0,0,12556.39,2319.2,12555.96,2318.22,187
185,8590,8712,1935,2060,122,125,8829,0,8829,1.0,0,8646.9,1999.07,8646.44,1998.49,188
186,6842,6928,1942,1994,86,52,2888,0,2888,1.0,0,6882.98,1969.89,6882.46,1969.18,189
187,11820,12491,1945,2471,671,526,184461,0,184461,1.0,0,12138.12,2191.14,12138.01,2190.63,190
188,8444,8507,1953,2003,63,50,1967,0,1967,1.0,0,8476.56,1980.86,8475.93,1980.17,191
189,8631,8814,1953,2282,183,329,28703,0,28703,1.0,0,8717.0,2132.07,8716.7,2131.41,193
190,8200,8315,1954,2031,115,77,4565,11,4554,0.9975903614457832,0,8254.59,1994.9,8254.24,1994.15,192
191,3477,3989,1956,2537,512,581,177201,0,177201,1.0,0,3739.81,2249.28,3739.29,2248.85,194
192,6829,6972,1956,2185,143,229,21050,0,21050,1.0,0,6902.68,2074.63,6902.16,2074.04,198
193,8390,8456,1956,2019,66,63,2990,0,2990,1.0,0,8421.77,1989.04,8421.29,1988.51,196
194,7418,7614,1957,2135,196,178,24575,1838,22737,0.925208545269583,1,7511.56,2044.57,7511.11,2044.08,195
195,6784,6854,1958,2029,70,71,3378,0,3378,1.0,0,6818.04,1990.87,6817.55,1990.49,197
196,7784,8196,1960,2207,412,247,43433,0,43433,1.0,0,7984.28,2074.07,7984.27,2073.69,199
197,8169,8219,1962,2003,50,41,1361,168,1193,0.8765613519470977,0,8194.66,1982.03,8194.14,1981.52,200
198,8505,8561,1962,2022,56,60,2235,0,2235,1.0,0,8531.78,1991.82,8531.27,1991.33,201
199,8297,8365,1966,2091,68,125,5688,0,5688,1.0,0,8329.51,2030.15,8329.06,2029.46,202
200,6965,7007,1975,2040,42,65,2047,0,2047,1.0,0,6986.57,2008.59,6986.03,2008.06,203
201,6644,6714,1977,2067,70,90,4292,1342,2950,0.6873252562907736,1,6682.5,2022.84,6681.94,2022.31,204
202,7586,7829,1987,2179,243,192,31590,0,31590,1.0,0,7704.9,2082.51,7704.39,2082.03,206
203,8031,8414,1987,2280,383,293,55888,2239,53649,0.9599377326080732,2,8244.33,2124.55,8243.79,2123.65,205
204,8408,8546,1993,2151,138,158,12143,0,12143,1.0,0,8467.23,2060.12,8466.8,2059.98,207
205,8245,8307,1996,2080,62,84,3051,0,3051,1.0,0,8277.67,2040.88,8277.18,2040.21,209
206,8529,8603,1996,2082,74,86,3739,0,3739,1.0,0,8566.5,2039.95,8565.93,2039.39,208
207,6690,6763,2000,2152,73,152,6115,0,6115,1.0,0,6727.88,2075.11,6727.29,2074.82,211
208,6741,6803,2000,2070,62,70,3199,0,3199,1.0,0,6771.64,2034.04,6771.15,2033.59,210
209,7063,7315,2000,2259,252,259,39333,0,39333,1.0,0,7185.0,2141.06,7184.45,2140.51,212
210,7255,7419,2003,2145,164,142,17035,0,17035,1.0,0,7335.6,2066.94,7335.07,2066.54,213
211,2667,3901,2014,2828,1234,814,533969,0,533969,1.0,0,3224.23,2415.91,3224.29,2415.76,214
212,6796,6847,2021,2070,51,49,1541,0,1541,1.0,0,6819.67,2043.42,6819.22,2043.05,215
213,6494,6603,2029,2144,109,115,6916,0,6916,1.0,0,6548.87,2080.44,6548.28,2080.09,216
214,6585,6700,2031,2158,115,127,9015,0,9015,1.0,0,6647.62,2091.94,6647.12,2091.56,217
215,8751,8869,2031,2124,118,93,7884,0,7884,1.0,0,8809.08,2079.19,8808.55,2078.72,218
216,6949,7001,2034,2081,52,47,1804,0,1804,1.0,0,6975.48,2058.89,6974.92,2058.29,219
217,8648,8698,2042,2089,50,47,1678,0,1678,1.0,0,8675.03,2067.32,8674.44,2066.71,220
218,8863,9005,2042,2123,142,81,8393,1958,6435,0.7667103538663171,0,8932.74,2082.1,8932.18,2081.61,221
219,6808,6857,2047,2105,49,58,2054,0,2054,1.0,0,6833.76,2077.94,6833.27,2077.35,222
220,8590,8660,2054,2116,70,62,3055,0,3055,1.0,0,8626.27,2084.9,8625.69,2084.27,223
221,6890,7135,2058,2438,245,380,37867,0,37867,1.0,0,7011.17,2262.2,7010.75,2261.24,224
222,6750,6834,2059,2176,84,117,6103,0,6103,1.0,0,6790.82,2118.22,6790.55,2117.81,225
223,8446,8570,2062,2185,124,123,9184,942,8242,0.8974303135888502,1,8509.33,2130.13,8508.91,2129.4,226
224,8560,8654,2072,2194,94,122,6152,0,6152,1.0,0,8606.54,2133.17,8605.96,2132.62,227
225,6292,6401,2083,2207,109,124,9000,0,9000,1.0,0,6344.44,2140.96,6343.98,2140.49,228
226,7807,7941,2085,2193,134,108,10422,0,10422,1.0,0,7872.66,2132.5,7872.14,2132.13,229
227,6445,6522,2089,2187,77,98,4362,0,4362,1.0,0,6488.7,2141.3,6488.09,2140.72,231
228,1561,1857,2090,2447,296,357,62180,0,62180,1.0,0,1706.39,2244.54,1705.97,2244.17,230
229,7307,7476,2097,2256,169,159,18651,0,18651,1.0,0,7391.95,2175.32,7391.46,2174.82,232
230,8826,8896,2098,2179,70,81,3633,0,3633,1.0,0,8862.38,2137.53,8861.97,2137.13,233
231,6516,6612,2099,2213,96,114,5322,0,5322,1.0,0,6556.97,2157.7,6556.84,2156.83,234
232,7450,7661,2099,2309,211,210,29756,0,29756,1.0,0,7557.29,2205.28,7556.79,2204.78,235
233,8358,8456,2103,2170,98,67,3394,344,3050,0.8986446670595168,0,8398.25,2140.14,8398.56,2139.84,238
234,8884,9020,2104,2185,136,81,6564,0,6564,1.0,0,8947.88,2141.93,8947.19,2141.46,239
235,3856,4514,2105,2792,658,687,252280,2153,250127,0.9914658316156651,1,4160.18,2474.31,4160.07,2473.8,236
236,6992,7108,2105,2233,116,128,9755,0,9755,1.0,0,7050.35,2170.14,7049.96,2169.67,237
237,8739,8828,2116,2174,89,58,3184,0,3184,1.0,0,8781.12,2143.6,8780.83,2143.03,240
238,6578,6662,2123,2213,84,90,4772,2335,2437,0.5106873428331936,1,6614.44,2161.31,6614.08,2161.02,241
239,6365,6444,2125,2197,79,72,3652,0,3652,1.0,0,6408.19,2160.57,6407.45,2160.21,242
240,6701,6754,2127,2174,53,47,1939,0,1939,1.0,0,6725.45,2151.42,6725.02,2150.91,243
241,8784,8875,2142,2220,91,78,4743,0,4743,1.0,0,8826.58,2183.97,8826.15,2183.39,244
242,7847,8011,2144,2348,164,204,17634,0,17634,1.0,0,7954.28,2232.59,7953.49,2232.19,246
243,6148,6312,2145,2357,164,212,16841,2722,14119,0.8383706430734517,1,6244.11,2254.85,6243.37,2254.58,245
244,8530,8632,2145,2236,102,91,6345,0,6345,1.0,0,8575.75,2194.14,8575.35,2193.56,247
245,8007,8134,2148,2399,127,251,19716,0,19716,1.0,0,8059.58,2248.47,8059.16,2248.35,248
246,3958,4033,2149,2204,75,55,2319,0,2319,1.0,0,3996.43,2177.28,3995.87,2176.73,249
247,6616,6705,2152,2232,89,80,4130,0,4130,1.0,0,6659.02,2191.18,6658.56,2190.65,251
248,7644,7851,2152,2336,207,184,23703,0,23703,1.0,0,7734.64,2229.22,7734.3,2228.87,250
249,6749,6850,2153,2273,101,120,6428,0,6428,1.0,0,6803.27,2205.09,6802.49,2204.69,252
250,8316,8521,2154,2355,205,201,23907,45,23862,0.9981177061111808,0,8419.71,2269.4,8419.26,2268.61,253
251,6826,6887,2155,2201,61,46,1925,0,1925,1.0,0,6857.46,2177.48,6856.88,2177.02,254
252,6405,6495,2156,2243,90,87,5236,0,5236,1.0,0,6453.51,2202.12,6452.97,2201.55,255
253,8967,9059,2158,2272,92,114,6023,1278,4745,0.7878133820355304,1,9006.94,2211.34,9006.48,2211.01,256
254,8890,8979,2162,2244,89,82,4488,0,4488,1.0,0,8936.86,2201.23,8936.34,2200.68,257
255,9144,9241,2162,2248,97,86,4694,0,4694,1.0,0,9191.13,2200.28,9190.78,2199.71,258
256,6677,6777,2170,2235,100,65,3961,0,3961,1.0,0,6726.92,2200.87,6726.4,2200.4,259
257,6850,6921,2172,2234,71,62,2401,0,2401,1.0,0,6890.36,2203.69,6889.6,2203.13,261
258,8438,8732,2172,2420,294,248,35820,2995,32825,0.9163874930206588,2,8592.28,2296.27,8591.35,2295.38,260
259,8779,8910,2179,2291,131,112,6841,0,6841,1.0,0,8845.7,2241.16,8845.23,2240.49,262
260,6494,6546,2183,2244,52,61,2010,0,2010,1.0,0,6517.12,2212.21,6516.8,2211.81,263
261,6305,6409,2184,2266,104,82,5883,0,5883,1.0,0,6356.15,2226.32,6355.73,2225.79,264
262,9041,9154,2185,2289,113,104,8338,0,8338,1.0,0,9098.84,2232.31,9098.33,2231.89,265
263,6532,6621,2197,2282,89,85,5432,0,5432,1.0,0,6577.72,2240.17,6577.18,2239.65,266
264,6821,6989,2203,2405,168,202,18367,0,18367,1.0,0,6883.28,2320.64,6882.95,2319.95,268
265,7211,7366,2204,2334,155,130,12802,0,12802,1.0,0,7286.29,2271.21,7285.9,2270.64,267
266,1700,2341,2206,2738,641,532,212774,0,212774,1.0,0,1998.53,2510.87,1998.06,2510.1,269
267,7720,7963,2208,2376,243,168,23976,0,23976,1.0,0,7842.54,2303.42,7842.0,2302.85,270
268,6548,6720,2210,2341,172,131,9506,0,9506,1.0,0,6633.0,2276.08,6632.47,2275.52,271
269,8080,8190,2215,2454,110,239,20863,0,20863,1.0,0,8132.78,2337.58,8132.33,2336.98,272
270,6722,6831,2220,2405,109,185,12764,678,12086,0.9468818552178001,1,6780.65,2315.55,6779.91,2315.17,273
271,2195,3508,2222,3118,1313,896,570229,0,570229,1.0,0,2787.66,2752.54,2787.54,2752.01,274
272,6377,6479,2224,2321,102,97,6789,0,6789,1.0,0,6425.45,2274.44,6424.97,2273.93,275
273,6472,6539,2224,2294,67,70,2822,0,2822,1.0,0,6501.64,2258.53,6501.24,2258.06,276
274,6711,6746,2226,2278,35,52,1048,0,1048,1.0,0,6727.09,2249.86,6726.62,2249.44,277
275,8881,8952,2226,2286,71,60,2816,0,2816,1.0,0,8912.05,2256.35,8911.8,2255.83,278
276,9111,9213,2229,2338,102,109,7014,385,6629,0.9451097804391217,1,9161.23,2283.87,9160.64,2283.48,279
277,7322,7531,2230,2402,209,172,23171,810,22361,0.9650425100340944,1,7428.03,2317.44,7427.57,2316.93,280
278,7098,7229,2232,2371,131,139,11556,0,11556,1.0,0,7162.96,2304.1,7162.52,2303.59,281
279,8947,8992,2238,2271,45,33,1048,0,1048,1.0,0,8969.78,2255.59,8969.27,2255.04,282
280,8991,9064,2241,2317,73,76,3587,0,3587,1.0,0,9027.66,2281.82,9027.21,2281.17,285
281,8729,8781,2242,2298,52,56,2338,0,2338,1.0,0,8756.44,2270.47,8755.89,2269.94,284
282,4233,4279,2251,2314,46,63,1777,0,1777,1.0,0,4255.35,2279.78,4254.89,2279.46,286
283,4483,4539,2253,2349,56,96,2478,0,2478,1.0,0,4509.14,2300.36,4508.93,2299.73,287
284,6286,6379,2254,2373,93,119,6648,0,6648,1.0,0,6331.42,2306.13,6330.92,2305.71,288
285,8181,8340,2255,2488,159,233,28123,0,28123,1.0,0,8252.46,2365.5,8252.06,2365.01,289
286,8927,9014,2256,2344,87,88,4227,0,4227,1.0,0,8969.65,2302.24,8969.09,2301.62,290
287,6500,6563,2265,2320,63,55,2393,0,2393,1.0,0,6533.74,2295.65,6533.16,2295.03,291
288,4464,4748,2267,2540,284,273,46880,0,46880,1.0,0,4613.48,2398.42,4613.06,2398.18,292
289,8612,9156,2267,2563,544,296,82721,0,82721,1.0,0,8887.49,2410.14,8887.17,2409.85,293
290,6639,6758,2268,2405,119,137,10967,91,10876,0.9917023798668734,0,6700.96,2341.27,6700.34,2340.76,294
291,9053,9116,2272,2360,63,88,3352,0,3352,1.0,0,9087.98,2312.71,9087.38,2312.34,295
292,11001,12058,2274,3073,1057,799,538774,0,538774,1.0,0,11505.84,2644.03,11505.34,2643.67,296
293,6445,6507,2280,2346,62,66,2534,0,2534,1.0,0,6475.35,2315.56,6474.91,2314.95,297
294,7479,7756,2282,2493,277,211,39828,0,39828,1.0,0,7617.58,2390.01,7617.08,2389.51,298
295,6331,6404,2296,2395,73,99,2701,0,2701,1.0,0,6367.34,2339.18,6366.66,2339.25,300
296,6630,6664,2296,2381,34,85,1932,0,1932,1.0,0,6646.39,2334.23,6645.81,2334.15,299
297,9175,9250,2300,2427,75,127,4839,0,4839,1.0,0,9208.3,2367.01,9207.82,2366.34,301
298,6058,6175,2303,2467,117,164,8730,0,8730,1.0,0,6119.98,2388.03,6119.37,2387.6,302
299,8980,9092,2307,2388,112,81,5726,0,5726,1.0,0,9036.1,2350.97,9035.64,2350.39,303
300,6191,6308,2309,2417,117,108,8413,3321,5092,0.6052537739213123,1,6257.3,2363.58,6256.63,2363.07,304
301,6482,6633,2312,2419,151,107,11141,0,11141,1.0,0,6554.47,2369.11,6554.27,2368.37,305
302,7181,7350,2316,2485,169,169,17160,0,17160,1.0,0,7252.7,2391.95,7252.32,2391.51,307
303,6352,6449,2317,2415,97,98,5834,0,5834,1.0,0,6405.18,2365.93,6404.52,2365.57,306
304,8314,8410,2320,2428,96,108,7924,0,7924,1.0,0,8355.73,2375.59,8355.35,2375.02,308
305,6410,6680,2327,2570,270,243,32797,1012,31785,0.9691435192243193,1,6553.6,2461.32,6552.83,2460.28,310
306,9104,9186,2329,2382,82,53,2852,0,2852,1.0,0,9145.95,2354.74,9145.41,2354.2,309
307,9227,9392,2331,2480,165,149,13799,0,13799,1.0,0,9315.14,2397.84,9314.46,2397.38,311
308,7746,8096,2340,2504,350,164,34518,0,34518,1.0,0,7901.0,2415.24,7900.87,2414.77,312
309,8313,8553,2346,2460,240,114,16980,0,16980,1.0,0,8451.62,2409.1,8450.7,2408.71,313
310,7076,7190,2351,2534,114,183,14411,0,14411,1.0,0,7134.34,2434.82,7133.75,2434.48,314
311,6134,6217,2354,2501,83,147,8005,0,8005,1.0,0,6179.88,2432.0,6179.35,2431.33,315
312,6648,7055,2358,2552,407,194,44518,0,44518,1.0,0,6834.36,2457.12,6834.21,2456.51,316
313,7234,7517,2365,2557,283,192,35326,0,35326,1.0,0,7380.13,2469.79,7379.52,2469.22,317
314,9139,9219,2369,2509,80,140,6575,0,6575,1.0,0,9176.05,2434.47,9175.6,2434.1,318
315,6282,6364,2371,2438,82,67,3773,0,3773,1.0,0,6323.86,2406.06,6323.38,2405.52,319
316,11768,12596,2375,3266,828,891,455918,0,455918,1.0,0,12174.93,2856.11,12174.55,2855.32,320
317,9221,9273,2393,2437,52,44,1423,0,1423,1.0,0,9250.15,2417.75,9249.47,2417.18,321
318,8517,8634,2396,2530,117,134,10162,0,10162,1.0,0,8574.29,2461.36,8573.78,2460.89,322
319,6214,6310,2404,2501,96,97,5740,0,5740,1.0,0,6254.47,2448.59,6254.1,2448.11,323
320,6349,6412,2407,2454,63,47,2088,0,2088,1.0,0,6380.94,2431.27,6380.43,2430.67,324
321,6294,6467,2418,2569,173,151,12738,0,12738,1.0,0,6399.39,2496.93,6398.44,2496.48,326
322,9367,9468,2418,2540,101,122,4288,0,4288,1.0,0,9420.43,2482.2,9419.66,2481.33,325
323,7633,8115,2426,2744,482,318,101730,58,101672,0.9994298633638061,0,7882.37,2571.83,7881.47,2571.52,327
324,9192,9304,2427,2539,112,112,7588,0,7588,1.0,0,9247.42,2479.8,9246.88,2479.4,328
325,6952,7099,2428,2657,147,229,21317,0,21317,1.0,0,7023.32,2519.41,7022.73,2519.33,329
326,6084,6183,2435,2562,99,127,7513,0,7513,1.0,0,6129.52,2501.53,6129.32,2501.27,330
327,6292,6363,2437,2494,71,57,3126,126,3000,0.9596928982725528,1,6327.39,2465.61,6326.86,2465.13,331
328,8816,8930,2437,2558,114,121,7440,0,7440,1.0,0,8861.95,2497.56,8861.78,2497.15,332
329,5993,6088,2438,2523,95,85,4535,0,4535,1.0,0,6035.41,2476.26,6034.88,2476.05,333
330,7981,8314,2445,2890,333,445,76602,1722,74880,0.9775201691861831,1,8137.69,2685.36,8137.37,2684.68,334
331,8876,8928,2445,2484,52,39,1451,0,1451,1.0,0,8900.83,2464.54,8900.36,2464.12,335
332,9304,9439,2448,2577,135,129,8910,2022,6888,0.773063973063973,1,9366.77,2509.78,9366.37,2509.32,336
333,8239,8554,2454,2670,315,216,52262,896,51366,0.9828556121082239,2,8400.29,2553.32,8399.77,2552.86,337
334,7422,7655,2462,2728,233,266,41224,0,41224,1.0,0,7535.96,2592.78,7535.43,2592.28,338
335,8552,8786,2464,2714,234,250,35080,0,35080,1.0,0,8666.53,2577.0,8665.96,2576.62,339
336,7001,7308,2471,2712,307,241,42107,0,42107,1.0,0,7175.52,2596.18,7174.75,2595.7,340
337,6172,6251,2475,2569,79,94,4957,0,4957,1.0,0,6210.62,2522.98,6210.12,2522.47,341
338,6249,6297,2476,2531,48,55,1861,0,1861,1.0,0,6277.0,2503.0,6276.39,2502.53,342
339,8891,8948,2479,2526,57,47,1672,0,1672,1.0,0,8922.88,2500.06,8922.25,2499.58,344
340,13235,13428,2479,2843,193,364,45903,0,45903,1.0,0,13328.2,2662.63,13327.64,2661.53,343
341,8862,9262,2483,2969,400,486,101184,1108,100076,0.989049652118912,2,9065.7,2728.05,9065.33,2727.06,345
342,6007,6106,2486,2564,99,78,5020,0,5020,1.0,0,6060.27,2528.76,6059.65,2528.23,346
343,9246,9328,2489,2566,82,77,3203,0,3203,1.0,0,9290.22,2528.38,9289.61,2527.9,347
344,9177,9246,2505,2581,69,76,3308,0,3308,1.0,0,9210.9,2543.76,9210.32,2543.16,349
345,9030,9085,2506,2578,55,72,2501,0,2501,1.0,0,9057.6,2536.49,9057.11,2536.21,348
346,8769,8879,2512,2627,110,115,8028,0,8028,1.0,0,8822.32,2568.31,8821.93,2567.88,351
347,6185,6605,2513,2833,420,320,65271,5718,59553,0.9123960104793859,4,6404.48,2634.89,6403.57,2634.6,350
348,5893,6022,2517,2697,129,180,12884,1475,11409,0.8855169202111146,1,5958.93,2605.04,5958.53,2604.59,352
349,6735,6852,2519,2658,117,139,13334,0,13334,1.0,0,6797.66,2589.71,6797.12,2589.17,353
350,6851,6979,2520,2682,128,162,17500,0,17500,1.0,0,6914.64,2600.94,6914.12,2600.44,354
351,8859,9010,2525,2675,151,150,11607,0,11607,1.0,0,8921.63,2592.16,8921.32,2591.77,355
352,6597,6740,2527,2649,143,122,12520,0,12520,1.0,0,6670.41,2588.11,6669.89,2587.63,356
353,9288,9345,2530,2581,57,51,1575,0,1575,1.0,0,9317.78,2558.29,9317.19,2557.76,357
354,9066,9109,2531,2607,43,76,2129,0,2129,1.0,0,9089.71,2572.65,9089.18,2571.99,358
355,9162,9214,2539,2604,52,65,2034,68,1966,0.9665683382497542,0,9184.98,2577.48,9184.48,2576.64,359
356,9377,9521,2540,2719,144,179,17313,15,17298,0.999133599029631,0,9443.43,2622.14,9443.0,2621.8,360
357,9232,9299,2545,2626,67,81,3694,0,3694,1.0,0,9265.69,2588.78,9265.17,2588.29,361
358,6099,6204,2549,2632,105,83,4725,0,4725,1.0,0,6142.73,2585.88,6142.52,2585.5,362
359,7277,7446,2549,2734,169,185,21572,0,21572,1.0,0,7366.45,2636.79,7366.03,2636.4,363
360,8475,8591,2550,2725,116,175,11596,0,11596,1.0,0,8540.3,2645.74,8539.75,2645.11,364
361,5983,6116,2552,2725,133,173,14133,4581,9552,0.6758649968159627,1,6054.73,2647.8,6054.41,2646.91,365
362,5997,6072,2558,2610,75,52,2292,0,2292,1.0,0,6035.76,2582.76,6035.16,2582.32,366
363,9293,9386,2566,2652,93,86,5564,591,4973,0.8937814521926671,1,9344.32,2607.44,9343.73,2606.87,367
364,4123,4369,2569,2948,246,379,51672,1411,50261,0.9726931413531507,1,4249.36,2767.47,4249.17,2767.28,368
365,9205,9256,2581,2663,51,82,2656,0,2656,1.0,0,9228.52,2623.08,9228.1,2622.6,369
366,6150,6215,2591,2630,65,39,1514,0,1514,1.0,0,6180.66,2608.15,6180.26,2607.67,370
367,1294,1568,2597,2897,274,300,41387,0,41387,1.0,0,1443.42,2752.72,1443.11,2752.66,371
368,8629,8885,2599,2784,256,185,29278,0,29278,1.0,0,8766.66,2696.64,8766.08,2696.13,372
369,6167,6257,2603,2766,90,163,9695,216,9479,0.977720474471377,1,6209.23,2686.4,6208.69,2685.85,376
370,6217,6291,2604,2698,74,94,2649,0,2649,1.0,0,6262.11,2655.28,6260.66,2653.89,373
371,7619,7661,2605,2650,42,45,1179,0,1179,1.0,0,7640.9,2631.55,7640.33,2630.84,374
372,1480,1911,2608,3007,431,399,90294,0,90294,1.0,0,1689.19,2806.07,1688.76,2805.49,375
373,6114,6171,2609,2684,57,75,2849,0,2849,1.0,0,6142.21,2649.57,6141.78,2648.91,377
374,9250,9336,2619,2691,86,72,3701,0,3701,1.0,0,9297.55,2649.93,9296.92,2649.43,378
375,6543,6662,2622,2787,119,165,12329,0,12329,1.0,0,6601.87,2698.78,6601.4,2698.3,379
376,6626,6873,2623,2875,247,252,42542,0,42542,1.0,0,6742.59,2746.07,6742.14,2745.56,380
377,4349,4572,2632,2864,223,232,28553,155,28398,0.9945714986166078,0,4462.85,2750.32,4462.66,2749.23,381
378,9320,9433,2640,2767,113,127,8966,0,8966,1.0,0,9372.21,2706.62,9371.76,2706.13,382
379,7567,7790,2643,2777,223,134,16154,0,16154,1.0,0,7679.09,2718.06,7678.68,2717.38,383
380,6979,7152,2646,2794,173,148,20725,0,20725,1.0,0,7055.95,2724.3,7055.57,2723.78,384
381,8189,8362,2648,2868,173,220,25540,164,25376,0.9935787000783085,1,8270.65,2764.84,8270.2,2764.25,385
382,9233,9282,2651,2711,49,60,2102,0,2102,1.0,0,9257.44,2682.18,9256.94,2681.59,386
383,7103,7372,2654,2865,269,211,32407,0,32407,1.0,0,7231.69,2766.91,7231.26,2766.35,387
384,5831,5945,2656,2778,114,122,8299,14,8285,0.9983130497650319,0,5891.8,2723.41,5891.3,2722.72,388
385,3434,3958,2657,3069,524,412,85316,0,85316,1.0,0,3733.28,2828.01,3732.01,2827.67,389
386,6787,6991,2658,2879,204,221,27898,0,27898,1.0,0,6903.01,2780.51,6902.38,2780.01,390
387,7750,7990,2660,2885,240,225,33476,0,33476,1.0,0,7873.1,2771.18,7872.53,2770.75,391
388,8327,8527,2660,2852,200,192,27237,0,27237,1.0,0,8430.54,2746.29,8430.07,2745.88,392
389,6143,6183,2670,2723,40,53,1542,0,1542,1.0,0,6161.43,2699.52,6160.98,2698.85,393
390,6079,6144,2672,2742,65,70,2974,0,2974,1.0,0,6114.28,2709.43,6113.7,2708.83,395
391,9275,9326,2673,2738,51,65,2075,0,2075,1.0,0,9300.97,2705.31,9300.43,2704.85,394
392,9400,9559,2673,2828,159,155,16792,0,16792,1.0,0,9483.83,2759.2,9483.39,2758.68,396
393,6248,6313,2674,2735,65,61,2618,0,2618,1.0,0,6281.51,2706.63,6280.99,2706.06,397
394,5926,6023,2678,2785,97,107,7338,392,6946,0.9465794494412646,1,5977.97,2735.35,5977.42,2734.79,398
395,8523,8649,2687,2838,126,151,13140,6,13134,0.9995433789954338,0,8579.8,2763.9,8579.41,2763.36,399
396,13074,13426,2693,3014,352,321,37884,1237,36647,0.967347692957449,1,13229.71,2870.15,13229.36,2869.49,400
397,7277,7546,2696,2935,269,239,35879,0,35879,1.0,0,7415.83,2815.24,7415.39,2814.75,402
398,6457,6619,2697,2882,162,185,17743,0,17743,1.0,0,6530.38,2790.11,6530.02,2789.64,401
399,7517,7579,2700,2736,62,36,1448,0,1448,1.0,0,7550.47,2718.92,7549.82,2718.43,403
400,1782,2303,2703,3159,521,456,172033,0,172033,1.0,0,2045.36,2928.11,2045.04,2927.68,404
401,9237,9305,2706,2821,68,115,4753,0,4753,1.0,0,9272.56,2767.35,9272.08,2766.75,405
402,4297,4427,2711,2837,130,126,9063,0,9063,1.0,0,4351.97,2779.32,4351.73,2778.76,406
403,7440,7979,2713,3285,539,572,167281,0,167281,1.0,0,7692.29,3007.71,7691.79,3007.33,408
404,6012,6093,2714,2801,81,87,4862,0,4862,1.0,0,6053.16,2756.64,6052.82,2756.29,407
405,6114,6187,2716,2796,73,80,3897,0,3897,1.0,0,6151.04,2759.19,6150.42,2758.6,409
406,9295,9344,2722,2791,49,69,2315,0,2315,1.0,0,9319.68,2760.78,9319.23,2760.07,410
407,6232,6340,2729,2879,108,150,11434,1489,9945,0.8697743571803394,1,6285.58,2804.88,6285.05,2804.26,411
408,6078,6269,2730,3115,191,385,36384,1287,35097,0.964627308707124,1,6166.86,2911.51,6166.45,2911.2,412
409,6378,6461,2733,2824,83,91,5127,207,4920,0.9596255119953189,0,6418.3,2782.63,6417.86,2782.11,413
410,8803,8920,2733,2929,117,196,15879,0,15879,1.0,0,8861.12,2827.12,8860.57,2826.65,414
411,3793,4137,2735,3288,344,553,126077,630,125447,0.995003053689412,0,3969.66,3034.39,3969.56,3033.43,415
412,6085,6121,2742,2793,36,51,1328,0,1328,1.0,0,6103.02,2765.33,6102.48,2765.0,416
413,5899,5998,2751,2842,99,91,5290,1186,4104,0.7758034026465028,0,5945.6,2803.1,5944.97,2802.31,417
414,9336,9417,2751,2847,81,96,4910,0,4910,1.0,0,9376.01,2798.83,9375.65,2798.3,418
415,12938,13009,2754,2849,71,95,3489,0,3489,1.0,0,12975.44,2795.24,12975.01,2795.1,420
416,9180,9248,2755,2807,68,52,2073,0,2073,1.0,0,9214.3,2781.33,9213.79,2780.82,419
417,8598,8817,2757,2947,219,190,31389,0,31389,1.0,0,8719.8,2850.99,8719.14,2850.5,421
418,5840,5877,2770,2802,37,32,730,0,730,1.0,0,5855.5,2786.61,5855.27,2785.96,422
419,5822,5910,2774,2864,88,90,4040,10,4030,0.9975247524752475,0,5866.92,2816.13,5866.35,2815.73,423
420,5974,6044,2776,2859,70,83,3278,0,3278,1.0,0,6008.73,2821.03,6008.17,2820.43,424
421,6038,6098,2785,2849,60,64,2800,0,2800,1.0,0,6069.67,2816.89,6069.04,2816.34,425
422,6593,6680,2786,2892,87,106,6101,0,6101,1.0,0,6631.91,2846.2,6631.48,2845.51,426
423,6930,7148,2787,2992,218,205,28549,0,28549,1.0,0,7040.14,2883.64,7039.59,2883.21,427
424,9090,9417,2787,3048,327,261,35835,5140,30695,0.8565648109390261,1,9246.0,2921.99,9246.06,2921.77,428
425,9289,9366,2789,2881,77,92,4320,0,4320,1.0,0,9324.36,2830.78,9324.0,2830.62,429
426,8310,8490,2794,2975,180,181,21497,0,21497,1.0,0,8398.33,2887.6,8397.76,2887.05,430
427,9503,9543,2804,2858,40,54,1221,0,1221,1.0,0,9525.84,2826.8,9525.18,2826.53,431
428,12865,13152,2805,3227,287,422,81777,0,81777,1.0,0,13005.63,3024.16,13004.98,3023.56,432
429,7888,8010,2808,2912,122,104,6752,0,6752,1.0,0,7948.53,2855.17,7947.77,2854.92,433
430,6171,6526,2809,3061,355,252,36384,0,36384,1.0,0,6352.47,2911.29,6351.5,2911.19,434
431,9524,9568,2811,2876,44,65,1744,0,1744,1.0,0,9550.26,2846.54,9549.61,2845.93,435
432,9385,9441,2815,2884,56,69,2397,0,2397,1.0,0,9415.84,2851.37,9415.26,2850.72,436
433,4051,4501,2818,3377,450,559,123621,7801,115820,0.9368958348500659,2,4248.14,3087.6,4247.87,3086.84,437
434,8478,8684,2818,3007,206,189,24012,336,23676,0.9860069965017492,1,8574.5,2915.4,8574.06,2914.86,438
435,5854,5976,2820,2915,122,95,7351,2241,5110,0.6951435178887226,1,5914.36,2869.2,5913.79,2868.65,439
436,9394,9524,2822,2997,130,175,13029,1160,11869,0.9109678409701435,1,9458.34,2899.03,9457.73,2898.88,440
437,7097,7327,2833,3104,230,271,39731,2420,37311,0.9390903828244948,1,7213.86,2958.37,7213.28,2958.03,441
438,5988,6112,2834,2963,124,129,9254,0,9254,1.0,0,6051.08,2891.77,6050.76,2891.25,442
439,5773,5855,2839,2892,82,53,2305,0,2305,1.0,0,5815.84,2866.3,5815.19,2865.75,444
440,4113,4141,2840,2901,28,61,918,0,918,1.0,0,4125.3,2872.58,4124.89,2871.78,443
441,9323,9407,2842,2919,84,77,3384,0,3384,1.0,0,9364.72,2881.16,9364.27,2880.65,445
442,8813,8991,2855,2994,178,139,15250,0,15250,1.0,0,8911.0,2929.75,8910.38,2929.19,446
443,5707,5819,2856,3004,112,148,9326,3672,5654,0.6062620630495389,1,5765.13,2939.47,5764.49,2938.8,447
444,5936,6004,2856,2950,68,94,3937,0,3937,1.0,0,5974.92,2906.73,5974.39,2906.1,448
445,7907,8362,2858,3078,455,220,68425,0,68425,1.0,0,8128.4,2956.91,8127.9,2956.45,450
446,3220,3889,2859,3586,669,727,319637,0,319637,1.0,0,3552.0,3219.92,3551.59,3219.57,449
447,7136,7169,2863,2889,33,26,453,0,453,1.0,0,7150.68,2872.04,7150.35,2871.7,451
448,6636,6778,2864,3009,142,145,15167,1070,14097,0.9294520999538471,1,6706.82,2934.66,6706.28,2934.22,453
449,6505,6654,2865,2978,149,113,11938,1158,10780,0.9029988272742503,1,6579.53,2922.6,6579.05,2922.1,452
450,9516,9557,2866,2927,41,61,1445,0,1445,1.0,0,9533.17,2898.86,9532.86,2898.38,454
451,6718,6987,2867,3132,269,265,49384,0,49384,1.0,0,6856.61,2997.53,6856.08,2997.0,455
452,7313,7558,2868,3075,245,207,31727,0,31727,1.0,0,7442.95,2972.9,7442.35,2972.34,456
453,9540,9576,2870,2917,36,47,1031,0,1031,1.0,0,9557.5,2892.47,9557.05,2892.05,457
454,5801,5905,2872,3015,104,143,9777,0,9777,1.0,0,5850.42,2950.2,5849.89,2949.52,458
455,11336,11932,2874,3549,596,675,255942,0,255942,1.0,0,11595.71,3211.09,11595.28,3210.31,459
456,9277,9331,2878,2922,54,44,1981,482,1499,0.756688541140838,1,9302.88,2900.44,9302.43,2899.9,460
457,10866,11439,2878,3548,573,670,236017,0,236017,1.0,0,11144.76,3239.52,11144.18,3238.94,461
458,4068,4158,2885,2982,90,97,4635,0,4635,1.0,0,4109.72,2929.69,4109.25,2929.55,462
459,9354,9400,2895,2970,46,75,2284,0,2284,1.0,0,9378.34,2929.63,9377.95,2929.39,463
460,5874,5927,2909,2953,53,44,1258,0,1258,1.0,0,5899.89,2925.08,5899.4,2924.72,464
461,5903,5945,2914,2976,42,62,1812,0,1812,1.0,0,5925.54,2949.52,5925.01,2948.79,465
462,9490,9548,2917,2967,58,50,1688,0,1688,1.0,0,9517.27,2942.77,9516.88,2942.09,466
463,9532,9577,2920,2979,45,59,1637,0,1637,1.0,0,9554.66,2947.53,9554.13,2947.16,467
464,5913,6125,2925,3212,212,287,33175,1292,31883,0.9610550113036925,1,6013.26,3056.88,6012.79,3056.44,468
465,6441,6541,2925,3101,100,176,8897,0,8897,1.0,0,6492.42,2992.24,6491.93,2992.33,469
466,2249,2787,2926,3369,538,443,152509,0,152509,1.0,0,2488.68,3128.8,2488.39,3128.23,470
467,13084,13369,2926,3135,285,209,39241,0,39241,1.0,0,13232.22,3032.08,13231.7,3031.79,471
468,8417,8590,2929,3060,173,131,13421,0,13421,1.0,0,8495.39,3001.9,8494.92,3001.52,472
469,8857,9059,2934,3079,202,145,19868,0,19868,1.0,0,8969.77,3015.33,8969.11,3014.72,474
470,8638,8890,2935,3120,252,185,29897,0,29897,1.0,0,8757.44,3022.42,8756.98,3022.03,473
471,9049,9248,2936,3190,199,254,27488,489,26999,0.9822104190919674,0,9151.36,3050.75,9151.02,3050.39,476
472,9429,9565,2936,3119,136,183,13713,452,13261,0.9670385765332167,1,9502.15,3020.21,9501.56,3019.81,475
473,6047,6110,2937,3018,63,81,3175,0,3175,1.0,0,6076.58,2978.43,6076.21,2977.83,477
474,6285,6487,2947,3117,202,170,27084,0,27084,1.0,0,6384.96,3032.32,6384.45,3031.9,478
475,7078,7114,2949,2990,36,41,802,0,802,1.0,0,7099.17,2965.12,7098.51,2964.93,479
476,5688,5713,2958,3000,25,42,757,757,0,0.0,0,5701.31,2981.05,5700.79,2980.4,480
477,8322,8432,2961,3056,110,95,6835,0,6835,1.0,0,8383.25,3010.75,8382.54,3010.33,481
478,6917,7144,2963,3205,227,242,33275,2926,30349,0.9120661157024793,1,7034.0,3095.79,7033.53,3095.19,482
479,6515,6664,2967,3076,149,109,11204,2300,8904,0.7947161727954302,1,6580.12,3020.96,6579.83,3020.41,483
480,6971,7018,2968,3037,47,69,1595,0,1595,1.0,0,6991.93,3001.92,6991.42,3001.46,484
481,5862,5934,2972,3095,72,123,5907,440,5467,0.925512104283054,1,5900.85,3035.06,5900.35,3034.49,485
482,5718,5870,2978,3101,152,123,9982,1090,8892,0.8908034462031656,1,5782.06,3039.36,5781.84,3038.82,486
483,9208,9467,2984,3265,259,281,37911,0,37911,1.0,0,9316.71,3117.07,9316.24,3116.71,487
484,7285,7321,2985,3025,36,40,695,0,695,1.0,0,7307.05,3007.04,7306.09,3006.63,488
485,9411,9471,2990,3062,60,72,2676,0,2676,1.0,0,9439.84,3027.48,9439.42,3027.05,489
486,5632,5740,2999,3122,108,123,6849,29,6820,0.9957658052270404,0,5688.76,3055.91,5688.12,3055.58,490
487,8585,8704,3002,3126,119,124,8180,0,8180,1.0,0,8634.52,3064.47,8634.28,3064.11,491
488,6195,6323,3003,3210,128,207,14873,0,14873,1.0,0,6262.14,3101.96,6261.6,3101.53,492
489,6483,6766,3004,3223,283,219,38896,0,38896,1.0,0,6637.32,3119.47,6636.72,3118.9,493
490,7787,8723,3010,3891,936,881,469755,3087,466668,0.9934284893189003,0,8172.11,3387.88,8171.7,3387.42,494
491,12462,12590,3012,3118,128,106,6838,0,6838,1.0,0,12516.27,3071.24,12515.91,3070.59,495
492,7101,7552,3017,3420,451,403,115785,0,115785,1.0,0,7330.87,3212.6,7330.35,3212.16,496
493,9371,9411,3019,3074,40,55,1545,0,1545,1.0,0,9390.32,3043.8,9389.85,3043.43,497
494,8468,8531,3025,3076,63,51,2408,0,2408,1.0,0,8499.21,3050.2,8498.71,3049.73,498
495,9393,9445,3035,3089,52,54,1464,0,1464,1.0,0,9418.59,3062.93,9418.12,3062.39,499
496,5922,5948,3040,3088,26,48,895,0,895,1.0,0,5934.06,3065.89,5933.51,3065.21,500
497,5799,5878,3043,3117,79,74,4115,0,4115,1.0,0,5836.47,3078.86,5836.04,3078.47,501
498,2619,3429,3045,3682,810,637,305467,0,305467,1.0,0,2976.09,3344.48,2976.15,3344.1,502
499,8889,9128,3056,3278,239,222,29167,0,29167,1.0,0,9018.87,3146.61,9018.35,3146.28,503
500,9427,9507,3060,3126,80,66,2704,0,2704,1.0,0,9462.62,3090.89,9462.49,3090.74,504
501,9528,9582,3067,3136,54,69,2265,0,2265,1.0,0,9555.95,3107.58,9555.36,3106.81,505
502,7801,7956,3071,3204,155,133,11234,1038,10196,0.9076019227345559,0,7883.41,3137.61,7882.8,3137.19,506
503,5709,5821,3077,3192,112,115,6933,0,6933,1.0,0,5768.85,3133.16,5768.07,3132.47,507
504,8690,8960,3082,3368,270,286,52317,0,52317,1.0,0,8818.14,3215.74,8817.71,3215.32,508
505,5634,5747,3084,3228,113,144,9574,0,9574,1.0,0,5689.13,3161.98,5688.61,3161.42,509
506,6114,6251,3086,3221,137,135,12560,0,12560,1.0,0,6180.55,3157.18,6180.03,3156.68,510
507,5856,5912,3088,3132,56,44,1410,0,1410,1.0,0,5879.58,3107.38,5879.33,3106.92,511
508,12924,13411,3093,3481,487,388,93804,0,93804,1.0,0,13157.08,3271.44,13156.59,3270.94,512
509,5930,6143,3095,3393,213,298,31936,0,31936,1.0,0,6039.55,3256.62,6039.2,3255.83,513
510,5864,5932,3097,3161,68,64,2484,0,2484,1.0,0,5901.47,3132.87,5900.89,3132.22,514
511,1749,2313,3098,3643,564,545,209773,0,209773,1.0,0,2024.16,3371.77,2023.66,3371.45,515
512,6302,6495,3099,3213,193,114,17405,0,17405,1.0,0,6392.54,3156.5,6392.14,3155.98,516
513,6574,6967,3099,3366,393,267,52057,0,52057,1.0,0,6773.1,3233.19,6772.65,3232.57,517
514,1901,2009,3101,3164,108,63,3432,0,3432,1.0,0,1955.17,3134.27,1954.18,3134.05,518
515,5806,5864,3113,3161,58,48,1857,0,1857,1.0,0,5833.89,3136.86,5833.44,3136.39,519
516,9446,9718,3115,3380,272,265,33007,691,32316,0.9790650468082528,1,9561.84,3264.72,9561.72,3263.97,520
517,9504,9547,3116,3149,43,33,1045,0,1045,1.0,0,9523.65,3133.8,9523.26,3133.27,521
518,5847,6007,3133,3304,160,171,17767,1538,16229,0.9134350199808634,1,5920.16,3219.79,5919.63,3219.31,522
519,9539,9596,3134,3236,57,102,3694,0,3694,1.0,0,9563.62,3185.58,9563.21,3185.11,523
520,5800,5873,3136,3192,73,56,2198,0,2198,1.0,0,5839.67,3169.87,5839.24,3169.13,524
521,9075,9214,3137,3354,139,217,18420,23,18397,0.9987513572204126,0,9140.11,3230.08,9139.69,3229.87,525
522,9194,9483,3151,3406,289,255,33429,0,33429,1.0,0,9358.9,3290.91,9358.26,3290.36,526
523,6457,6575,3164,3295,118,131,9675,0,9675,1.0,0,6511.5,3228.02,6511.02,3227.63,527
524,5721,5760,3179,3227,39,48,1119,0,1119,1.0,0,5740.79,3203.86,5740.21,3203.34,529
525,5756,5803,3179,3225,47,46,1610,0,1610,1.0,0,5779.7,3202.29,5779.16,3201.78,528
526,6596,7283,3180,3596,687,416,141131,0,141131,1.0,0,6936.51,3382.52,6935.96,3382.29,530
527,9596,9684,3185,3254,88,69,4242,0,4242,1.0,0,9640.35,3218.31,9639.85,3217.73,531
528,5469,5560,3187,3289,91,102,4839,7,4832,0.9985534201281256,0,5513.27,3231.55,5512.7,3231.27,532
529,5686,5862,3190,3483,176,293,29610,0,29610,1.0,0,5774.19,3331.29,5773.54,3330.69,533
530,6305,6473,3190,3296,168,106,13777,0,13777,1.0,0,6392.27,3247.2,6391.81,3246.62,534
531,1417,1801,3191,3748,384,557,149813,0,149813,1.0,0,1611.38,3447.84,1610.85,3447.77,535
532,8594,8733,3200,3374,139,174,15669,0,15669,1.0,0,8655.83,3285.1,8655.43,3284.71,536
533,8829,9149,3201,3572,320,371,71340,0,71340,1.0,0,8974.28,3397.66,8973.89,3397.01,537
534,5491,5610,3204,3337,119,133,8733,876,7857,0.8996908278941944,1,5551.49,3278.57,5551.0,3277.91,538
535,6115,6310,3205,3361,195,156,25128,0,25128,1.0,0,6212.5,3280.52,6212.0,3280.05,539
536,5664,5731,3209,3243,67,34,1677,0,1677,1.0,0,5698.6,3225.71,5698.03,3225.24,540
537,7440,7892,3209,3677,452,468,114113,2128,111985,0.981351817934854,1,7688.24,3430.44,7687.65,3430.12,541
538,9161,9294,3210,3378,133,168,15687,205,15482,0.9869318544017339,1,9223.35,3292.96,9222.9,3292.47,542
539,6467,6665,3223,3438,198,215,24645,0,24645,1.0,0,6556.36,3344.57,6556.05,3343.87,543
540,5608,5730,3232,3331,122,99,6006,433,5573,0.927905427905428,1,5667.46,3279.47,5667.03,3279.12,544
541,5596,5643,3240,3281,47,41,1337,0,1337,1.0,0,5618.85,3260.27,5618.37,3259.78,545
542,5401,5477,3251,3321,76,70,3390,0,3390,1.0,0,5434.92,3280.74,5434.44,3280.36,546
543,3791,4418,3257,3915,627,658,252466,7499,244967,0.9702969904858476,3,4105.76,3564.65,4105.45,3563.78,547
544,5730,5758,3270,3304,28,34,761,0,761,1.0,0,5744.12,3286.6,5743.62,3286.13,548
545,5401,5503,3274,3437,102,163,10371,0,10371,1.0,0,5451.51,3356.63,5451.0,3356.06,549
546,6214,6475,3286,3497,261,211,37952,0,37952,1.0,0,6355.39,3386.03,6354.8,3385.64,550
547,9348,9550,3288,3505,202,217,23147,0,23147,1.0,0,9447.38,3395.26,9446.99,3394.76,553
548,5653,5708,3289,3344,55,55,1946,0,1946,1.0,0,5680.79,3315.88,5680.26,3315.41,551
549,5794,5959,3289,3465,165,176,17864,1477,16387,0.917319749216301,1,5876.47,3380.86,5875.93,3380.46,552
550,5493,5716,3291,3469,223,178,25132,0,25132,1.0,0,5601.59,3387.06,5601.24,3386.53,555
551,2097,2764,3293,3774,667,481,186921,0,186921,1.0,0,2435.78,3536.46,2435.16,3536.26,554
552,9541,9728,3299,3436,187,137,13574,1883,11691,0.8612789155738912,1,9642.46,3379.49,9641.78,3378.99,556
553,6009,6244,3315,3475,235,160,26343,0,26343,1.0,0,6120.74,3400.5,6120.26,3399.93,557
554,8671,8843,3317,3520,172,203,20468,0,20468,1.0,0,8764.94,3413.41,8764.37,3413.0,558
555,9461,9869,3333,3546,408,213,34149,0,34149,1.0,0,9661.92,3443.07,9661.64,3442.62,559
556,9026,9267,3353,3675,241,322,44715,0,44715,1.0,0,9149.13,3522.08,9148.61,3521.51,560
557,8518,8829,3354,3644,311,290,56608,1892,54716,0.9665771622385528,1,8659.59,3519.2,8659.16,3518.59,561
558,5320,5435,3369,3537,115,168,12067,0,12067,1.0,0,5375.91,3461.0,5375.47,3460.4,562
559,7117,7655,3369,3829,538,460,145489,0,145489,1.0,0,7385.94,3588.74,7385.4,3588.25,563
560,11721,11991,3378,3582,270,204,22629,0,22629,1.0,0,11839.72,3487.76,11839.8,3487.54,564
561,5430,5543,3389,3496,113,107,7333,0,7333,1.0,0,5483.41,3452.87,5482.9,3452.32,566
562,5913,6055,3389,3565,142,176,16055,0,16055,1.0,0,5974.8,3471.22,5974.37,3470.82,565
563,10797,12551,3395,4123,1754,728,803965,1205,802760,0.9985011785338914,1,11681.62,3758.46,11679.97,3757.79,567
564,6350,6613,3397,3671,263,274,46551,0,46551,1.0,0,6478.51,3542.94,6477.99,3542.36,568
565,9838,9967,3400,3600,129,200,15888,0,15888,1.0,0,9901.38,3498.15,9900.9,3497.81,569
566,9221,9409,3405,3563,188,158,20591,0,20591,1.0,0,9316.5,3472.45,9316.03,3472.08,570
567,6562,6622,3407,3495,60,88,2925,0,2925,1.0,0,6593.16,3449.69,6592.76,3449.21,571
568,12957,13292,3413,3851,335,438,61743,0,61743,1.0,0,13094.02,3600.5,13093.65,3600.37,572
569,6743,7602,3421,4390,859,969,384310,4973,379337,0.9870599255809113,1,7110.6,3875.39,7110.01,3875.36,573
570,5467,5629,3435,3650,162,215,19964,24,19940,0.998797836104989,0,5554.55,3550.77,5554.11,3550.14,574
571,9732,9851,3438,3531,119,93,7099,0,7099,1.0,0,9789.77,3485.3,9789.53,3484.93,575
572,5598,5750,3448,3642,152,194,19788,0,19788,1.0,0,5674.17,3535.03,5673.67,3534.68,576
573,5838,5919,3449,3597,81,148,8288,26,8262,0.9968629343629344,0,5886.97,3514.51,5886.35,3514.12,577
574,5736,5869,3454,3591,133,137,13625,0,13625,1.0,0,5804.76,3525.3,5804.25,3524.76,578
575,6197,6362,3465,3644,165,179,24011,0,24011,1.0,0,6280.25,3551.8,6279.71,3551.38,579
576,5905,6208,3469,3680,303,211,44913,759,44154,0.9831006612784717,0,6078.77,3573.87,6078.07,3573.41,580
577,9630,9819,3470,3625,189,155,14665,165,14500,0.9887487214456189,0,9728.17,3543.32,9727.57,3542.89,581
578,3576,3959,3478,3815,383,337,75442,0,75442,1.0,0,3780.83,3653.11,3780.39,3652.56,582
579,5358,5519,3484,3677,161,193,15351,5,15346,0.9996742883199792,0,5433.08,3571.94,5432.56,3571.72,583
580,8183,8561,3487,3844,378,357,95204,0,95204,1.0,0,8373.11,3661.66,8372.54,3661.09,584
581,2555,3941,3489,4255,1386,766,674877,0,674877,1.0,0,3175.17,3866.36,3175.06,3866.06,585
582,9348,9531,3500,3686,183,186,24535,755,23780,0.969227633992256,1,9438.9,3593.23,9438.34,3592.73,586
583,9516,9649,3502,3623,133,121,11368,90,11278,0.9920830401125967,0,9585.48,3564.62,9584.93,3564.07,587
584,8807,8933,3504,3737,126,233,18494,0,18494,1.0,0,8864.6,3620.72,8864.04,3620.12,588
585,9803,9914,3519,3645,111,126,6660,0,6660,1.0,0,9845.4,3581.73,9845.22,3581.27,589
586,5223,5407,3525,3694,184,169,16868,0,16868,1.0,0,5317.02,3613.14,5316.57,3612.54,590
587,9234,9359,3526,3661,125,135,10883,0,10883,1.0,0,9297.49,3594.11,9296.93,3593.6,591
588,5269,5333,3528,3574,64,46,1637,0,1637,1.0,0,5302.01,3551.19,5301.44,3550.71,592
589,6464,6810,3536,3837,346,301,63335,1819,61516,0.9712797031657062,0,6639.06,3684.1,6638.38,3683.88,594
590,8906,9097,3547,3808,191,261,31175,0,31175,1.0,0,8991.98,3664.54,8991.61,3664.23,595
591,9645,9748,3556,3651,103,95,6201,0,6201,1.0,0,9704.81,3602.08,9704.05,3601.49,596
592,5688,5920,3566,3700,232,134,19470,1542,17928,0.9208012326656394,0,5794.88,3632.56,5794.42,3632.07,597
593,1200,2247,3587,4334,1047,747,359154,0,359154,1.0,0,1757.65,3922.98,1756.48,3922.34,598
594,9624,9690,3590,3667,66,77,3171,0,3171,1.0,0,9655.12,3630.94,9654.67,3630.39,599
595,9803,9936,3598,3765,133,167,10476,1530,8946,0.8539518900343642,1,9877.2,3683.68,9876.71,3682.78,600
596,9727,9831,3602,3694,104,92,5894,0,5894,1.0,0,9785.9,3649.32,9785.31,3648.71,601
597,5135,5388,3604,3846,253,242,31972,0,31972,1.0,0,5247.68,3722.26,5247.36,3721.81,602
598,9139,9295,3604,3774,156,170,16919,0,16919,1.0,0,9221.92,3692.33,9221.36,3691.72,603
599,5444,5554,3607,3708,110,101,7827,176,7651,0.9775137345087518,1,5498.36,3658.47,5497.86,3657.96,604
600,9476,9662,3607,3778,186,171,22031,391,21640,0.9822522808769462,0,9573.29,3693.42,9572.71,3692.83,605
601,5536,5724,3615,3803,188,188,23999,1398,22601,0.941747572815534,1,5626.64,3706.79,5626.19,3706.32,606
602,6190,6499,3615,3817,309,202,39170,0,39170,1.0,0,6358.94,3730.6,6358.26,3730.04,607
603,8774,8819,3617,3660,45,43,1327,0,1327,1.0,0,8797.27,3634.44,8796.77,3634.1,608
604,6136,6270,3618,3759,134,141,13526,0,13526,1.0,0,6207.64,3687.04,6207.06,3686.54,609
605,8710,8870,3619,3806,160,187,15013,0,15013,1.0,0,8782.67,3712.35,8782.2,3711.74,610
606,8463,8758,3624,3986,295,362,58305,0,58305,1.0,0,8616.54,3779.8,8616.39,3780.04,611
607,9258,9408,3631,3815,150,184,17871,0,17871,1.0,0,9334.65,3728.35,9334.14,3727.78,612
608,7492,7857,3633,4003,365,370,93128,0,93128,1.0,0,7683.94,3825.91,7683.21,3825.52,613
609,1266,1718,3639,3903,452,264,68726,0,68726,1.0,0,1464.46,3772.9,1465.06,3772.47,614
610,5899,6177,3644,3911,278,267,50607,560,50047,0.988934337147035,0,6030.46,3763.16,6030.04,3762.77,615
611,9654,9751,3647,3731,97,84,5364,0,5364,1.0,0,9702.59,3686.88,9702.1,3686.36,616
612,9019,9189,3658,3847,170,189,21083,0,21083,1.0,0,9100.24,3762.72,9099.82,3762.08,617
613,5370,5478,3664,3764,108,100,7586,0,7586,1.0,0,5421.27,3712.27,5420.89,3711.8,618
614,5653,5912,3666,3917,259,251,43386,9,43377,0.999792559811921,0,5790.7,3786.94,5790.13,3786.51,619
615,9676,9803,3679,3771,127,92,5352,0,5352,1.0,0,9741.53,3727.5,9740.98,3726.92,620
616,9372,9532,3683,3866,160,183,20828,0,20828,1.0,0,9451.99,3775.91,9451.48,3775.41,621
617,9788,9851,3695,3774,63,79,3923,0,3923,1.0,0,9821.3,3732.92,9820.77,3732.47,622
618,5445,5578,3703,3845,133,142,12577,0,12577,1.0,0,5510.5,3772.4,5510.04,3771.97,623
619,9591,9693,3707,3835,102,128,5572,2782,2790,0.5007178750897344,1,9641.4,3777.2,9641.12,3776.32,624
620,2107,2590,3725,4163,483,438,130645,0,130645,1.0,0,2380.2,3938.6,2379.68,3938.21,625
621,9650,9809,3725,3843,159,118,9439,47,9392,0.995020658968111,0,9732.25,3789.9,9731.61,3789.33,626
622,8804,9032,3728,3936,228,208,28474,0,28474,1.0,0,8902.26,3828.98,8901.92,3828.51,627
623,2465,2599,3738,3829,134,91,6120,0,6120,1.0,0,2539.45,3777.28,2538.64,3777.05,628
624,5347,5461,3746,3861,114,115,8813,0,8813,1.0,0,5400.25,3801.36,5399.82,3800.92,629
625,6109,6238,3756,3930,129,174,13892,0,13892,1.0,0,6178.98,3856.92,6178.41,3856.15,630
626,9759,9889,3758,3868,130,110,6406,0,6406,1.0,0,9823.74,3808.53,9823.26,3808.12,631
627,6464,6801,3764,4166,337,402,97313,3530,93783,0.9637252987781694,0,6633.18,3963.17,6632.74,3962.47,632
628,9123,9293,3769,3920,170,151,16665,0,16665,1.0,0,9210.26,3841.43,9209.69,3840.95,633
629,8679,8834,3772,3959,155,187,18245,0,18245,1.0,0,8749.78,3860.22,8749.4,3859.9,634
630,9517,9613,3777,3849,96,72,4941,0,4941,1.0,0,9564.41,3811.99,9563.96,3811.6,635
631,5249,5418,3781,3937,169,156,13783,0,13783,1.0,0,5330.86,3855.26,5330.57,3854.99,636
632,7927,8355,3783,4092,428,309,89796,0,89796,1.0,0,8155.09,3950.74,8154.47,3950.21,637
633,5533,5704,3791,3963,171,172,19948,0,19948,1.0,0,5613.92,3877.65,5613.47,3877.11,638
634,9259,9517,3792,4022,258,230,30856,974,29882,0.9684340160746694,1,9382.83,3904.54,9382.51,3903.96,639
635,6212,6500,3795,3971,288,176,31375,0,31375,1.0,0,6355.08,3873.63,6354.58,3873.0,640
636,5809,6047,3797,4053,238,256,34594,0,34594,1.0,0,5923.64,3929.53,5923.19,3928.95,641
637,5188,5249,3811,3877,61,66,2060,0,2060,1.0,0,5218.06,3840.68,5217.5,3840.32,642
638,5411,5546,3811,3945,135,134,12403,0,12403,1.0,0,5477.0,3882.11,5476.47,3881.54,643
639,8327,8553,3812,4029,226,217,32886,0,32886,1.0,0,8434.54,3913.43,8434.0,3912.88,644
640,8365,8434,3815,3850,69,35,1306,0,1306,1.0,0,8399.31,3830.9,8398.88,3830.33,645
641,9496,9656,3820,3943,160,123,11008,0,11008,1.0,0,9576.93,3876.99,9576.17,3876.29,646
642,9648,9804,3822,3907,156,85,7723,0,7723,1.0,0,9716.25,3860.2,9716.01,3859.81,647
643,3783,4299,3835,4210,516,375,125046,88,124958,0.9992962589766966,0,4042.62,4018.59,4042.33,4018.24,648
644,5159,5297,3837,4034,138,197,13999,30,13969,0.9978569897849846,0,5240.14,3936.02,5239.49,3935.32,650
645,9011,9175,3837,4040,164,203,25142,0,25142,1.0,0,9087.29,3936.06,9086.81,3935.6,649
646,7716,8043,3861,4107,327,246,36195,0,36195,1.0,0,7868.18,3981.72,7867.9,3980.93,651
647,8886,9026,3868,4039,140,171,16341,0,16341,1.0,0,8963.07,3953.51,8962.49,3953.03,652
648,5279,5399,3882,3978,120,96,7422,0,7422,1.0,0,5334.04,3935.75,5333.57,3935.14,653
649,5595,5753,3884,4292,158,408,34714,0,34714,1.0,0,5670.58,4075.45,5670.05,4075.59,654
650,5957,6196,3885,4148,239,263,39304,0,39304,1.0,0,6083.46,4024.35,6082.91,4023.82,655
651,9550,9697,3887,4028,147,141,10032,0,10032,1.0,0,9615.72,3952.01,9615.41,3951.53,656
652,9113,9426,3888,4302,313,414,69065,0,69065,1.0,0,9243.5,4091.18,9243.14,4090.75,657
653,9327,9563,3892,4196,236,304,25805,1745,24060,0.9323774462313505,2,9448.46,4049.83,9447.99,4049.43,658
654,6155,6342,3895,4100,187,205,22685,0,22685,1.0,0,6251.3,3998.97,6250.76,3998.34,659
655,8446,8740,3904,4184,294,280,38833,0,38833,1.0,0,8567.02,4026.67,8566.83,4026.2,660
656,6420,6469,3905,3971,49,66,1863,0,1863,1.0,0,6450.47,3936.36,6449.86,3935.99,661
657,5726,5856,3908,4043,130,135,11162,0,11162,1.0,0,5783.43,3977.1,5783.06,3976.64,662
658,5281,5572,3910,4152,291,242,34630,1229,33401,0.9645105399942246,1,5424.82,4016.62,5424.53,4016.13,664
659,8717,8943,3910,4147,226,237,31646,0,31646,1.0,0,8821.5,4025.99,8821.11,4025.54,663
660,11335,11442,3916,3985,107,69,3022,0,3022,1.0,0,11386.48,3943.98,11386.81,3944.2,665
661,6729,7002,3933,4167,273,234,42815,0,42815,1.0,0,6863.22,4049.31,6862.67,4048.91,666
662,6319,6522,3934,4210,203,276,32113,0,32113,1.0,0,6411.7,4060.1,6411.36,4059.88,667
663,1569,2361,3939,4598,792,659,301647,0,301647,1.0,0,1986.1,4279.25,1985.54,4278.81,668
664,10965,11643,3946,4713,678,767,313820,0,313820,1.0,0,11326.62,4270.95,11326.19,4270.75,669
665,5468,5628,3947,4170,160,223,19441,788,18653,0.9594671056015637,1,5555.51,4062.41,5554.61,4062.18,670
666,7273,8021,3985,4496,748,511,219082,0,219082,1.0,0,7629.68,4226.57,7629.46,4225.85,671
667,9492,9592,3991,4122,100,131,8518,0,8518,1.0,0,9540.77,4053.37,9540.29,4052.93,672
668,5786,5919,4006,4136,133,130,12470,0,12470,1.0,0,5853.47,4072.76,5853.01,4072.24,674
669,8945,9065,4006,4129,120,123,10139,0,10139,1.0,0,9005.14,4070.09,9004.69,4069.52,675
670,8193,8479,4013,4240,286,227,39055,0,39055,1.0,0,8347.28,4123.37,8346.69,4122.85,676
671,8545,8748,4018,4203,203,185,22099,0,22099,1.0,0,8651.42,4108.77,8650.83,4108.37,677
672,9031,9167,4026,4169,136,143,13705,0,13705,1.0,0,9102.62,4100.35,9102.06,4099.85,678
673,5690,5947,4035,4438,257,403,40256,1128,39128,0.9719793322734499,1,5825.8,4217.03,5825.53,4217.13,679
674,8817,8974,4039,4208,157,169,14934,0,14934,1.0,0,8900.68,4135.63,8900.17,4134.92,680
675,3325,3808,4042,4645,483,603,189789,0,189789,1.0,0,3588.61,4373.44,3587.98,4372.66,681
676,5891,6038,4049,4235,147,186,19395,0,19395,1.0,0,5961.31,4152.72,5960.77,4152.0,682
677,8245,8291,4054,4086,46,32,939,0,939,1.0,0,8265.3,4069.18,8264.98,4068.67,683
678,7989,8249,4058,4311,260,253,44139,0,44139,1.0,0,8111.08,4178.71,8110.61,4178.28,684
679,6099,6293,4063,4301,194,238,29337,0,29337,1.0,0,6199.33,4180.16,6198.8,4179.7,685
680,2838,3425,4068,4695,587,627,260353,914,259439,0.9964893817240439,1,3118.0,4381.82,3117.45,4381.24,686
681,6266,6405,4082,4250,139,168,13702,0,13702,1.0,0,6331.03,4168.68,6330.59,4168.11,687
682,6443,6637,4084,4313,194,229,23940,1216,22724,0.9492063492063492,0,6531.85,4206.18,6531.37,4205.6,688
683,3728,3885,4098,4231,157,133,11556,0,11556,1.0,0,3803.58,4161.65,3802.89,4161.0,689
684,9503,9545,4105,4175,42,70,2087,0,2087,1.0,0,9523.24,4139.84,9522.7,4139.36,690
685,8649,8857,4106,4302,208,196,26590,0,26590,1.0,0,8756.74,4214.66,8756.19,4214.02,691
686,9427,9482,4110,4160,55,50,1560,583,977,0.6262820512820513,1,9456.35,4132.3,9455.76,4131.94,692
687,1754,2877,4111,4847,1123,736,451940,496,451444,0.9989025091826349,1,2382.59,4509.67,2381.89,4509.2,693
688,3744,4135,4118,4715,391,597,138364,0,138364,1.0,0,3946.02,4397.52,3945.52,4396.82,694
689,5496,5621,4121,4261,125,140,10047,0,10047,1.0,0,5565.62,4183.48,5564.99,4183.06,695
690,8864,9154,4125,4524,290,399,61675,1229,60446,0.9800729631130928,1,9030.2,4313.73,9029.71,4313.56,697
691,6589,6878,4126,4354,289,228,35445,651,34794,0.9816335167160389,0,6742.81,4230.73,6742.53,4230.25,696
692,9437,9516,4128,4326,79,198,8901,0,8901,1.0,0,9475.43,4227.07,9474.96,4226.65,699
693,9406,9462,4129,4192,56,63,2332,0,2332,1.0,0,9432.22,4160.87,9431.8,4160.37,698
694,6010,6137,4138,4305,127,167,13683,0,13683,1.0,0,6073.49,4223.49,6073.0,4223.0,700
695,8498,8661,4158,4302,163,144,15965,0,15965,1.0,0,8575.53,4230.84,8575.05,4230.31,701
696,8380,8503,4159,4297,123,138,10936,0,10936,1.0,0,8440.58,4223.53,8440.11,4223.12,702
697,9343,9406,4162,4211,63,49,1808,0,1808,1.0,0,9372.92,4185.42,9372.55,4184.87,703
698,9365,9456,4167,4328,91,161,8735,0,8735,1.0,0,9412.02,4249.71,9411.52,4249.19,704
699,6855,7307,4169,4535,452,366,106305,1418,104887,0.9866610225295142,0,7093.44,4348.59,7092.92,4348.16,705
700,9500,9554,4171,4231,54,60,1748,0,1748,1.0,0,9524.62,4200.01,9524.18,4199.58,706
701,5677,5788,4183,4395,111,212,13597,0,13597,1.0,0,5730.71,4280.4,5730.06,4280.14,707
702,8852,8965,4194,4292,113,98,6379,0,6379,1.0,0,8917.09,4239.45,8916.41,4238.97,708
703,9303,9384,4196,4292,81,96,5019,1224,3795,0.7561267184698147,1,9345.02,4249.2,9344.44,4248.56,709
704,8158,8486,4197,4418,328,221,44364,0,44364,1.0,0,8301.63,4315.15,8301.51,4314.79,710
705,7797,8009,4198,4433,212,235,23799,1146,22653,0.9518467162485819,1,7917.16,4316.14,7916.47,4315.66,711
706,6362,6518,4205,4411,156,206,23501,0,23501,1.0,0,6436.3,4308.96,6435.76,4308.46,712
707,9288,9318,4209,4242,30,33,752,0,752,1.0,0,9302.98,4224.92,9302.47,4224.44,713
708,5535,5641,4222,4415,106,193,11621,0,11621,1.0,0,5585.02,4325.42,5584.47,4324.98,714
709,6205,6372,4223,4412,167,189,21806,0,21806,1.0,0,6297.68,4316.17,6297.1,4315.69,715
710,5897,6057,4229,4396,160,167,16336,2717,13619,0.8336802154750245,1,5967.39,4303.52,5966.99,4303.14,716
711,8832,8925,4234,4311,93,77,4296,0,4296,1.0,0,8873.57,4277.4,8873.22,4276.85,717
712,9250,9303,4234,4310,53,76,2814,0,2814,1.0,0,9274.72,4272.13,9274.55,4271.68,718
713,8415,8588,4237,4421,173,184,17505,474,17031,0.9729220222793488,1,8506.94,4331.51,8506.42,4331.0,719
714,9209,9255,4247,4331,46,84,2933,0,2933,1.0,0,9232.37,4286.99,9231.87,4286.6,720
715,8431,8871,4248,4674,440,426,78440,2933,75507,0.9626083630800611,0,8642.96,4476.15,8643.06,4476.18,721
716,5624,5710,4250,4326,86,76,3992,0,3992,1.0,0,5665.72,4288.2,5665.24,4287.98,722
717,9285,9313,4253,4293,28,40,647,0,647,1.0,0,9299.67,4272.54,9299.17,4272.09,723
718,6101,6223,4258,4399,122,141,10340,0,10340,1.0,0,6160.34,4332.42,6159.82,4331.83,724
719,5775,5803,4262,4309,28,47,808,0,808,1.0,0,5787.91,4290.84,5787.44,4289.8,725
720,6551,6721,4265,4456,170,191,16336,0,16336,1.0,0,6637.0,4362.14,6636.47,4361.56,726
721,9300,9343,4272,4326,43,54,1493,0,1493,1.0,0,9319.38,4301.41,9318.92,4300.72,727
722,8725,8930,4282,4554,205,272,32765,0,32765,1.0,0,8813.44,4412.25,8813.09,4411.79,728
723,7847,8218,4290,4683,371,393,86932,1939,84993,0.9776952100492339,1,8043.68,4475.04,8043.2,4474.71,729
724,9110,9215,4290,4418,105,128,6746,0,6746,1.0,0,9155.86,4339.31,9155.46,4339.15,730
725,9298,9421,4290,4391,123,101,7428,0,7428,1.0,0,9357.62,4340.31,9357.22,4339.88,731
726,6510,6619,4292,4394,109,102,6822,0,6822,1.0,0,6561.1,4335.27,6560.68,4334.91,732
727,5926,6187,4295,4676,261,381,50229,586,49643,0.9883334328774214,1,6056.72,4477.77,6055.75,4477.59,733
728,6669,6859,4295,4464,190,169,19299,0,19299,1.0,0,6756.62,4380.53,6756.33,4380.06,734
729,7987,8024,4295,4340,37,45,1152,0,1152,1.0,0,8003.57,4318.18,8003.13,4317.65,735
730,5759,5859,4296,4408,100,112,7084,0,7084,1.0,0,5806.92,4346.63,5806.27,4346.35,736
731,9228,9321,4297,4442,93,145,7642,0,7642,1.0,0,9273.71,4374.68,9273.14,4374.0,737
732,5633,5695,4306,4355,62,49,2262,0,2262,1.0,0,5662.81,4331.71,5662.36,4331.18,738
733,9158,9254,4309,4431,96,122,6499,0,6499,1.0,0,9208.03,4374.75,9207.4,4374.25,739
734,9404,9479,4315,4393,75,78,3403,141,3262,0.9585659712018807,1,9439.84,4350.83,9439.23,4350.37,740
735,7239,7411,4317,4486,172,169,11398,0,11398,1.0,0,7320.34,4389.16,7319.6,4389.16,741
736,13404,13787,4343,4743,383,400,85219,1207,84012,0.9858364918621434,1,13587.53,4520.5,13587.22,4520.34,742
737,5624,5711,4344,4412,87,68,3481,0,3481,1.0,0,5666.33,4379.44,5665.94,4379.05,743
738,6178,6321,4360,4539,143,179,18687,0,18687,1.0,0,6244.22,4452.48,6243.75,4451.88,744
739,9308,9416,4366,4457,108,91,4738,0,4738,1.0,0,9354.68,4404.27,9354.42,4403.88,745
740,5943,6017,4367,4475,74,108,4599,0,4599,1.0,0,5988.75,4416.64,5988.1,4416.22,747
741,6444,6590,4367,4539,146,172,16866,0,16866,1.0,0,6514.43,4454.42,6513.94,4453.85,748
742,5710,5767,4368,4407,57,39,1664,0,1664,1.0,0,5742.71,4388.39,5741.85,4388.03,746
743,8427,8544,4372,4464,117,92,5675,0,5675,1.0,0,8493.89,4422.7,8493.08,4421.93,749
744,5550,5657,4373,4554,107,181,11280,3433,7847,0.6956560283687944,1,5599.15,4467.66,5598.4,4466.99,751
745,7666,7882,4373,4571,216,198,26127,0,26127,1.0,0,7772.84,4460.36,7772.22,4460.03,750
746,5770,5886,4375,4486,116,111,7767,997,6770,0.8716364104544869,0,5830.09,4425.19,5829.52,4424.72,752
747,7221,7564,4380,4747,343,367,71269,0,71269,1.0,0,7370.57,4553.06,7370.05,4552.68,754
748,6293,6475,4381,4589,182,208,26324,0,26324,1.0,0,6384.24,4490.29,6383.7,4489.78,753
749,6549,6957,4391,4618,408,227,53481,0,53481,1.0,0,6742.96,4514.2,6742.77,4513.62,756
750,8163,8304,4391,4635,141,244,23180,0,23180,1.0,0,8230.47,4500.46,8229.93,4500.15,757
751,9334,9424,4392,4495,90,103,4438,816,3622,0.8161333934204597,1,9380.69,4442.83,9380.19,4442.32,758
752,8903,9038,4395,4501,135,106,8095,302,7793,0.9626930203829525,1,8968.82,4449.93,8968.28,4449.42,759
753,5629,5713,4400,4450,84,50,3055,0,3055,1.0,0,5671.42,4422.59,5670.9,4422.11,760
754,5900,5979,4401,4514,79,113,3967,0,3967,1.0,0,5937.17,4457.19,5936.73,4456.52,762
755,5712,5777,4402,4440,65,38,1605,0,1605,1.0,0,5746.38,4419.65,5745.69,4419.13,761
756,8289,8472,4403,4538,183,135,19915,0,19915,1.0,0,8374.71,4470.95,8374.28,4470.47,763
757,9179,9234,4409,4464,55,55,1621,0,1621,1.0,0,9204.18,4434.42,9203.72,4434.05,764
758,9141,9183,4413,4484,42,71,2010,0,2010,1.0,0,9159.67,4449.04,9159.24,4448.52,765
759,5693,5815,4415,4695,122,280,14022,0,14022,1.0,0,5750.54,4557.82,5750.13,4557.4,766
760,9195,9335,4421,4574,140,153,11631,0,11631,1.0,0,9267.06,4497.5,9266.57,4497.02,767
761,5746,5811,4428,4498,65,70,3133,0,3133,1.0,0,5775.92,4465.15,5775.48,4464.61,768
762,4040,4347,4429,4780,307,351,68146,0,68146,1.0,0,4189.08,4603.08,4188.77,4602.5,769
763,9027,9076,4431,4476,49,45,1439,184,1255,0.872133425990271,1,9050.67,4455.04,9050.15,4454.41,770
764,7058,7262,4432,4595,204,163,20900,1724,19176,0.9175119617224881,1,7160.51,4517.27,7160.02,4516.68,771
765,4134,4198,4434,4479,64,45,1978,0,1978,1.0,0,4166.22,4453.62,4165.65,4453.41,772
766,5844,5926,4435,4538,82,103,4041,995,3046,0.7537738183617916,0,5892.65,4484.89,5891.94,4484.67,773
767,9196,9272,4435,4481,76,46,1948,0,1948,1.0,0,9231.65,4456.13,9231.25,4455.66,774
768,5649,5712,4441,4509,63,68,3191,0,3191,1.0,0,5678.39,4478.37,5677.96,4477.67,775
769,8831,8932,4454,4570,101,116,6824,0,6824,1.0,0,8886.92,4513.0,8886.28,4512.91,776
770,10896,11359,4457,5036,463,579,187988,0,187988,1.0,0,11126.67,4741.06,11126.02,4740.4,777
771,9151,9213,4462,4523,62,61,2623,0,2623,1.0,0,9181.58,4492.73,9181.13,4492.26,778
772,7629,7669,4467,4500,40,33,764,0,764,1.0,0,7653.33,4486.88,7652.62,4486.15,779
773,9321,9377,4468,4568,56,100,3570,0,3570,1.0,0,9347.66,4519.89,9347.09,4519.31,780
774,8983,9108,4472,4604,125,132,10427,0,10427,1.0,0,9041.52,4533.93,9041.13,4533.58,781
775,1144,1832,4477,4936,688,459,186562,0,186562,1.0,0,1497.19,4695.33,1496.49,4694.85,782
776,5803,5887,4479,4545,84,66,3742,798,2944,0.7867450561197221,1,5849.15,4507.77,5848.43,4507.28,783
777,7496,7777,4488,4771,281,283,52573,0,52573,1.0,0,7624.32,4632.44,7623.94,4631.98,784
778,8906,9013,4489,4627,107,138,8606,0,8606,1.0,0,8957.05,4556.59,8956.46,4556.18,785
779,5764,5812,4490,4531,48,41,1384,0,1384,1.0,0,5787.07,4509.23,5786.64,4508.8,786
780,6033,6230,4506,4738,197,232,25264,722,24542,0.9714217859404687,1,6129.54,4624.44,6129.13,4623.85,787
781,3459,4118,4507,5089,659,582,209362,0,209362,1.0,0,3752.87,4818.81,3752.77,4818.16,788
782,5558,5723,4509,4624,165,115,14286,0,14286,1.0,0,5648.74,4567.47,5648.15,4566.99,789
783,5922,5960,4510,4564,38,54,1500,0,1500,1.0,0,5940.86,4536.38,5940.37,4535.91,790
784,9091,9166,4510,4573,75,63,2894,0,2894,1.0,0,9127.08,4543.16,9126.7,4542.52,791
785,5786,5847,4514,4572,61,58,2456,0,2456,1.0,0,5815.45,4546.53,5815.02,4545.91,794
786,7712,7894,4514,4689,182,175,19950,0,19950,1.0,0,7805.34,4596.31,7804.9,4595.93,792
787,9275,9323,4514,4555,48,41,1438,0,1438,1.0,0,9299.64,4535.53,9299.05,4535.05,793
788,9146,9223,4520,4607,77,87,4437,275,4162,0.9380211854856886,1,9184.99,4565.09,9184.47,4564.56,795
789,6185,6406,4525,4843,221,318,36675,4081,32594,0.8887252897068848,4,6296.06,4673.83,6295.68,4673.78,796
790,6873,7244,4527,4733,371,206,48005,0,48005,1.0,0,7054.67,4628.09,7054.3,4627.74,797
791,8213,8498,4528,4720,285,192,34467,0,34467,1.0,0,8365.0,4618.04,8364.44,4617.63,798
792,6437,6605,4529,4708,168,179,20616,0,20616,1.0,0,6510.67,4618.71,6510.31,4618.17,799
793,5844,5940,4535,4600,96,65,4252,0,4252,1.0,0,5895.54,4565.34,5894.89,4564.87,800
794,2989,3523,4538,5119,534,581,221891,0,221891,1.0,0,3271.18,4843.15,3270.74,4842.58,801
795,8859,8910,4538,4582,51,44,1520,0,1520,1.0,0,8885.4,4559.82,8884.86,4559.36,802
796,9220,9346,4546,4641,126,95,7362,0,7362,1.0,0,9290.55,4590.91,9289.9,4590.42,804
797,8409,8700,4547,4791,291,244,28867,0,28867,1.0,0,8547.78,4669.52,8547.33,4669.05,803
798,5777,5898,4563,4675,121,112,9108,4773,4335,0.4759552042160738,1,5839.24,4620.06,5838.75,4619.59,805
799,6698,6879,4563,4734,181,171,18989,0,18989,1.0,0,6787.61,4631.28,6787.02,4631.03,806
800,9097,9182,4564,4656,85,92,4891,0,4891,1.0,0,9142.4,4616.54,9141.71,4615.75,807
801,8831,8875,4570,4622,44,52,1757,977,780,0.443938531587934,0,8854.44,4595.18,8853.95,4594.71,808
802,8859,8919,4572,4667,60,95,3676,0,3676,1.0,0,8892.05,4622.22,8891.32,4621.56,810
803,9049,9122,4572,4642,73,70,2933,0,2933,1.0,0,9086.33,4601.46,9085.44,4601.37,809
804,6372,6443,4575,4667,71,92,4376,0,4376,1.0,0,6412.0,4615.56,6411.52,4615.24,811
805,11179,11746,4576,5219,567,643,174984,0,174984,1.0,0,11507.02,4916.72,11506.27,4916.1,812
806,10449,10710,4577,4961,261,384,61980,3597,58383,0.9419651500484028,1,10584.31,4767.6,10583.67,4767.0,813
807,8868,9062,4578,4744,194,166,12968,0,12968,1.0,0,8960.7,4656.02,8960.27,4655.62,814
808,6011,6049,4580,4641,38,61,1390,0,1390,1.0,0,6028.35,4612.88,6027.85,4612.17,815
809,7873,8108,4582,4881,235,299,44085,0,44085,1.0,0,7974.16,4709.05,7973.71,4708.74,816
810,2673,3046,4587,5134,373,547,137751,0,137751,1.0,0,2854.89,4868.94,2854.48,4868.29,817
811,6339,6386,4588,4689,47,101,2941,0,2941,1.0,0,6362.18,4641.0,6361.69,4640.36,818
812,8640,8801,4591,4779,161,188,17248,0,17248,1.0,0,8720.47,4685.08,8720.02,4684.38,819
813,9165,9281,4591,4673,116,82,5488,0,5488,1.0,0,9219.63,4634.73,9219.07,4634.33,820
814,5892,5948,4596,4645,56,49,2003,0,2003,1.0,0,5919.89,4621.1,5919.36,4620.56,821
815,5607,5747,4606,4699,140,93,7215,0,7215,1.0,0,5687.23,4649.46,5686.45,4648.82,823
816,3495,3594,4607,4675,99,68,3119,0,3119,1.0,0,3541.21,4640.1,3540.68,4639.76,822
817,6583,6755,4609,4747,172,138,15841,0,15841,1.0,0,6666.98,4677.63,6666.52,4677.19,824
818,9042,9110,4623,4688,68,65,2650,0,2650,1.0,0,9078.03,4656.05,9077.46,4655.46,825
819,8012,8257,4630,4831,245,201,29312,261,29051,0.9910957969432315,0,8155.43,4742.37,8154.73,4741.84,826
820,7254,7595,4633,4899,341,266,58548,0,58548,1.0,0,7419.99,4775.72,7419.55,4775.15,827
821,6366,6438,4634,4708,72,74,2707,0,2707,1.0,0,6401.31,4675.36,6400.75,4674.67,829
822,5965,6058,4636,4721,93,85,4406,0,4406,1.0,0,6013.39,4678.71,6012.91,4678.36,828
823,9227,9301,4636,4710,74,74,3180,77,3103,0.9757861635220125,0,9267.27,4674.73,9266.71,4674.08,831
824,5871,5966,4637,4711,95,74,4362,46,4316,0.9894543787253554,0,5916.53,4674.18,5916.12,4673.71,830
825,1339,2741,4638,5981,1402,1343,735658,504,735154,0.9993148990427617,1,2028.08,5217.45,2027.08,5217.57,832
826,8762,8845,4642,4760,83,118,5964,1,5963,0.999832327297116,0,8799.61,4696.78,8799.12,4696.41,833
827,9090,9196,4649,4763,106,114,7962,0,7962,1.0,0,9139.92,4708.64,9139.49,4708.15,834
828,6755,6975,4653,4873,220,220,31134,0,31134,1.0,0,6878.0,4762.31,6877.35,4761.78,835
829,9162,9246,4656,4740,84,84,3959,0,3959,1.0,0,9206.08,4697.87,9205.2,4697.06,836
830,8988,9047,4658,4703,59,45,1852,0,1852,1.0,0,9014.18,4678.15,9013.85,4677.68,837
831,5809,5872,4659,4718,63,59,1991,0,1991,1.0,0,5833.36,4685.41,5833.1,4684.99,838
832,6385,6667,4659,4870,282,211,37393,318,37075,0.9914957344957612,1,6531.12,4768.42,6530.41,4767.76,839
833,5701,5832,4661,4780,131,119,10287,0,10287,1.0,0,5766.1,4725.08,5765.64,4724.5,840
834,8837,8891,4664,4702,54,38,1266,0,1266,1.0,0,8862.61,4683.21,8862.33,4682.54,841
835,8544,8673,4667,4816,129,149,10872,0,10872,1.0,0,8615.51,4739.82,8615.03,4739.41,842
836,8243,8425,4669,4809,182,140,17759,25,17734,0.998592263077876,0,8321.72,4737.24,8321.43,4736.78,843
837,6965,7106,4670,4881,141,211,20258,0,20258,1.0,0,7032.66,4769.52,7032.22,4769.01,844
838,7719,7891,4672,4864,172,192,26200,197,26003,0.9924809160305343,0,7814.93,4766.37,7814.32,4765.85,845
839,9023,9104,4673,4742,81,69,3481,731,2750,0.7900028727377191,1,9064.25,4709.66,9063.56,4709.07,846
840,6161,6211,4676,4748,50,72,2748,0,2748,1.0,0,6185.44,4713.36,6184.94,4712.83,847
841,8927,8994,4680,4745,67,65,2887,0,2887,1.0,0,8962.56,4711.04,8961.99,4710.69,848
842,5823,5913,4681,4780,90,99,5012,2153,2859,0.5704309656823623,1,5864.24,4728.02,5863.66,4727.71,849
843,4048,4368,4685,5064,320,379,58460,8228,50232,0.8592541908997605,1,4214.12,4868.32,4213.93,4868.04,850
844,5894,5979,4686,4774,85,88,4034,0,4034,1.0,0,5939.49,4731.26,5938.99,4730.69,851
845,11679,12257,4691,5149,578,458,188318,0,188318,1.0,0,11962.86,4941.28,11962.52,4940.74,852
846,6169,6282,4694,4818,113,124,8459,0,8459,1.0,0,6232.52,4758.26,6232.01,4757.8,853
847,8812,8898,4695,4781,86,86,4380,0,4380,1.0,0,8852.24,4739.48,8851.8,4739.04,854
848,8975,9039,4699,4765,64,66,2992,2,2990,0.9993315508021391,0,9008.51,4733.41,9007.97,4732.9,856
849,5974,6042,4700,4762,68,62,2931,0,2931,1.0,0,6009.49,4730.53,6008.94,4730.05,855
850,6038,6091,4703,4770,53,67,2641,0,2641,1.0,0,6064.38,4735.53,6063.9,4735.05,857
851,7073,7263,4717,4879,190,162,24296,0,24296,1.0,0,7160.53,4797.46,7160.14,4796.93,858
852,6083,6191,4722,4814,108,92,6546,0,6546,1.0,0,6135.54,4769.34,6135.12,4768.87,859
853,8896,8933,4726,4778,37,52,1328,0,1328,1.0,0,8912.53,4750.59,8912.14,4750.17,860
854,10200,10544,4726,5119,344,393,73404,0,73404,1.0,0,10380.92,4917.55,10380.58,4917.03,861
855,5931,6039,4729,4828,108,99,6052,0,6052,1.0,0,5983.78,4785.02,5983.4,4784.34,863
856,9017,9172,4729,4838,155,109,9144,0,9144,1.0,0,9078.06,4781.84,9078.15,4781.24,862
857,8920,8988,4737,4823,68,86,4105,0,4105,1.0,0,8952.99,4778.43,8952.52,4777.93,864
858,8697,8845,4741,4994,148,253,17909,286,17623,0.9840303757887096,1,8767.7,4880.02,8767.0,4878.76,865
859,6645,6833,4742,4910,188,168,23468,0,23468,1.0,0,6726.94,4826.24,6726.6,4825.79,866
860,8337,8657,4750,5008,320,258,49159,275,48884,0.9944059073618259,0,8504.62,4868.44,8504.02,4868.37,867
861,5889,5936,4751,4797,47,46,1211,0,1211,1.0,0,5912.57,4775.57,5912.02,4774.92,868
862,8755,8859,4751,4878,104,127,7550,0,7550,1.0,0,8809.93,4810.21,8809.38,4809.82,869
863,5841,5895,4752,4793,54,41,1381,0,1381,1.0,0,5873.31,4774.34,5872.47,4773.86,870
864,7551,7780,4753,4919,229,166,24752,0,24752,1.0,0,7652.4,4830.81,7652.07,4830.4,871
865,6021,6132,4757,4835,111,78,4191,0,4191,1.0,0,6073.59,4796.15,6073.24,4795.55,872
866,8973,9070,4763,4864,97,101,3960,1134,2826,0.7136363636363636,1,9012.05,4810.17,9012.27,4810.24,873
867,8846,8934,4772,4863,88,91,5688,0,5688,1.0,0,8888.23,4811.0,8887.78,4810.66,874
868,6264,6315,4774,4832,51,58,1860,0,1860,1.0,0,6286.79,4806.03,6286.3,4805.35,875
869,8634,8690,4776,4882,56,106,4241,0,4241,1.0,0,8661.1,4833.9,8660.62,4833.32,876
870,8680,8724,4777,4862,44,85,2807,0,2807,1.0,0,8700.22,4817.38,8699.76,4816.96,877
871,9101,9181,4777,4855,80,78,4611,0,4611,1.0,0,9143.26,4818.0,9142.71,4817.56,878
872,1067,1482,4779,5092,415,313,82732,0,82732,1.0,0,1277.38,4950.94,1276.77,4950.12,879
873,5833,6000,4780,4936,167,156,15772,4686,11086,0.7028911995942176,1,5923.02,4859.49,5922.22,4858.66,880
874,8164,8345,4786,4901,181,115,12505,183,12322,0.9853658536585366,0,8255.17,4844.7,8254.63,4844.16,881
875,6144,6285,4799,4932,141,133,9892,0,9892,1.0,0,6225.52,4856.19,6224.97,4855.92,882
876,6272,6557,4801,5002,285,201,33049,1799,31250,0.9455656752095374,1,6414.35,4889.77,6413.87,4889.22,883
877,5977,6069,4805,4879,92,74,3900,775,3125,0.8012820512820513,1,6032.3,4840.67,6031.53,4840.13,884
878,7922,8258,4806,5081,336,275,36008,0,36008,1.0,0,8113.1,4915.98,8112.76,4916.11,885
879,6092,6180,4811,4889,88,78,3554,0,3554,1.0,0,6141.99,4851.86,6141.07,4851.19,886
880,1859,1915,4812,4877,56,65,1729,0,1729,1.0,0,1879.25,4837.01,1878.68,4836.88,887
881,7075,7352,4817,5042,277,225,29604,0,29604,1.0,0,7224.55,4918.71,7223.91,4918.26,888
882,8886,9040,4820,4931,154,111,12255,0,12255,1.0,0,8967.5,4874.56,8966.85,4874.19,889
883,6053,6137,4825,4919,84,94,4761,0,4761,1.0,0,6093.89,4876.15,6093.41,4875.58,890
884,9036,9130,4834,4903,94,69,3497,0,3497,1.0,0,9078.96,4867.74,9078.68,4867.2,891
885,6886,7020,4835,5051,134,216,22825,0,22825,1.0,0,6955.85,4944.27,6955.32,4943.77,893
886,8097,8377,4835,5143,280,308,34963,0,34963,1.0,0,8272.13,4997.87,8270.73,4997.53,892
887,8818,8895,4842,4916,77,74,3170,0,3170,1.0,0,8853.71,4876.43,8853.31,4875.98,894
888,6557,6969,4844,5211,412,367,59096,2856,56240,0.9516718559631786,2,6790.32,5066.13,6789.4,5065.43,895
889,7592,7934,4850,5116,342,266,69519,1625,67894,0.9766250952976884,1,7764.28,4980.78,7763.77,4980.3,896
890,4300,4428,4854,4996,128,142,10472,0,10472,1.0,0,4363.15,4921.75,4362.51,4921.36,897
891,5988,6143,4860,4983,155,123,9637,2568,7069,0.7335270312337865,1,6060.43,4925.83,6059.97,4925.26,898
892,8640,8732,4862,5023,92,161,10617,0,10617,1.0,0,8688.62,4945.58,8688.15,4944.98,899
893,6505,6722,4864,5086,217,222,31502,2186,29316,0.9306075804710812,1,6608.45,4973.7,6608.08,4973.21,900
894,3409,4317,4867,6098,908,1231,668098,401,667697,0.9993997886537603,0,3878.18,5505.36,3877.49,5504.91,901
895,7227,7601,4876,5130,374,254,68079,0,68079,1.0,0,7436.32,5001.48,7435.7,5001.03,902
896,6669,6829,4877,5008,160,131,14377,0,14377,1.0,0,6754.17,4946.04,6753.67,4945.49,903
897,6968,7249,4877,5149,281,272,38202,0,38202,1.0,0,7081.03,5026.87,7080.81,5026.27,904
898,6127,6202,4884,4965,75,81,3965,0,3965,1.0,0,6162.12,4924.51,6161.66,4923.99,905
899,8788,8928,4884,5002,140,118,8589,0,8589,1.0,0,8870.99,4951.14,8870.06,4950.78,906
900,8997,9072,4884,4959,75,75,3093,0,3093,1.0,0,9037.85,4927.51,9037.19,4926.84,907
901,6178,6248,4888,4945,70,57,2627,0,2627,1.0,0,6218.13,4912.85,6217.35,4912.34,908
902,8491,8550,4893,4946,59,53,2023,0,2023,1.0,0,8519.91,4919.91,8519.46,4919.36,909
903,7929,8170,4910,5061,241,151,29156,0,29156,1.0,0,8044.32,4980.41,8043.93,4979.98,910
904,8924,8999,4912,4972,75,60,3405,0,3405,1.0,0,8962.71,4943.61,8962.09,4943.11,911
905,12153,12680,4912,5328,527,416,103940,0,103940,1.0,0,12379.19,5091.36,12379.02,5091.02,912
906,5928,6082,4916,5044,154,128,10299,0,10299,1.0,0,6005.92,4977.94,6005.45,4977.44,913
907,6251,6360,4921,5045,109,124,5607,0,5607,1.0,0,6317.56,4973.85,6316.55,4973.57,915
908,8310,8504,4921,5127,194,206,19049,2834,16215,0.8512257861305056,1,8416.07,5021.95,8415.36,5021.57,914
909,8474,8565,4925,5051,91,126,5193,0,5193,1.0,0,8520.5,4984.42,8519.87,4984.06,916
910,6224,6295,4931,5019,71,88,4054,0,4054,1.0,0,6258.3,4975.91,6257.68,4975.55,917
911,6152,6239,4934,5058,87,124,6473,0,6473,1.0,0,6192.92,4992.15,6192.48,4991.64,918
912,12640,12765,4939,5064,125,125,8803,0,8803,1.0,0,12699.77,5001.26,12699.3,5001.05,919
913,8920,9039,4955,5049,119,94,7574,2052,5522,0.7290731449696329,1,8978.2,5001.4,8977.65,5000.76,920
914,6348,6429,4956,5046,81,90,5098,0,5098,1.0,0,6387.56,4996.84,6386.94,4996.37,921
915,6058,6176,4960,5168,118,208,15870,1024,14846,0.9354757403906743,1,6123.01,5062.56,6122.52,5061.99,922
916,8722,8778,4961,5018,56,57,2210,0,2210,1.0,0,8748.58,4987.62,8748.14,4987.22,923
917,6395,6582,4964,5166,187,202,21813,0,21813,1.0,0,6476.48,5064.77,6476.12,5064.45,924
918,8745,8930,4974,5128,185,154,19085,0,19085,1.0,0,8836.14,5053.46,8835.78,5052.8,925
919,10734,11383,4980,5660,649,680,233756,0,233756,1.0,0,11040.15,5316.77,11039.68,5316.21,926
920,8484,8587,4990,5077,103,87,4749,0,4749,1.0,0,8542.77,5037.44,8541.91,5037.14,927
921,8617,8672,4990,5044,55,54,2012,0,2012,1.0,0,8643.02,5016.6,8642.61,5016.23,928
922,8581,8629,4994,5079,48,85,2445,0,2445,1.0,0,8604.85,5034.08,8604.42,5033.74,929
923,6291,6351,4999,5044,60,45,1468,0,1468,1.0,0,6316.82,5020.25,6316.76,5020.06,930
924,3208,3723,5001,5461,515,460,134227,0,134227,1.0,0,3472.55,5235.02,3472.11,5234.39,931
925,8614,8760,5002,5169,146,167,10294,0,10294,1.0,0,8670.23,5080.48,8670.38,5079.71,932
926,6222,6298,5007,5058,76,51,2186,0,2186,1.0,0,6262.16,5030.76,6261.5,5030.13,933
927,8438,8488,5009,5067,50,58,2225,621,1604,0.7208988764044943,0,8463.83,5038.2,8463.3,5037.71,934
928,7866,8001,5011,5205,135,194,19077,0,19077,1.0,0,7927.74,5121.83,7927.33,5121.13,935
929,2736,3289,5018,5677,553,659,214307,0,214307,1.0,0,3016.55,5350.24,3016.1,5350.01,936
930,4206,4372,5021,5259,166,238,23247,0,23247,1.0,0,4272.86,5147.11,4272.42,5146.24,937
931,11058,12688,5024,6186,1630,1162,916191,0,916191,1.0,0,11814.61,5615.73,11814.0,5615.3,938
932,6168,6237,5027,5092,69,65,2852,246,2606,0.9137447405329593,1,6203.22,5061.02,6202.79,5060.42,939
933,8710,8756,5032,5084,46,52,1471,0,1471,1.0,0,8735.86,5060.61,8735.38,5059.93,941
934,6267,6357,5034,5099,90,65,4033,0,4033,1.0,0,6310.09,5066.4,6309.71,5065.95,940
935,2267,2894,5036,5751,627,715,271075,0,271075,1.0,0,2576.7,5393.61,2576.26,5393.0,942
936,6210,6276,5036,5140,66,104,3832,52,3780,0.9864300626304802,0,6245.36,5092.35,6244.73,5091.54,943
937,6336,6414,5039,5140,78,101,5711,0,5711,1.0,0,6377.31,5088.08,6376.73,5087.65,944
938,7972,8108,5047,5178,136,131,12259,0,12259,1.0,0,8036.52,5100.09,8036.08,5099.79,945
939,8553,8616,5049,5114,63,65,2740,0,2740,1.0,0,8585.26,5085.46,8584.73,5084.83,946
940,8460,8512,5063,5132,52,69,2276,0,2276,1.0,0,8482.98,5096.74,8482.65,5096.34,948
941,8500,8559,5063,5107,59,44,1870,0,1870,1.0,0,8527.16,5084.04,8526.77,5083.56,947
942,8677,8803,5066,5217,126,151,7875,0,7875,1.0,0,8733.69,5129.15,8733.39,5129.06,949
943,7509,7789,5068,5298,280,230,43787,0,43787,1.0,0,7633.41,5180.78,7633.02,5180.23,951
944,7104,7278,5069,5181,174,112,14621,0,14621,1.0,0,7192.11,5119.82,7191.53,5119.41,950
945,8392,8492,5070,5174,100,104,4893,0,4893,1.0,0,8438.94,5137.86,8438.83,5136.66,953
946,7659,7894,5072,5425,235,353,43857,7,43850,0.9998403903595777,0,7795.55,5266.38,7795.0,5265.67,952
947,6859,7161,5078,5326,302,248,40013,1460,38553,0.96351185864594,2,7011.1,5205.92,7010.48,5205.38,954
948,2834,2926,5082,5185,92,103,4864,0,4864,1.0,0,2883.44,5129.77,2882.83,5129.26,956
949,6303,6344,5087,5141,41,54,1314,0,1314,1.0,0,6322.45,5110.25,6321.97,5110.04,957
950,6131,6285,5089,5259,154,170,13440,0,13440,1.0,0,6214.35,5176.29,6213.74,5175.78,958
951,8292,8396,5091,5210,104,119,6920,824,6096,0.8809248554913295,1,8337.36,5141.32,8337.0,5141.08,959
952,11597,12180,5094,5590,583,496,177542,0,177542,1.0,0,11916.92,5310.49,11916.24,5310.09,960
953,6504,6573,5095,5158,69,63,2816,0,2816,1.0,0,6536.82,5125.21,6536.38,5124.7,961
954,8493,8564,5095,5164,71,69,3112,0,3112,1.0,0,8528.12,5130.6,8527.7,5129.97,963
955,6249,6319,5096,5161,70,65,2890,0,2890,1.0,0,6283.9,5131.47,6283.35,5130.96,962
956,7268,7524,5098,5319,256,221,43391,0,43391,1.0,0,7394.87,5198.02,7394.39,5197.62,964
957,8041,8302,5099,5272,261,173,29571,2169,27402,0.926651110885665,2,8180.63,5184.83,8180.2,5184.25,965
958,4468,4729,5104,5293,261,189,29180,0,29180,1.0,0,4599.22,5207.09,4598.71,5206.42,966
959,8550,8617,5110,5161,67,51,2243,0,2243,1.0,0,8581.3,5135.1,8580.91,5134.4,967
960,8598,8664,5120,5209,66,89,3456,112,3344,0.9675925925925926,1,8629.5,5166.67,8628.99,5166.09,968
961,6316,6371,5124,5195,55,71,2339,0,2339,1.0,0,6345.03,5160.0,6344.52,5159.44,969
962,6357,6458,5130,5228,101,98,5085,0,5085,1.0,0,6403.28,5181.53,6402.75,5180.61,970
963,6605,6740,5134,5281,135,147,11583,934,10649,0.9193645860312527,1,6676.6,5203.59,6676.31,5203.17,971
964,6455,6534,5140,5198,79,58,2640,0,2640,1.0,0,6496.91,5161.1,6496.55,5160.93,972
965,12114,12198,5142,5240,84,98,5305,0,5305,1.0,0,12150.89,5191.1,12150.66,5190.54,973
966,8611,8736,5147,5349,125,202,15439,0,15439,1.0,0,8671.54,5248.92,8671.12,5248.33,974
967,6257,6424,5149,5314,167,165,15231,4665,10566,0.6937167618672444,1,6335.05,5240.57,6334.64,5240.01,976
968,8451,8511,5149,5218,60,69,2519,0,2519,1.0,0,8478.48,5178.7,8478.08,5178.38,975
969,8337,8413,5152,5222,76,70,3616,0,3616,1.0,0,8374.64,5186.42,8374.13,5185.94,977
970,8483,8642,5152,5265,159,113,11509,2045,9464,0.8223129724563385,1,8556.39,5207.97,8555.87,5207.66,978
971,7071,7315,5153,5478,244,325,33806,841,32965,0.9751227592735018,0,7176.35,5324.55,7176.15,5323.89,980
972,6575,6619,5154,5203,44,49,1575,0,1575,1.0,0,6595.15,5177.31,6594.73,5176.84,979
973,6521,6577,5155,5218,56,63,2640,0,2640,1.0,0,6552.13,5185.68,6551.55,5185.25,981
974,8274,8311,5155,5196,37,41,985,25,960,0.9746192893401016,0,8291.9,5177.58,8291.47,5177.02,982
975,7779,8122,5158,5502,343,344,60854,1351,59503,0.9777993229697308,1,7965.19,5333.66,7964.7,5333.4,983
976,7189,7249,5161,5234,60,73,3362,0,3362,1.0,0,7223.0,5197.29,7222.34,5196.92,984
977,6436,6491,5164,5235,55,71,2730,0,2730,1.0,0,6464.06,5203.65,6463.6,5203.0,985
978,7160,7202,5167,5222,42,55,1716,0,1716,1.0,0,7182.08,5193.7,7181.57,5193.24,986
979,4246,4394,5168,5365,148,197,14705,0,14705,1.0,0,4330.43,5264.83,4329.79,5264.39,987
980,8397,8454,5173,5220,57,47,1545,0,1545,1.0,0,8426.38,5192.61,8425.8,5192.34,988
981,6484,6582,5177,5265,98,88,4906,0,4906,1.0,0,6527.66,5228.44,6527.11,5227.67,989
982,6736,6931,5179,5326,195,147,17077,0,17077,1.0,0,6840.66,5256.35,6840.23,5255.92,990
983,6710,6743,5185,5230,33,45,1083,0,1083,1.0,0,6726.16,5206.8,6725.7,5206.31,991
984,6736,6788,5195,5240,52,45,1749,0,1749,1.0,0,6760.67,5217.54,6760.22,5217.06,992
985,8291,8334,5195,5237,43,42,1056,0,1056,1.0,0,8307.43,5214.57,8307.23,5214.14,993
986,8424,8492,5196,5272,68,76,3901,437,3464,0.8879774416816201,1,8455.21,5238.96,8454.78,5238.3,994
987,6571,6627,5201,5242,56,41,1418,0,1418,1.0,0,6598.55,5220.2,6598.13,5219.85,995
988,11569,11640,5206,5277,71,71,1979,0,1979,1.0,0,11606.32,5233.44,11605.77,5232.88,996
989,8361,8424,5207,5287,63,80,3608,183,3425,0.9492793791574279,1,8395.33,5244.84,8394.74,5244.38,997
990,8265,8394,5209,5386,129,177,12033,0,12033,1.0,0,8323.91,5297.55,8323.5,5297.04,998
991,6395,6453,5219,5280,58,61,2620,0,2620,1.0,0,6423.16,5249.85,6422.72,5249.35,999
992,4141,4691,5222,5732,550,510,134135,0,134135,1.0,0,4424.02,5458.34,4423.92,5457.95,1000
993,6444,6500,5230,5287,56,57,2119,7,2112,0.9966965549787635,0,6472.06,5257.47,6471.35,5257.0,1003
994,6621,6672,5230,5278,51,48,1591,0,1591,1.0,0,6645.66,5253.41,6645.25,5253.0,1001
995,6560,6625,5231,5295,65,64,2970,0,2970,1.0,0,6593.93,5266.6,6593.36,5265.99,1002
996,8160,8210,5241,5291,50,50,1598,0,1598,1.0,0,8186.31,5266.09,8185.81,5265.53,1004
997,8199,8252,5243,5301,53,58,1923,0,1923,1.0,0,8223.09,5269.87,8222.63,5269.48,1005
998,8479,8565,5245,5332,86,87,4141,0,4141,1.0,0,8524.68,5280.62,8523.88,5280.39,1006
999,8501,8617,5246,5389,116,143,9668,0,9668,1.0,0,8562.04,5323.43,8561.51,5322.8,1007
1000,6482,6568,5257,5345,86,88,5140,0,5140,1.0,0,6524.44,5297.76,6523.96,5297.3,1008
1001,8246,8297,5259,5296,51,37,1319,0,1319,1.0,0,8271.5,5275.78,8271.03,5275.35,1009
1002,6618,6676,5262,5310,58,48,1698,0,1698,1.0,0,6645.37,5289.17,6644.92,5288.66,1010
1003,8359,8502,5264,5436,143,172,16616,0,16616,1.0,0,8437.97,5354.49,8437.19,5353.86,1012
1004,8113,8168,5265,5324,55,59,2378,0,2378,1.0,0,8137.9,5293.0,8137.46,5292.57,1011
1005,7410,7559,5266,5412,149,146,15325,408,14917,0.9733768352365416,1,7486.0,5340.07,7485.51,5339.53,1013
1006,4411,5166,5268,5961,755,693,281338,3534,277804,0.9874385969900973,1,4772.99,5636.46,4772.65,5635.66,1014
1007,6669,6723,5269,5300,54,31,1321,0,1321,1.0,0,6694.3,5283.39,6693.9,5282.94,1015
1008,7176,7466,5270,5528,290,258,41274,0,41274,1.0,0,7329.02,5398.65,7328.49,5398.33,1016
1009,6722,6800,5271,5340,78,69,3013,0,3013,1.0,0,6758.77,5308.07,6758.31,5307.5,1017
1010,8084,8116,5272,5330,32,58,1119,0,1119,1.0,0,8101.55,5303.24,8101.14,5302.49,1018
1011,8202,8281,5275,5387,79,112,5207,0,5207,1.0,0,8242.38,5333.4,8241.87,5332.87,1019
1012,6958,7001,5281,5327,43,46,1453,0,1453,1.0,0,6979.03,5304.0,6978.53,5303.42,1021
1013,6920,6964,5282,5336,44,54,1794,0,1794,1.0,0,6943.13,5308.78,6942.6,5308.31,1020
1014,6997,7049,5285,5351,52,66,2177,0,2177,1.0,0,7020.67,5317.45,7020.32,5317.0,1022
1015,7535,7713,5285,5446,178,161,20016,0,20016,1.0,0,7622.16,5364.91,7621.68,5364.46,1023
1016,8156,8211,5288,5345,55,57,2114,0,2114,1.0,0,8183.04,5314.07,8182.58,5313.63,1024
1017,6670,6757,5293,5359,87,66,3664,0,3664,1.0,0,6709.67,5326.59,6709.5,5326.25,1025
1018,6539,6642,5294,5380,103,86,6204,82,6122,0.986782720825274,0,6592.21,5333.43,6591.67,5332.99,1026
1019,6798,6882,5294,5349,84,55,2983,0,2983,1.0,0,6840.76,5323.81,6840.25,5323.26,1027
1020,9992,10267,5294,5915,275,621,80863,0,80863,1.0,0,10130.63,5571.35,10130.36,5571.12,1028
1021,8329,8415,5297,5406,86,109,4091,0,4091,1.0,0,8367.34,5349.19,8366.94,5348.74,1029
1022,6619,6686,5307,5382,67,75,2668,0,2668,1.0,0,6652.3,5345.01,6651.74,5344.68,1030
1023,8107,8178,5311,5366,71,55,1933,0,1933,1.0,0,8144.67,5338.67,8143.91,5337.96,1031
1024,7037,7084,5315,5368,47,53,1733,0,1733,1.0,0,7059.67,5342.36,7059.2,5341.83,1032
1025,6816,6951,5316,5433,135,117,7278,0,7278,1.0,0,6878.49,5368.85,6878.13,5368.36,1033
1026,6918,7054,5319,5423,136,104,7714,0,7714,1.0,0,6983.87,5373.04,6983.39,5372.59,1034
1027,8087,8145,5328,5404,58,76,2498,0,2498,1.0,0,8117.09,5366.18,8116.55,5365.64,1035
1028,6743,6849,5331,5455,106,124,8083,0,8083,1.0,0,6792.8,5392.01,6792.42,5391.61,1036
1029,6471,6612,5333,5464,141,131,9524,3200,6324,0.6640067198656027,1,6548.45,5399.27,6547.72,5398.6,1037
1030,8175,8239,5337,5407,64,70,2581,0,2581,1.0,0,8205.13,5371.28,8204.71,5370.84,1038
1031,6712,6745,5345,5402,33,57,1262,0,1262,1.0,0,6728.74,5372.19,6728.19,5371.72,1039
1032,6443,6505,5349,5424,62,75,2465,0,2465,1.0,0,6477.86,5384.54,6477.28,5384.1,1040
1033,8132,8210,5349,5434,78,85,3665,0,3665,1.0,0,8167.91,5399.33,8167.46,5398.55,1041
1034,6635,6726,5354,5429,91,75,4493,0,4493,1.0,0,6678.14,5391.89,6677.67,5391.43,1042
1035,7061,7102,5364,5436,41,72,1665,0,1665,1.0,0,7081.4,5402.19,7080.71,5401.54,1043
1036,7024,7070,5367,5422,46,55,1814,0,1814,1.0,0,7048.88,5397.84,7048.37,5397.17,1044
1037,3264,3542,5368,5578,278,210,35248,0,35248,1.0,0,3395.41,5466.62,3394.98,5466.21,1045
1038,6881,6939,5368,5445,58,77,2754,328,2426,0.8809005083514887,0,6910.76,5408.69,6910.3,5408.09,1046
1039,8181,8372,5370,5465,191,95,8480,855,7625,0.8991745283018868,0,8267.97,5415.01,8267.73,5414.64,1047
1040,6593,6640,5373,5412,47,39,1286,0,1286,1.0,0,6618.91,5392.83,6618.2,5392.19,1048
1041,7668,7779,5380,5486,111,106,7828,264,7564,0.9662749105774144,0,7726.85,5433.4,7726.24,5432.9,1049
1042,7451,7595,5390,5532,144,142,14876,0,14876,1.0,0,7517.53,5463.02,7517.13,5462.47,1050
1043,6644,6759,5393,5485,115,92,5781,0,5781,1.0,0,6705.78,5440.45,6705.24,5439.91,1051
1044,6920,6983,5401,5485,63,84,2721,0,2721,1.0,0,6952.05,5438.36,6951.47,5438.06,1052
1045,8065,8189,5401,5487,124,86,5754,0,5754,1.0,0,8119.99,5444.52,8119.62,5444.05,1053
1046,6604,6650,5405,5451,46,46,1459,0,1459,1.0,0,6626.96,5431.79,6626.3,5431.05,1054
1047,7908,8090,5411,5523,182,112,13266,0,13266,1.0,0,8002.42,5467.63,8001.81,5467.26,1055
1048,6948,7118,5414,5530,170,116,13284,0,13284,1.0,0,7025.12,5472.61,7024.77,5472.18,1056
1049,9532,10133,5424,6175,601,751,251008,0,251008,1.0,0,9838.86,5806.93,9838.12,5806.95,1057
1050,6810,6950,5425,5512,140,87,6243,3591,2652,0.42479577126381546,1,6886.04,5467.59,6885.16,5467.21,1058
1051,7573,7706,5436,5564,133,128,12424,0,12424,1.0,0,7640.5,5500.25,7639.98,5499.75,1059
1052,7684,7852,5437,5671,168,234,21259,49,21210,0.9976950938426078,0,7758.55,5548.97,7757.92,5548.68,1060
1053,7100,7234,5448,5572,134,124,9645,0,9645,1.0,0,7167.3,5512.25,7167.0,5511.63,1061
1054,7204,7295,5455,5532,91,77,4638,0,4638,1.0,0,7253.47,5491.07,7252.57,5490.53,1062
1055,2917,3515,5458,6311,598,853,300208,0,300208,1.0,0,3206.44,5838.79,3205.91,5838.46,1063
1056,9419,9658,5460,5809,239,349,52888,0,52888,1.0,0,9537.21,5631.52,9536.65,5631.12,1064
1057,1834,2600,5463,5866,766,403,171158,0,171158,1.0,0,2148.37,5662.47,2148.4,5662.47,1065
1058,7288,7435,5472,5594,147,122,10009,1918,8091,0.8083724647816964,1,7356.83,5525.09,7356.56,5524.72,1066
1059,7804,7953,5492,5631,149,139,12773,0,12773,1.0,0,7878.93,5560.17,7878.46,5559.69,1067
1060,12329,12786,5504,6063,457,559,131502,0,131502,1.0,0,12580.75,5795.44,12580.06,5795.01,1068
1061,7522,7599,5510,5583,77,73,3658,0,3658,1.0,0,7561.86,5547.25,7561.35,5546.71,1069
1062,7388,7535,5521,5671,147,150,13087,0,13087,1.0,0,7455.27,5587.9,7454.83,5587.55,1070
1063,7174,7290,5524,5623,116,99,7300,0,7300,1.0,0,7241.11,5573.02,7240.64,5572.33,1071
1064,7277,7326,5530,5615,49,85,2776,0,2776,1.0,0,7301.7,5572.6,7301.07,5571.92,1072
1065,7552,7702,5543,5690,150,147,12555,0,12555,1.0,0,7635.22,5613.9,7634.43,5613.22,1073
1066,7465,7602,5562,5758,137,196,14987,201,14786,0.9865883765930473,0,7537.55,5661.52,7537.21,5660.95,1074
1067,1698,3003,5573,6260,1305,687,408955,0,408955,1.0,0,2355.91,5946.85,2355.91,5946.3,1075
1068,1590,1966,5579,5943,376,364,67056,3,67053,0.9999552612741589,0,1767.52,5800.08,1767.35,5798.84,1076
1069,7721,7893,5588,5756,172,168,16115,4344,11771,0.7304374806081291,1,7808.08,5670.75,7807.42,5670.31,1077
1070,3717,4717,5647,6564,1000,917,449180,0,449180,1.0,0,4193.4,6103.68,4192.86,6103.29,1078
1071,7576,7758,5660,5806,182,146,15707,6307,9400,0.5984592856688101,2,7659.3,5727.14,7658.94,5726.68,1079
1072,4758,5473,5693,6860,715,1167,374403,0,374403,1.0,0,5102.63,6322.16,5102.07,6321.19,1080
1073,9187,9658,5711,6193,471,482,125998,0,125998,1.0,0,9444.08,5952.25,9443.44,5951.75,1081
1074,12150,12215,5736,5840,65,104,2161,0,2161,1.0,0,12180.39,5785.28,12180.15,5785.21,1082
1075,11861,12422,5775,6285,561,510,153036,0,153036,1.0,0,12145.53,6050.74,12144.78,6050.35,1083
1076,9881,10695,5788,6553,814,765,272703,0,272703,1.0,0,10350.06,6162.2,10349.03,6161.8,1084
1077,1365,1771,5860,6262,406,402,99458,16,99442,0.999839128074162,0,1567.9,6048.99,1567.64,6048.71,1085
1078,11010,12067,5874,6568,1057,694,426663,0,426663,1.0,0,11502.77,6239.53,11502.7,6239.13,1086
1079,10513,10654,5900,6055,141,155,11396,0,11396,1.0,0,10589.45,5971.07,10589.34,5970.5,1088
1080,2409,3261,5915,6940,852,1025,413811,0,413811,1.0,0,2736.68,6382.63,2736.52,6382.35,1089
1081,3901,4970,5923,7156,1069,1233,580534,0,580534,1.0,0,4492.11,6527.66,4491.49,6526.99,1091
1082,5265,5924,5923,6568,659,645,181071,0,181071,1.0,0,5631.68,6226.38,5631.26,6226.03,1090
1083,3182,3762,5952,6447,580,495,180953,0,180953,1.0,0,3495.83,6201.8,3495.39,6201.4,1092
1084,3971,4030,5978,6048,59,70,2687,0,2687,1.0,0,4002.5,6014.57,4001.93,6014.06,1093
1085,12356,12658,5989,6415,302,426,50588,0,50588,1.0,0,12524.13,6175.37,12523.32,6175.2,1094
1086,5708,6073,6016,6516,365,500,68250,1550,66700,0.9772893772893773,1,5916.16,6245.96,5915.24,6245.15,1095
1087,12363,12495,6023,6143,132,120,5826,0,5826,1.0,0,12438.34,6083.88,12436.93,6083.98,1096
1088,9309,10041,6062,6724,732,662,308279,0,308279,1.0,0,9681.65,6371.06,9681.22,6370.65,1097
1089,1940,2535,6092,6576,595,484,193713,0,193713,1.0,0,2232.98,6333.87,2232.48,6333.21,1098
1090,8049,8401,6109,6348,352,239,56504,0,56504,1.0,0,8228.46,6234.17,8228.03,6233.56,1099
1091,12015,12480,6150,6463,465,313,64245,0,64245,1.0,0,12247.02,6293.92,12246.49,6293.51,1100
1092,6194,6976,6158,7243,782,1085,385829,0,385829,1.0,0,6566.6,6756.9,6566.14,6756.54,1101
1093,9995,10383,6166,6750,388,584,135257,0,135257,1.0,0,10167.8,6433.41,10167.03,6433.42,1102
1094,5225,5728,6219,6699,503,480,140336,0,140336,1.0,0,5492.76,6460.64,5492.2,6460.05,1104
1095,5993,6351,6244,6816,358,572,112341,0,112341,1.0,0,6166.89,6520.24,6166.57,6520.09,1105
1096,12097,12485,6279,6722,388,443,102199,0,102199,1.0,0,12299.07,6518.24,12298.6,6517.42,1106
1097,8007,8596,6326,6777,589,451,186475,0,186475,1.0,0,8297.29,6537.92,8296.78,6537.54,1107
1098,3047,3620,6336,6930,573,594,211256,0,211256,1.0,0,3339.7,6659.22,3339.01,6658.52,1108
1099,3553,4018,6349,6749,465,400,112538,0,112538,1.0,0,3769.46,6548.64,3768.73,6548.14,1109
1100,11760,12166,6365,7019,406,654,140146,762,139384,0.9945628130663736,1,11946.76,6662.12,11946.06,6661.82,1110
1101,2794,3239,6377,6784,445,407,101452,0,101452,1.0,0,3032.32,6578.79,3031.43,6578.5,1111
1102,10129,10707,6452,7048,578,596,213157,0,213157,1.0,0,10410.06,6766.34,10409.55,6765.56,1112
1103,7648,8158,6454,6919,510,465,139026,0,139026,1.0,0,7899.44,6708.83,7899.11,6708.37,1113
1104,5871,6086,6459,6791,215,332,31240,0,31240,1.0,0,5992.96,6601.82,5992.49,6601.71,1114
1105,8921,9570,6471,7068,649,597,266696,0,266696,1.0,0,9242.91,6767.33,9242.53,6766.98,1115
1106,11214,12027,6488,7275,813,787,364133,0,364133,1.0,0,11608.0,6944.96,11607.89,6944.4,1116
1107,5434,5986,6495,7007,552,512,151213,0,151213,1.0,0,5747.19,6761.23,5746.26,6760.6,1117
1108,1923,2485,6512,6839,562,327,124911,0,124911,1.0,0,2219.1,6677.97,2218.59,6677.49,1118
1109,9449,10211,6518,7216,762,698,328151,0,328151,1.0,0,9832.96,6895.54,9832.56,6895.02,1119
1110,6780,7174,6547,6819,394,272,63698,0,63698,1.0,0,6980.99,6680.37,6980.72,6679.92,1120
1111,3441,4046,6644,7251,605,607,251820,0,251820,1.0,0,3735.6,6962.56,3735.3,6962.1,1121
1112,11930,12335,6670,7109,405,439,116622,157,116465,0.9986537703006294,0,12147.85,6884.41,12147.28,6883.88,1122
1113,8047,8677,6690,7234,630,544,224414,0,224414,1.0,0,8384.46,6952.77,8383.76,6952.22,1123
1114,5261,6488,6694,8002,1227,1308,649115,0,649115,1.0,0,5919.84,7325.72,5919.08,7325.45,1124
1115,4671,5353,6704,7107,682,403,144963,0,144963,1.0,0,5038.47,6896.0,5037.39,6895.66,1125
1116,7261,7827,6720,7200,566,480,165486,0,165486,1.0,0,7540.49,6975.27,7539.95,6974.56,1127
1117,2572,3082,6726,7338,510,612,140534,0,140534,1.0,0,2828.58,6968.84,2827.59,6969.29,1128
1118,4166,4711,6728,7352,545,624,244053,0,244053,1.0,0,4428.27,7025.82,4427.8,7025.24,1129
1119,1897,2670,6739,7415,773,676,325050,0,325050,1.0,0,2324.77,7055.38,2324.02,7054.74,1131
1120,5008,5823,6765,7781,815,1016,435146,0,435146,1.0,0,5390.78,7295.09,5390.44,7294.29,1132
1121,6785,7388,6773,7240,603,467,153182,0,153182,1.0,0,7098.85,6994.5,7098.05,6994.07,1133
1122,10942,11297,6807,7407,355,600,116686,0,116686,1.0,0,11113.02,7093.98,11112.66,7093.55,1134
1123,7721,8164,6833,7341,443,508,136359,0,136359,1.0,0,7955.22,7095.53,7955.26,7094.75,1136
1124,8549,9104,6858,7348,555,490,161383,0,161383,1.0,0,8855.59,7087.88,8854.91,7087.62,1137
1125,7805,7891,6871,6939,86,68,2794,0,2794,1.0,0,7839.85,6900.89,7839.65,6900.55,1138
1126,2917,3524,6889,7410,607,521,207698,0,207698,1.0,0,3215.83,7127.61,3215.36,7127.14,1139
1127,4645,5210,6935,7421,565,486,171935,0,171935,1.0,0,4913.31,7160.98,4912.87,7160.57,1140
1128,8976,9497,6979,7324,521,345,90670,0,90670,1.0,0,9238.96,7149.47,9238.22,7148.87,1141
1129,4012,4437,7069,7454,425,385,70899,0,70899,1.0,0,4209.61,7295.23,4208.78,7294.29,1142
1130,8075,8276,7091,7309,201,218,21289,0,21289,1.0,0,8175.85,7190.64,8175.42,7190.41,1143
1131,2687,2776,7096,7185,89,89,3365,0,3365,1.0,0,2734.56,7144.27,2733.95,7143.64,1144
1132,6668,7343,7102,8238,675,1136,500221,0,500221,1.0,0,7015.6,7671.05,7015.13,7670.61,1146
1133,9169,10310,7102,8152,1141,1050,733475,0,733475,1.0,0,9780.31,7556.14,9779.7,7555.56,1145
1134,2636,3099,7115,7436,463,321,82329,0,82329,1.0,0,2867.67,7303.48,2867.33,7303.07,1147
1135,7198,8302,7125,8091,1104,966,671662,0,671662,1.0,0,7681.77,7629.49,7681.0,7629.0,1148
1136,2657,2786,7135,7282,129,147,6503,0,6503,1.0,0,2729.21,7210.29,2728.26,7209.88,1149
1137,6192,6797,7135,7762,605,627,262471,0,262471,1.0,0,6496.0,7439.67,6495.56,7439.21,1150
1138,8226,8784,7151,7584,558,433,138856,0,138856,1.0,0,8494.4,7345.05,8494.02,7344.48,1151
1139,4625,4671,7153,7231,46,78,2152,0,2152,1.0,0,4644.11,7190.2,4643.59,7189.85,1152
1140,3770,4147,7155,7491,377,336,69314,0,69314,1.0,0,3938.64,7317.4,3938.56,7317.05,1153
1141,7345,7395,7165,7244,50,79,1454,0,1454,1.0,0,7371.23,7206.72,7370.77,7206.09,1154
1142,11102,11562,7166,7638,460,472,126849,0,126849,1.0,0,11298.92,7394.67,11298.74,7394.28,1155
1143,2844,3816,7170,8025,972,855,412099,1597,410502,0.996124717604265,1,3382.94,7580.0,3382.42,7580.21,1156
1144,3530,5121,7212,8831,1591,1619,1373211,232,1372979,0.9998310529117521,0,4366.24,8057.6,4365.62,8056.98,1157
1145,11263,12018,7220,7919,755,699,270747,0,270747,1.0,0,11612.2,7553.24,11611.87,7552.85,1158
1146,7912,8519,7252,7764,607,512,113012,0,113012,1.0,0,8228.1,7482.0,8228.07,7481.96,1159
1147,8139,9271,7284,8388,1132,1104,648990,0,648990,1.0,0,8690.73,7814.43,8690.08,7813.94,1160
1148,10804,11164,7312,7659,360,347,66478,0,66478,1.0,0,11007.08,7516.72,11006.47,7516.13,1161
1149,3477,4372,7340,7918,895,578,229061,178,228883,0.9992229144201763,0,3854.68,7633.95,3855.2,7632.94,1163
1150,2468,3066,7382,7846,598,464,147976,0,147976,1.0,0,2717.22,7611.01,2717.52,7609.95,1165
1151,5242,6794,7546,8601,1552,1055,1035810,0,1035810,1.0,0,6040.58,8088.99,6040.14,8088.52,1166
1152,4070,4129,7554,7649,59,95,2407,0,2407,1.0,0,4099.71,7594.3,4099.29,7594.42,1167
1153,8982,9625,7568,8136,643,568,215027,0,215027,1.0,0,9295.78,7849.28,9294.81,7848.81,1168
1154,10883,11345,7588,8030,462,442,100576,0,100576,1.0,0,11080.23,7782.83,11079.97,7782.16,1169
1155,4052,4100,7615,7695,48,80,2401,0,2401,1.0,0,4077.28,7658.01,4076.81,7657.3,1170
1156,11654,11805,7655,7801,151,146,9835,0,9835,1.0,0,11724.1,7738.4,11724.24,7737.24,1171
1157,4897,5344,7702,8357,447,655,120798,0,120798,1.0,0,5141.95,8004.73,5141.01,8004.43,1173
1158,4017,4071,7703,7770,54,67,2243,0,2243,1.0,0,4048.21,7736.9,4047.49,7736.42,1172
1159,8348,8483,7735,7845,135,110,5890,0,5890,1.0,0,8408.09,7791.44,8408.03,7790.07,1174
1160,11026,11335,7736,8075,309,339,32775,0,32775,1.0,0,11182.07,7901.39,11180.55,7901.7,1175
1161,8347,8392,7741,7798,45,57,1374,0,1374,1.0,0,8369.26,7770.8,8368.76,7770.24,1176
1162,3832,4141,7766,8008,309,242,39606,0,39606,1.0,0,3994.67,7888.48,3993.95,7888.55,1177
1163,10108,10160,7844,7924,52,80,2229,0,2229,1.0,0,10134.98,7884.72,10134.24,7884.34,1178
1164,2975,3566,7884,8341,591,457,166261,0,166261,1.0,0,3268.67,8109.39,3268.44,8108.9,1179
1165,3510,3900,7886,8198,390,312,42900,0,42900,1.0,0,3680.57,8033.65,3680.64,8032.94,1180
1166,7542,8232,7899,8516,690,617,279732,0,279732,1.0,0,7916.59,8201.48,7916.07,8200.99,1181
1167,8688,9905,7935,8745,1217,810,562095,0,562095,1.0,0,9250.83,8329.27,9250.61,8328.63,1183
1168,6995,7696,8031,8671,701,640,316665,0,316665,1.0,0,7351.07,8353.49,7350.56,8353.02,1185
1169,9743,10350,8063,8703,607,640,238680,399,238281,0.9983283056812469,0,10040.59,8379.95,10039.96,8379.57,1186
1170,4651,5048,8077,8470,397,393,31841,0,31841,1.0,0,4853.44,8280.62,4853.02,8280.04,1187
1171,3455,3709,8079,8393,254,314,38150,0,38150,1.0,0,3589.94,8234.67,3589.63,8233.74,1188
1172,10583,10628,8085,8131,45,46,973,0,973,1.0,0,10602.86,8108.93,10602.56,8108.41,1189
1173,6566,7057,8169,8778,491,609,200585,0,200585,1.0,0,6813.38,8451.72,6813.01,8451.2,1190
1174,8274,8728,8179,8540,454,361,76804,0,76804,1.0,0,8500.26,8325.8,8499.31,8325.99,1191
1175,4596,5677,8201,8991,1081,790,404754,0,404754,1.0,0,5115.83,8594.95,5115.37,8594.96,1192
1176,8003,8372,8258,8691,369,433,65137,0,65137,1.0,0,8213.05,8484.43,8212.23,8483.85,1193
1177,10310,10604,8299,8459,294,160,31738,0,31738,1.0,0,10459.18,8380.41,10458.55,8380.03,1194
1178,6101,6612,8357,8812,511,455,160935,0,160935,1.0,0,6372.76,8567.34,6371.98,8567.16,1195
1179,8297,8836,8390,9096,539,706,250586,0,250586,1.0,0,8569.58,8708.34,8569.0,8708.13,1196
1180,4405,4791,8393,8791,386,398,106245,0,106245,1.0,0,4609.57,8587.22,4609.25,8586.65,1198
1181,9759,10685,8393,9072,926,679,268653,0,268653,1.0,0,10213.25,8716.68,10212.72,8716.41,1197
1182,5719,6164,8411,8806,445,395,67510,0,67510,1.0,0,5987.36,8589.35,5986.6,8588.67,1199
1183,7277,8857,8454,9695,1580,1241,900155,0,900155,1.0,0,7965.28,9081.09,7965.5,9081.01,1201
1184,9224,9855,8461,8959,631,498,226145,0,226145,1.0,0,9542.92,8700.58,9542.49,8700.02,1202
1185,5525,6020,8587,8963,495,376,121894,0,121894,1.0,0,5787.64,8762.85,5787.03,8762.55,1204
1186,6919,7366,8587,9066,447,479,147880,0,147880,1.0,0,7115.52,8823.12,7115.0,8822.7,1205
1187,6450,6960,8599,9128,510,529,175218,0,175218,1.0,0,6706.75,8893.5,6706.18,8892.98,1206
1188,10387,10710,8654,8964,323,310,56375,0,56375,1.0,0,10557.79,8810.09,10557.18,8809.64,1207
1189,8117,8515,8665,9159,398,494,86021,0,86021,1.0,0,8305.93,8917.68,8305.77,8917.85,1208
1190,8666,9292,8688,9140,626,452,180728,0,180728,1.0,0,8969.28,8909.86,8968.65,8909.38,1209
1191,4894,5335,8706,8968,441,262,67351,0,67351,1.0,0,5111.96,8841.75,5111.66,8841.18,1210
1192,10123,10450,8740,9015,327,275,46207,0,46207,1.0,0,10290.72,8895.23,10290.39,8894.34,1211
1193,9005,9873,8816,9587,868,771,359312,0,359312,1.0,0,9388.88,9182.05,9388.77,9181.39,1212
1194,5209,5324,8854,8947,115,93,6210,0,6210,1.0,0,5276.68,8899.84,5276.09,8899.68,1213
1195,7120,7551,8854,9201,431,347,85302,0,85302,1.0,0,7328.77,9065.9,7328.42,9065.32,1214
1196,9801,9954,8860,9055,153,195,15744,0,15744,1.0,0,9872.0,8954.82,9871.35,8954.49,1215
1197,4683,5100,8874,9089,417,215,43774,0,43774,1.0,0,4884.04,8994.76,4883.78,8994.38,1216
1198,6334,6392,9013,9064,58,51,2031,0,2031,1.0,0,6362.0,9037.56,6361.48,9037.18,1217
1199,8453,8551,9018,9143,98,125,7989,0,7989,1.0,0,8498.13,9074.1,8497.53,9073.98,1218
1200,6603,7198,9025,9375,595,350,109643,0,109643,1.0,0,6918.82,9183.65,6918.58,9183.47,1219
1201,8472,8845,9042,9371,373,329,61546,0,61546,1.0,0,8671.28,9207.06,8671.07,9206.49,1220
1202,6223,6659,9046,9341,436,295,72573,0,72573,1.0,0,6454.24,9197.28,6453.79,9197.07,1221
1203,8192,8506,9064,9385,314,321,61792,0,61792,1.0,0,8339.79,9237.58,8339.18,9236.58,1222
1204,8757,9118,9124,9439,361,315,71114,0,71114,1.0,0,8942.17,9273.34,8941.39,9272.9,1225
1205,7050,7683,9156,9632,633,476,201133,0,201133,1.0,0,7347.58,9406.35,7347.32,9405.67,1226
1206,8475,8557,9167,9259,82,92,4830,0,4830,1.0,0,8512.67,9214.81,8512.39,9214.73,1227
1207,5972,6112,9215,9344,140,129,7011,0,7011,1.0,0,6020.17,9278.56,6020.63,9278.31,1228
1208,7540,7815,9382,9675,275,293,39610,7,39603,0.9998232769502651,0,7662.62,9518.47,7662.41,9517.63,1229
1209,8632,9122,9397,9854,490,457,120736,431,120305,0.99643022793533,1,8872.11,9592.93,8871.48,9592.52,1230
