ndimage_cellID,x0,x1,y0,y1,length,height,total_area,nuclei_area,cyto_area,c2t_area_ratio,orig_comX,orig_comY,ndimage_comX,ndimage_comY,orig_cellID
1,0,10720,0,15008,10720,15008,63611800,183821,63427979,0.9971102688494902,7209.57,7213.38,7206.54,7213.6,1
2,2342,2616,904,1231,274,327,55578,0,55578,1.0,2495.5,1067.27,2494.58,1067.25,2
3,2062,3026,958,1812,964,854,396202,1322,394880,0.9966633182063694,2524.64,1392.12,2524.47,1391.38,3
4,2978,3266,1129,1519,288,390,71653,0,71653,1.0,3136.52,1323.29,3136.09,1323.34,4
5,3326,3517,1162,1302,191,140,10179,0,10179,1.0,3405.3,1228.34,3405.74,1228.59,5
6,913,1600,1230,1617,687,387,149310,0,149310,1.0,1279.1,1412.47,1277.3,1411.84,7
7,3240,3649,1231,1571,409,340,91722,0,91722,1.0,3413.01,1408.53,3412.58,1408.01,8
8,1840,2180,1279,1574,340,295,58600,0,58600,1.0,2010.57,1427.71,2010.27,1426.93,9
9,2493,2861,1367,1695,368,328,75559,2829,72730,0.9625590598075676,2651.45,1532.94,2650.98,1532.37,10
10,1008,1404,1409,1865,396,456,110679,4236,106443,0.9617271569132356,1192.44,1642.16,1192.06,1641.65,11
11,2720,3447,1433,2382,727,949,337824,0,337824,1.0,3013.08,1889.56,3013.24,1889.96,12
12,3127,3577,1455,2077,450,622,157666,3675,153991,0.9766912333667372,3313.19,1780.98,3312.59,1779.96,14
13,3892,4010,1466,1559,118,93,6469,0,6469,1.0,3948.85,1517.54,3948.4,1516.98,15
14,3856,4130,1494,1769,274,275,44836,0,44836,1.0,3996.78,1643.91,3995.75,1642.96,16
15,561,1168,1520,2333,607,813,213744,1140,212604,0.9946665169548619,867.32,1973.21,866.94,1971.91,18
16,1735,2250,1538,2058,515,520,165906,0,165906,1.0,1952.18,1802.86,1951.88,1802.51,19
17,1361,1607,1587,1773,246,186,18983,0,18983,1.0,1453.88,1676.69,1454.26,1675.85,20
18,1373,1789,1632,2033,416,401,114302,0,114302,1.0,1590.83,1839.69,1590.48,1839.24,21
19,2372,2833,1663,2105,461,442,131445,0,131445,1.0,2598.24,1887.9,2597.91,1887.53,22
20,3348,3714,1724,2157,366,433,86038,4726,81312,0.9450707826774216,3545.86,1923.87,3545.18,1923.72,23
21,3632,4279,1726,2722,647,996,370716,0,370716,1.0,3961.62,2246.46,3961.16,2245.66,24
22,878,1452,1734,2701,574,967,322923,0,322923,1.0,1173.78,2237.29,1173.4,2236.45,25
23,5631,5848,1781,2165,217,384,40705,71,40634,0.9982557425377717,5727.1,1964.33,5726.49,1964.18,26
24,1776,2607,1797,2529,831,732,348225,0,348225,1.0,2178.89,2189.37,2178.51,2188.81,27
25,5249,5532,1843,2159,283,316,49133,6,49127,0.9998778824822421,5384.77,2008.71,5384.15,2008.25,28
26,4675,5278,1937,2805,603,868,275756,2675,273081,0.9902993951174226,4994.3,2407.58,4994.01,2406.61,29
27,1330,1854,1986,2464,524,478,171019,0,171019,1.0,1583.04,2196.83,1582.59,2196.47,30
28,286,697,1988,2429,411,441,99193,0,99193,1.0,519.79,2214.23,519.07,2213.67,31
29,1819,1887,2007,2101,68,94,2609,0,2609,1.0,1858.12,2052.48,1857.26,2051.68,32
30,5398,5674,2009,2317,276,308,58131,0,58131,1.0,5537.82,2167.16,5537.34,2166.68,33
31,3388,3826,2010,2496,438,486,95844,0,95844,1.0,3639.79,2246.53,3639.08,2246.01,34
32,5578,5909,2022,2375,331,353,58377,2877,55500,0.9507168919266149,5768.93,2191.58,5768.2,2191.35,35
33,2479,2954,2053,2524,475,471,121224,0,121224,1.0,2725.73,2271.99,2725.25,2271.74,36
34,5873,6368,2057,2435,495,378,107018,4681,102337,0.9562596946308097,6097.22,2231.4,6097.42,2230.96,37
35,5138,5460,2093,2601,322,508,103430,0,103430,1.0,5300.68,2358.7,5300.06,2358.17,38
36,2889,2943,2163,2274,54,111,3901,0,3901,1.0,2914.32,2217.98,2913.95,2217.74,39
37,0,979,2188,2886,979,698,368648,0,368648,1.0,411.43,2524.11,411.82,2523.39,40
38,2790,3395,2189,3052,605,863,255322,0,255322,1.0,3046.9,2624.85,3047.11,2623.87,41
39,628,743,2191,2336,115,145,6035,0,6035,1.0,699.45,2280.01,698.31,2278.99,42
40,3153,3819,2239,2876,666,637,260320,0,260320,1.0,3450.56,2556.28,3450.21,2555.91,43
41,6160,6415,2261,2744,255,483,52283,0,52283,1.0,6301.19,2463.68,6300.79,2464.36,44
42,5647,6106,2264,2919,459,655,207960,6532,201428,0.9685901134833622,5874.79,2619.27,5874.29,2618.76,45
43,5365,5732,2289,2748,367,459,122879,0,122879,1.0,5562.74,2514.89,5562.17,2514.55,46
44,2322,2891,2302,2754,569,452,152533,1947,150586,0.9872355490287348,2583.76,2550.55,2583.34,2549.8,47
45,1292,2047,2331,3081,755,750,300006,0,300006,1.0,1618.91,2649.07,1618.53,2648.81,48
46,2849,2897,2365,2442,48,77,2544,0,2544,1.0,2872.92,2404.01,2872.41,2403.63,49
47,6028,6312,2393,2779,284,386,64117,0,64117,1.0,6161.22,2578.98,6160.62,2578.77,50
48,6417,7089,2431,3391,672,960,367499,6557,360942,0.9821577745789785,6797.54,2952.3,6796.95,2951.76,51
49,6354,6746,2445,2926,392,481,138965,0,138965,1.0,6555.75,2679.65,6555.15,2679.2,52
50,1853,2856,2468,3293,1003,825,374991,0,374991,1.0,2259.02,2858.59,2259.74,2858.95,53
51,646,1112,2512,2927,466,415,99607,3930,95677,0.9605449416205688,864.7,2686.99,864.21,2686.86,54
52,7052,7423,2512,2897,371,385,60503,0,60503,1.0,7220.25,2716.8,7220.28,2716.94,55
53,5006,5442,2555,3014,436,459,129596,225,129371,0.9982638353035588,5236.88,2796.17,5236.29,2795.78,56
54,0,219,2570,2949,219,379,47095,0,47095,1.0,84.72,2804.48,84.85,2803.82,57
55,3452,4003,2618,3139,551,521,172659,0,172659,1.0,3782.54,2880.48,3781.49,2879.8,58
56,3958,4537,2641,3159,579,518,174551,0,174551,1.0,4212.6,2915.02,4212.42,2914.41,59
57,823,1476,2652,3272,653,620,269710,2101,267609,0.9922101516443588,1142.84,2985.61,1142.56,2984.98,60
58,139,438,2671,3227,299,556,95870,0,95870,1.0,277.32,2958.02,276.73,2957.14,61
59,6029,6605,2679,3751,576,1072,336174,0,336174,1.0,6309.18,3197.02,6308.63,3196.38,62
60,3970,4096,2688,2792,126,104,5616,0,5616,1.0,4041.65,2737.64,4040.54,2736.84,63
61,5280,6189,2714,3709,909,995,442043,0,442043,1.0,5738.92,3209.26,5738.36,3208.34,64
62,2474,2920,2725,3231,446,506,136263,0,136263,1.0,2707.96,2953.18,2707.45,2952.86,65
63,6327,6364,2731,2783,37,52,1186,0,1186,1.0,6346.01,2758.07,6345.65,2757.53,66
64,6944,7231,2770,3065,287,295,52493,52,52441,0.999009391728421,7092.94,2916.62,7092.6,2916.33,67
65,364,885,2797,3289,521,492,168162,0,168162,1.0,640.47,3027.68,639.63,3027.16,68
66,3136,3772,2823,3595,636,772,300802,0,300802,1.0,3423.29,3163.18,3422.95,3162.78,69
67,7181,7466,2823,3171,285,348,68783,4355,64428,0.9366849366849367,7319.19,3004.54,7318.64,3003.76,70
68,1379,1986,2833,3518,607,685,263223,0,263223,1.0,1717.97,3171.12,1717.29,3170.73,71
69,5580,6073,2871,3109,493,238,68112,0,68112,1.0,5844.74,2977.79,5843.9,2977.35,72
70,0,519,2905,4263,519,1358,439753,1736,438017,0.9960523293758087,193.43,3681.5,193.67,3680.54,73
71,4876,5328,2946,3339,452,393,95382,0,95382,1.0,5129.74,3153.16,5128.8,3152.37,74
72,2821,3187,2956,3510,366,554,124294,0,124294,1.0,3010.5,3238.25,3010.26,3237.79,75
73,1933,2610,3011,3691,677,680,294007,0,294007,1.0,2247.79,3339.69,2247.3,3339.36,76
74,7022,7329,3014,3388,307,374,70687,0,70687,1.0,7152.95,3221.58,7152.73,3220.88,77
75,7249,7657,3017,3439,408,422,97492,3221,94271,0.9669613917039347,7456.76,3256.81,7456.34,3256.27,78
76,3870,4680,3038,3866,810,828,395842,0,395842,1.0,4292.26,3448.77,4291.85,3448.32,79
77,1937,2005,3048,3127,68,79,2381,0,2381,1.0,1968.66,3094.58,1968.16,3093.8,80
78,7530,7790,3050,3315,260,265,28810,0,28810,1.0,7661.4,3188.56,7660.63,3188.03,81
79,3705,4083,3074,3465,378,391,81061,0,81061,1.0,3882.35,3257.4,3881.42,3257.07,82
80,232,633,3119,3530,401,411,97766,1603,96163,0.9836037068101385,433.84,3321.63,433.11,3321.23,83
81,586,1160,3175,4050,574,875,279738,0,279738,1.0,893.82,3595.99,893.12,3595.65,84
82,1078,1615,3207,3756,537,549,222199,0,222199,1.0,1334.02,3476.89,1333.5,3476.42,85
83,4662,5251,3207,3851,589,644,258838,0,258838,1.0,4955.33,3522.48,4955.04,3521.95,86
84,2815,2889,3221,3297,74,76,2789,0,2789,1.0,2855.11,3267.74,2854.56,3266.64,89
85,5190,5701,3222,3789,511,567,189118,2826,186292,0.9850569485717912,5430.54,3524.09,5429.8,3523.29,88
86,2571,2961,3262,3593,390,331,64791,3143,61648,0.9514901761047059,2735.72,3407.96,2735.27,3408.27,90
87,6391,6937,3265,3954,546,689,219278,0,219278,1.0,6698.65,3623.43,6698.03,3622.91,91
88,7751,8030,3277,3562,279,285,57670,0,57670,1.0,7886.98,3405.85,7886.47,3405.54,93
89,6895,7361,3278,3889,466,611,163704,0,163704,1.0,7114.25,3552.3,7113.84,3552.13,92
90,7572,7895,3290,3687,323,397,54356,3286,51070,0.9395466921774965,7718.67,3487.69,7718.27,3487.09,94
91,2989,3572,3307,4030,583,723,216727,0,216727,1.0,3247.65,3666.02,3247.06,3665.69,96
92,3480,4274,3332,4240,794,908,308986,0,308986,1.0,3870.23,3779.78,3869.72,3779.3,98
93,1596,2060,3370,3837,464,467,103624,0,103624,1.0,1836.61,3605.85,1835.98,3605.23,99
94,379,840,3387,4023,461,636,178104,0,178104,1.0,596.57,3696.54,596.24,3696.06,100
95,7161,7666,3388,4286,505,898,290080,3916,286164,0.9865002757859901,7416.89,3842.55,7416.53,3841.93,101
96,2530,3078,3482,4119,548,637,261163,1608,259555,0.9938429256824283,2813.46,3800.42,2812.92,3799.94,102
97,7852,8108,3497,3793,256,296,43764,0,43764,1.0,7971.65,3655.25,7971.18,3654.89,103
98,2102,2621,3498,3921,519,423,137329,0,137329,1.0,2378.36,3717.88,2377.82,3717.32,104
99,2899,3029,3501,3562,130,61,3654,0,3654,1.0,2962.3,3528.93,2962.29,3528.3,105
100,4209,4991,3501,4355,782,854,345799,3054,342745,0.9911682798388659,4622.08,3975.29,4621.16,3974.59,106
101,5666,5759,3504,3624,93,120,5437,0,5437,1.0,5714.84,3566.73,5714.16,3566.08,108
102,5944,6330,3507,4375,386,868,169871,0,169871,1.0,6153.25,3863.42,6153.09,3864.08,109
103,7826,7902,3529,3608,76,79,3167,0,3167,1.0,7868.12,3562.51,7867.65,3562.18,111
104,5538,5974,3536,4132,436,596,147974,0,147974,1.0,5757.42,3804.3,5756.77,3804.07,112
105,1266,1847,3560,4172,581,612,173078,145,172933,0.9991622274350292,1560.14,3875.22,1560.01,3874.62,114
106,7557,7914,3603,4059,357,456,112924,0,112924,1.0,7731.05,3829.2,7730.54,3828.75,115
107,4006,4090,3636,3726,84,90,2799,0,2799,1.0,4045.47,3680.82,4045.15,3680.47,116
108,1810,2296,3647,4074,486,427,106456,2225,104231,0.9790993462087623,2034.51,3867.82,2034.69,3867.27,117
109,6791,7246,3667,4311,455,644,159053,0,159053,1.0,7024.5,3984.29,7024.1,3983.75,118
110,698,1394,3675,4270,696,595,183805,210,183595,0.9988574848344713,1123.19,4021.94,1121.69,4021.4,119
111,6124,7154,3684,4836,1030,1152,682893,2497,680396,0.9963434974439627,6614.28,4333.48,6613.47,4332.62,120
112,3969,4136,3690,3845,167,155,12447,0,12447,1.0,4057.82,3769.12,4057.33,3768.53,121
113,1195,1328,3703,3852,133,149,9458,0,9458,1.0,1269.57,3778.03,1268.61,3777.18,122
114,632,6504,3706,10850,5872,7144,13429182,201051,13228131,0.9850287977331754,3546.2,7472.62,3544.79,7471.74,123
115,4935,5693,3714,4876,758,1162,556548,0,556548,1.0,5279.92,4234.19,5279.13,4234.84,124
116,7959,8249,3732,4091,290,359,59726,0,59726,1.0,8096.9,3917.94,8096.66,3917.57,125
117,7908,7996,3783,3895,88,112,6134,0,6134,1.0,7951.31,3837.38,7950.78,3837.02,126
118,4087,4370,3811,4020,283,209,37283,0,37283,1.0,4233.16,3914.12,4232.65,3913.43,127
119,7822,8175,3859,4245,353,386,61206,4180,57026,0.9317060418913179,7960.89,4061.94,7960.67,4061.62,128
120,2194,2649,3867,4200,455,333,89602,1948,87654,0.9782594138523694,2446.89,4027.39,2446.37,4027.0,129
121,5406,6212,3885,4884,806,999,375045,0,375045,1.0,5797.21,4381.35,5796.63,4381.07,130
122,1574,2243,3907,5042,669,1135,347007,4500,342507,0.9870319618912586,1897.23,4429.12,1896.85,4429.62,131
123,301,1554,3951,5598,1253,1647,997699,13716,983983,0.986252366695767,910.13,4773.5,909.47,4772.94,132
124,7495,7932,3994,4503,437,509,131641,0,131641,1.0,7726.84,4242.99,7726.28,4242.55,133
125,2051,2429,3999,4560,378,561,151972,0,151972,1.0,2230.25,4272.04,2229.7,4271.74,134
126,3664,3803,4016,4147,139,131,10912,0,10912,1.0,3734.64,4086.39,3734.26,4085.89,135
127,1342,1583,4034,4315,241,281,42813,942,41871,0.9779973372573751,1457.29,4171.29,1456.79,4170.91,136
128,2605,3034,4053,4443,429,390,90063,0,90063,1.0,2809.1,4239.5,2808.55,4239.05,137
129,8161,8301,4073,4232,140,159,8822,0,8822,1.0,8226.96,4141.79,8227.02,4141.9,138
130,3723,4027,4077,4551,304,474,90493,0,90493,1.0,3882.11,4323.87,3881.58,4323.02,139
131,4675,5089,4096,4560,414,464,115074,399,114675,0.9965326659367016,4884.08,4338.66,4883.56,4338.17,140
132,7893,8341,4101,4604,448,503,145210,0,145210,1.0,8115.75,4361.96,8115.31,4361.28,141
133,1535,1691,4120,4341,156,221,20368,0,20368,1.0,1611.17,4244.6,1610.81,4243.67,142
134,0,384,4128,4648,384,520,121291,0,121291,1.0,143.85,4395.79,144.31,4395.23,143
135,3947,4065,4182,4324,118,142,7774,0,7774,1.0,4001.22,4257.37,4001.02,4256.64,145
136,1108,1612,4183,4748,504,565,178845,1087,177758,0.9939221113254494,1353.73,4455.26,1353.26,4454.5,144
137,7010,7621,4205,4800,611,595,236576,0,236576,1.0,7351.42,4505.39,7350.52,4505.21,146
138,1060,1157,4219,4363,97,144,7685,0,7685,1.0,1108.53,4295.19,1108.29,4294.33,147
139,5850,6209,4345,4783,359,438,97065,0,97065,1.0,6014.03,4565.03,6013.31,4564.69,150
140,6057,6218,4350,4428,161,78,4885,0,4885,1.0,6125.0,4386.02,6125.76,4385.49,151
141,7273,8092,4399,5576,819,1177,471163,0,471163,1.0,7653.63,4933.16,7652.97,4933.07,152
142,0,646,4474,5756,646,1282,575933,880,575053,0.9984720444912863,281.82,5097.12,281.66,5096.4,154
143,1354,1932,4498,5111,578,613,193959,3627,190332,0.9813001716857687,1669.37,4774.87,1669.26,4774.65,155
144,8035,8400,4518,5023,365,505,125882,0,125882,1.0,8223.72,4780.12,8223.39,4779.61,156
145,5945,6442,4590,5152,497,562,169093,0,169093,1.0,6191.49,4882.36,6191.15,4881.73,157
146,8061,8126,4596,4650,65,54,1911,0,1911,1.0,8095.41,4617.01,8094.95,4616.44,158
147,6346,7356,4617,5651,1010,1034,760463,4465,755998,0.994128576932737,6879.51,5150.03,6879.12,5149.3,159
148,0,76,4621,5036,76,415,20504,0,20504,1.0,27.01,4810.01,27.38,4810.02,160
149,5251,5700,4633,5010,449,377,86629,1369,85260,0.9841969779173256,5445.74,4838.86,5445.81,4838.39,161
150,2063,2236,4652,4805,173,153,13997,0,13997,1.0,2141.5,4732.06,2140.93,4731.64,162
151,6708,6824,4757,4834,116,77,4009,0,4009,1.0,6759.4,4801.34,6760.3,4801.27,164
152,5595,6207,4761,5334,612,573,197611,4527,193084,0.9770913562504112,5886.47,5079.01,5886.01,5078.06,165
153,2025,2094,4790,4887,69,97,3339,0,3339,1.0,2057.65,4840.53,2057.42,4839.83,166
154,5080,5425,4840,5150,345,310,51720,0,51720,1.0,5235.61,4983.6,5235.55,4983.29,168
155,7846,8340,4901,5297,494,396,121683,0,121683,1.0,8089.07,5105.31,8088.41,5104.73,169
156,5330,5922,4953,5695,592,742,222575,2033,220542,0.9908660002246433,5588.59,5321.79,5588.27,5321.8,170
157,4996,5463,4997,5383,467,386,83118,0,83118,1.0,5217.21,5189.67,5216.76,5189.29,171
158,0,80,5009,5257,80,248,6911,0,6911,1.0,19.55,5150.97,20.37,5147.0,172
159,7569,7929,5029,5348,360,319,69799,0,69799,1.0,7753.5,5189.21,7753.01,5188.83,173
160,5902,6591,5116,5909,689,793,268754,0,268754,1.0,6257.96,5543.89,6257.34,5543.28,174
161,4086,4222,5130,5273,136,143,10873,4314,6559,0.6032373769888715,4151.76,5206.5,4151.36,5206.09,175
162,349,967,5153,5957,618,804,271944,0,271944,1.0,649.72,5550.33,648.94,5549.85,176
163,3809,3997,5193,5299,188,106,14217,246,13971,0.9826967714707744,3900.92,5241.97,3900.5,5241.53,177
164,3107,3259,5204,5341,152,137,13219,174,13045,0.9868371283758227,3184.92,5271.49,3184.36,5270.93,178
165,3241,3307,5212,5271,66,59,2117,83,2034,0.9607935758148323,3271.71,5241.0,3271.34,5240.55,179
166,4029,4166,5212,5320,137,108,8956,3631,5325,0.5945734702992407,4088.45,5267.73,4088.18,5267.22,180
167,4207,4299,5212,5312,92,100,5015,0,5015,1.0,4247.6,5269.65,4247.19,5269.0,181
168,8222,8289,5222,5306,67,84,3591,0,3591,1.0,8255.87,5267.43,8255.32,5266.83,182
169,7501,8165,5235,5936,664,701,290860,5415,285445,0.9813827958467991,7845.32,5593.33,7845.04,5592.66,183
170,2977,3039,5238,5303,62,65,1971,0,1971,1.0,3006.01,5262.2,3005.61,5262.02,184
171,3009,3113,5244,5336,104,92,5717,641,5076,0.8878782578275319,3057.7,5283.51,3057.25,5283.16,185
172,3285,3378,5247,5291,93,44,2495,0,2495,1.0,3330.18,5268.74,3329.84,5268.08,186
173,3952,4050,5249,5324,98,75,3932,0,3932,1.0,4005.97,5287.16,4005.24,5286.69,187
174,3605,3671,5254,5310,66,56,2059,0,2059,1.0,3632.33,5278.97,3631.99,5278.62,188
175,5739,6148,5256,5662,409,406,95681,0,95681,1.0,5948.1,5457.95,5947.55,5457.3,189
176,4136,4268,5260,5370,132,110,8204,3451,4753,0.5793515358361775,4199.82,5318.95,4199.46,5318.41,190
177,3238,3310,5261,5339,72,78,3672,0,3672,1.0,3271.28,5302.93,3270.83,5302.31,191
178,7997,8567,5261,5757,570,496,167903,8219,159684,0.9510491176453071,8273.06,5509.07,8272.54,5508.55,192
179,3595,3735,5264,5440,140,176,14158,0,14158,1.0,3670.56,5348.08,3670.18,5347.52,193
180,2933,3008,5268,5304,75,36,1393,0,1393,1.0,2970.48,5284.2,2970.14,5283.9,194
181,3043,3147,5272,5371,104,99,4988,0,4988,1.0,3094.26,5325.56,3093.8,5324.96,195
182,2912,2960,5275,5332,48,57,1701,0,1701,1.0,2931.89,5301.92,2931.51,5301.49,196
183,4260,4387,5278,5411,127,133,9049,4372,4677,0.5168526909050724,4321.74,5344.9,4321.28,5344.41,197
184,3327,3378,5279,5357,51,78,2772,0,2772,1.0,3352.09,5318.64,3351.52,5318.03,198
185,3441,3602,5283,5382,161,99,9842,0,9842,1.0,3521.95,5332.43,3521.49,5332.06,199
186,3844,4019,5284,5443,175,159,12775,1278,11497,0.8999608610567514,3924.2,5346.55,3923.87,5346.36,200
187,3348,3441,5286,5392,93,106,5611,0,5611,1.0,3392.68,5343.8,3392.2,5343.08,201
188,3290,3332,5287,5354,42,67,1906,0,1906,1.0,3313.34,5322.78,3312.82,5322.25,203
189,3801,3873,5287,5342,72,55,2080,0,2080,1.0,3835.88,5315.06,3835.68,5314.93,202
190,3420,3462,5289,5335,42,46,1387,0,1387,1.0,3439.77,5309.16,3439.34,5308.79,204
191,3696,3817,5291,5398,121,107,8131,0,8131,1.0,3762.65,5344.23,3761.91,5343.79,206
192,1180,1489,5292,5670,309,378,74659,1798,72861,0.9759171700665693,1326.88,5466.78,1326.61,5466.48,205
193,4014,4186,5295,5442,172,147,10240,0,10240,1.0,4104.81,5352.69,4104.88,5352.75,207
194,2904,3053,5299,5408,149,109,10442,0,10442,1.0,2981.19,5352.39,2980.72,5352.0,208
195,2748,2921,5315,5395,173,80,8523,0,8523,1.0,2836.82,5353.17,2836.14,5352.76,209
196,3124,3192,5317,5368,68,51,2101,0,2101,1.0,3156.53,5343.24,3156.04,5342.68,210
197,3161,3253,5325,5436,92,111,7160,0,7160,1.0,3209.53,5384.85,3208.97,5384.18,211
198,3782,3963,5328,5585,181,257,18755,0,18755,1.0,3875.74,5450.42,3875.2,5450.04,213
199,2733,2774,5329,5371,41,42,1137,0,1137,1.0,2755.62,5350.53,2754.95,5349.96,212
200,3246,3297,5333,5410,51,77,2615,0,2615,1.0,3269.53,5369.28,3269.04,5368.81,214
201,3399,3489,5339,5446,90,107,5937,0,5937,1.0,3444.87,5392.55,3444.32,5392.1,215
202,3057,3124,5343,5397,67,54,1893,0,1893,1.0,3093.24,5372.59,3092.72,5371.86,216
203,3097,3172,5346,5442,75,96,4020,0,4020,1.0,3137.24,5397.44,3136.58,5396.76,217
204,4169,4338,5350,5494,169,144,18092,0,18092,1.0,4249.78,5426.88,4249.19,5426.34,218
205,3281,3355,5351,5429,74,78,4068,0,4068,1.0,3318.88,5388.15,3318.36,5387.72,219
206,3923,4013,5353,5418,90,65,3674,0,3674,1.0,3965.97,5381.49,3965.52,5381.08,220
207,3998,4073,5360,5434,75,74,3885,0,3885,1.0,4036.08,5396.14,4035.55,5395.69,221
208,2825,2972,5361,5504,147,143,13217,0,13217,1.0,2904.22,5433.38,2903.56,5432.85,222
209,3569,3674,5363,5498,105,135,7662,0,7662,1.0,3621.11,5433.54,3620.46,5432.95,223
210,3513,3581,5367,5431,68,64,2293,0,2293,1.0,3548.49,5392.4,3547.88,5392.06,224
211,4070,4152,5367,5443,82,76,4662,0,4662,1.0,4110.6,5402.99,4110.07,5402.57,225
212,3015,3120,5369,5515,105,146,8910,1547,7363,0.826374859708193,3068.45,5443.0,3067.8,5442.41,226
213,3485,3542,5371,5439,57,68,2699,0,2699,1.0,3510.21,5407.13,3509.83,5406.64,227
214,4328,4441,5375,5501,113,126,10267,0,10267,1.0,4383.79,5447.16,4383.37,5446.4,228
215,2813,2850,5384,5427,37,43,1072,0,1072,1.0,2835.08,5404.33,2834.45,5403.85,229
216,3709,3897,5387,5624,188,237,25548,0,25548,1.0,3790.45,5514.54,3789.98,5513.98,230
217,3333,3406,5388,5442,73,54,2135,0,2135,1.0,3367.02,5410.63,3366.53,5410.32,231
218,2727,2827,5390,5507,100,117,8381,0,8381,1.0,2776.27,5444.38,2775.74,5443.95,232
219,2955,3038,5392,5501,83,109,6160,0,6160,1.0,2997.47,5449.86,2996.97,5449.4,233
220,3550,3587,5395,5440,37,45,862,0,862,1.0,3571.05,5419.85,3570.43,5419.27,234
221,3222,3300,5400,5464,78,64,3138,0,3138,1.0,3261.88,5432.37,3261.36,5431.85,235
222,3686,3737,5402,5453,51,51,1736,0,1736,1.0,3715.11,5425.36,3714.53,5424.9,236
223,3937,4031,5403,5513,94,110,7410,0,7410,1.0,3984.86,5457.08,3984.34,5456.53,237
224,2571,2649,5410,5503,78,93,4781,0,4781,1.0,2611.69,5455.22,2611.13,5454.73,238
225,3417,3496,5419,5483,79,64,2202,0,2202,1.0,3457.49,5452.26,3457.02,5451.71,239
226,3353,3404,5420,5469,51,49,1874,0,1874,1.0,3379.03,5443.8,3378.49,5443.32,240
227,3672,3728,5422,5492,56,70,2321,0,2321,1.0,3695.35,5460.62,3695.01,5459.91,241
228,4018,4108,5423,5541,90,118,7822,0,7822,1.0,4063.65,5480.53,4063.14,5480.11,242
229,3286,3359,5427,5477,73,50,2568,0,2568,1.0,3323.16,5451.91,3322.65,5451.44,243
230,3400,3438,5427,5470,38,43,1215,0,1215,1.0,3418.2,5447.27,3417.74,5446.84,244
231,2642,2738,5428,5518,96,90,6057,0,6057,1.0,2692.36,5468.35,2691.81,5467.9,245
232,3106,3180,5428,5478,74,50,2553,0,2553,1.0,3144.63,5454.6,3144.08,5454.09,246
233,4101,4178,5428,5522,77,94,5734,0,5734,1.0,4140.55,5475.49,4140.04,5474.97,247
234,3503,3625,5429,5536,122,107,8472,0,8472,1.0,3561.9,5485.95,3561.45,5485.44,248
235,3458,3513,5431,5491,55,60,1919,0,1919,1.0,3487.92,5465.0,3487.41,5464.27,250
236,3167,3228,5432,5482,61,50,1896,187,1709,0.9013713080168776,3196.78,5455.39,3196.18,5455.02,249
237,2511,2587,5435,5537,76,102,5156,0,5156,1.0,2552.82,5484.07,2552.32,5483.61,251
238,2804,2880,5447,5506,76,59,2506,0,2506,1.0,2839.87,5479.68,2839.42,5479.13,252
239,3238,3346,5449,5599,108,150,8675,0,8675,1.0,3295.5,5526.45,3294.9,5525.83,253
240,3170,3245,5453,5507,75,54,2265,1167,1098,0.4847682119205298,3210.56,5484.6,3210.03,5483.91,254
241,6773,7592,5458,6052,819,594,239971,0,239971,1.0,7186.29,5721.97,7185.88,5721.29,255
242,3358,3418,5462,5496,60,34,1342,0,1342,1.0,3387.93,5478.01,3387.46,5477.51,256
243,3105,3178,5472,5542,73,70,3752,0,3752,1.0,3141.65,5506.29,3141.05,5505.7,259
244,3312,3391,5472,5527,79,55,2933,0,2933,1.0,3347.02,5500.33,3346.72,5499.84,257
245,4274,4358,5473,5568,84,95,4427,0,4427,1.0,4325.31,5520.88,4324.46,5520.08,258
246,3387,3672,5476,5799,285,323,42280,0,42280,1.0,3513.44,5643.73,3513.02,5643.48,260
247,1101,1447,5481,5837,346,356,47816,3736,44080,0.9218671574368412,1260.07,5667.36,1259.51,5666.77,262
248,3607,3822,5482,5794,215,312,42351,0,42351,1.0,3703.46,5648.7,3702.81,5647.9,261
249,2751,2839,5483,5563,88,80,3561,0,3561,1.0,2797.27,5523.41,2796.48,5523.05,264
250,4166,4308,5483,5591,142,108,10298,0,10298,1.0,4240.18,5534.85,4239.51,5534.26,263
251,4397,4474,5483,5563,77,80,3644,0,3644,1.0,4440.16,5521.42,4439.46,5520.92,265
252,2892,2985,5485,5554,93,69,3972,0,3972,1.0,2941.84,5522.78,2941.29,5522.18,266
253,2985,3052,5486,5544,67,58,2497,0,2497,1.0,3016.58,5515.69,3016.16,5515.19,267
254,2563,2707,5488,5588,144,100,8388,0,8388,1.0,2631.11,5534.44,2630.79,5534.05,268
255,2868,2915,5489,5529,47,40,1030,0,1030,1.0,2891.46,5506.08,2890.95,5505.74,269
256,2696,2778,5493,5554,82,61,3013,0,3013,1.0,2734.36,5523.64,2733.97,5523.26,270
257,3050,3116,5493,5549,66,56,2525,0,2525,1.0,3082.64,5523.58,3082.21,5522.99,272
258,3161,3262,5494,5580,101,86,6356,0,6356,1.0,3211.72,5538.71,3211.23,5538.16,271
259,2382,2555,5496,5641,173,145,12210,0,12210,1.0,2463.27,5572.13,2462.91,5571.41,274
260,897,1329,5497,6055,432,558,114832,0,114832,1.0,1115.62,5793.58,1114.91,5792.83,273
261,4355,4431,5501,5575,76,74,3390,0,3390,1.0,4389.03,5535.75,4388.72,5535.45,275
262,2836,2891,5502,5550,55,48,1644,0,1644,1.0,2859.78,5524.32,2859.52,5523.93,276
263,3905,4094,5508,5724,189,216,24581,1445,23136,0.9412147593669907,4002.07,5601.22,4001.63,5600.96,277
264,4066,4212,5515,5638,146,123,13151,0,13151,1.0,4141.3,5576.34,4140.74,5575.81,278
265,2829,3033,5518,5668,204,150,15934,0,15934,1.0,2939.55,5598.45,2939.02,5597.72,279
266,3367,3409,5520,5553,42,33,987,0,987,1.0,3385.74,5536.93,3385.34,5536.36,280
267,3337,3371,5521,5564,34,43,1073,0,1073,1.0,3353.04,5540.83,3352.61,5540.4,281
268,3099,3164,5527,5577,65,50,1824,12,1812,0.993421052631579,3135.2,5553.72,3134.35,5553.12,284
269,2800,2860,5528,5585,60,57,2172,0,2172,1.0,2827.53,5558.57,2827.18,5557.94,282
270,2388,2456,5529,5565,68,36,1422,0,1422,1.0,2422.38,5546.84,2421.87,5546.29,283
271,2536,2596,5530,5596,60,66,2313,0,2313,1.0,2565.14,5567.58,2564.67,5566.96,287
272,2860,2908,5531,5572,48,41,1280,0,1280,1.0,2884.31,5553.39,2883.82,5552.8,285
273,3533,3640,5531,5642,107,111,7192,0,7192,1.0,3584.88,5580.55,3584.56,5580.22,286
274,3029,3099,5532,5590,70,58,2193,0,2193,1.0,3064.14,5561.46,3063.6,5560.89,289
275,4423,4575,5532,5691,152,159,17632,2636,14996,0.8504990925589837,4497.15,5610.35,4496.68,5609.88,288
276,3239,3323,5538,5645,84,107,4484,0,4484,1.0,3278.1,5598.26,3277.63,5597.53,290
277,3345,3442,5539,5594,97,55,3395,0,3395,1.0,3393.27,5571.18,3392.84,5570.51,291
278,2709,2761,5542,5604,52,62,2212,0,2212,1.0,2735.09,5572.8,2734.64,5572.32,292
279,4323,4410,5546,5636,87,90,4245,875,3370,0.7938751472320377,4370.53,5589.18,4369.96,5588.71,293
280,2642,2713,5548,5593,71,45,2073,0,2073,1.0,2676.17,5569.34,2675.85,5568.99,294
281,2756,2805,5552,5602,49,50,1688,0,1688,1.0,2781.06,5576.57,2780.53,5576.08,295
282,3090,3456,5557,6020,366,463,53306,1657,51649,0.9689153191010392,3287.76,5736.77,3287.13,5736.64,296
283,4255,4363,5560,5634,108,74,3733,0,3733,1.0,4312.95,5599.24,4312.32,5598.67,297
284,2999,3055,5562,5619,56,57,2256,0,2256,1.0,3024.6,5592.04,3024.21,5591.43,298
285,2455,2554,5564,5695,99,131,5666,0,5666,1.0,2512.96,5631.64,2512.54,5630.98,299
286,4398,4430,5565,5646,32,81,1519,0,1519,1.0,4415.84,5601.01,4415.37,5600.88,300
287,3074,3127,5576,5631,53,55,2067,0,2067,1.0,3099.74,5604.48,3099.26,5603.91,301
288,2658,2715,5579,5633,57,54,2004,0,2004,1.0,2685.94,5605.03,2685.53,5604.47,302
289,3812,3914,5580,5693,102,113,8154,0,8154,1.0,3860.81,5628.98,3860.29,5628.62,303
290,2767,2951,5581,5715,184,134,11383,0,11383,1.0,2856.99,5652.52,2856.53,5651.98,307
291,3039,3079,5581,5627,40,46,1189,0,1189,1.0,3060.63,5606.81,3060.04,5606.22,304
292,3377,3448,5581,5655,71,74,3580,0,3580,1.0,3413.56,5617.42,3413.21,5616.94,305
293,2623,2664,5582,5629,41,47,1497,0,1497,1.0,2642.39,5606.32,2641.92,5605.79,306
294,2527,2632,5585,5671,105,86,4921,600,4321,0.8780735622840886,2573.93,5619.72,2573.63,5619.3,308
295,708,981,5587,5867,273,280,43491,0,43491,1.0,866.68,5728.54,865.96,5727.99,309
296,3300,3389,5587,5699,89,112,6799,0,6799,1.0,3344.51,5645.67,3344.02,5645.11,310
297,2704,2772,5590,5648,68,58,2748,0,2748,1.0,2739.05,5619.7,2738.58,5618.97,312
298,4052,4374,5590,5773,322,183,28083,1045,27038,0.9627888758323541,4226.57,5669.08,4226.03,5668.92,311
299,2295,2392,5591,5663,97,72,4387,0,4387,1.0,2341.32,5625.85,2340.87,5625.44,313
300,6491,6968,5616,6183,477,567,139332,119,139213,0.9991459248413861,6745.31,5868.37,6744.76,5867.87,314
301,3005,3092,5617,5684,87,67,3918,0,3918,1.0,3048.72,5646.41,3048.24,5645.84,315
302,4353,4427,5619,5695,74,76,3327,35,3292,0.9894800120228434,4389.1,5656.99,4388.55,5656.44,316
303,2433,2866,5621,6229,433,608,155526,2016,153510,0.9870375371320551,2638.85,5879.26,2638.58,5878.98,317
304,2337,2408,5624,5693,71,69,2309,0,2309,1.0,2366.59,5659.95,2366.48,5659.11,318
305,2422,2468,5629,5666,46,37,1124,0,1124,1.0,2443.69,5649.2,2443.33,5648.67,319
306,2373,2454,5632,5721,81,89,3860,680,3180,0.8238341968911918,2414.54,5680.7,2413.92,5679.92,320
307,3801,4057,5636,5823,256,187,28377,3174,25203,0.8881488529442859,3937.91,5734.74,3937.26,5734.17,321
308,5674,5971,5638,6039,297,401,67965,511,67454,0.9924814242624881,5802.64,5822.69,5802.0,5822.15,322
309,4505,4608,5643,5718,103,75,3334,0,3334,1.0,4555.75,5680.14,4555.51,5679.69,323
310,3372,3459,5645,5731,87,86,5167,0,5167,1.0,3415.32,5684.22,3414.82,5683.78,324
311,2439,2517,5646,5733,78,87,4584,0,4584,1.0,2477.68,5690.07,2477.16,5689.6,325
312,2135,2294,5647,5773,159,126,10069,0,10069,1.0,2228.22,5719.99,2227.52,5719.38,326
313,0,194,5650,5957,194,307,28367,0,28367,1.0,79.38,5791.93,79.65,5791.83,327
314,4424,4459,5650,5685,35,35,685,0,685,1.0,4438.05,5671.41,4437.69,5670.66,328
315,2935,3052,5652,5784,117,132,10495,0,10495,1.0,2997.08,5715.53,2996.56,5715.12,329
316,2278,2343,5660,5742,65,82,3588,0,3588,1.0,2314.43,5699.14,2313.93,5698.81,330
317,3048,3290,5663,5911,242,248,35812,0,35812,1.0,3161.44,5790.66,3160.96,5789.98,331
318,3039,3073,5670,5702,34,32,631,0,631,1.0,3055.1,5686.19,3054.75,5685.44,332
319,4566,4642,5671,5744,76,73,3290,0,3290,1.0,4606.05,5705.05,4605.45,5704.65,333
320,109,853,5674,6340,744,666,261569,0,261569,1.0,475.41,6020.76,475.03,6019.88,334
321,2297,2402,5675,5793,105,118,5346,0,5346,1.0,2349.98,5737.05,2349.48,5736.41,335
322,4400,4514,5677,5770,114,93,6268,0,6268,1.0,4455.56,5717.56,4455.48,5717.39,336
323,6176,6756,5679,6265,580,586,176526,0,176526,1.0,6459.08,5993.54,6458.73,5992.98,338
324,4050,4259,5680,5765,209,85,8584,0,8584,1.0,4161.62,5723.93,4161.31,5723.61,337
325,4306,4431,5687,5890,125,203,13931,0,13931,1.0,4373.0,5787.04,4372.48,5786.54,339
326,4498,4573,5692,5773,75,81,3827,0,3827,1.0,4536.55,5734.4,4535.83,5733.87,340
327,2864,2941,5710,5744,77,34,1696,13,1683,0.9923349056603774,2901.91,5723.94,2901.44,5723.5,341
328,4259,4312,5711,5770,53,59,1876,0,1876,1.0,4288.49,5736.94,4287.98,5736.68,342
329,2342,2445,5717,5825,103,108,6783,0,6783,1.0,2397.86,5770.46,2397.21,5770.02,343
330,2851,3059,5719,5984,208,265,23566,1949,21617,0.9172961045574132,2957.62,5841.73,2957.12,5841.59,346
331,4571,4740,5719,5843,169,124,13207,1683,11524,0.8725675777996517,4645.98,5784.58,4645.76,5783.88,344
332,8217,8359,5721,5833,142,112,8260,0,8260,1.0,8294.26,5770.76,8293.52,5770.4,345
333,2438,2489,5722,5790,51,68,2400,0,2400,1.0,2464.31,5756.32,2463.8,5755.69,347
334,2283,2317,5724,5760,34,36,775,0,775,1.0,2298.38,5740.2,2297.96,5739.8,348
335,4156,4252,5731,5821,96,90,4894,0,4894,1.0,4208.41,5772.78,4207.81,5772.32,349
336,3670,4057,5733,6044,387,311,67538,1203,66335,0.9821878053836359,3848.32,5889.11,3848.0,5888.52,350
337,4414,4539,5739,5893,125,154,10123,267,9856,0.9736244196384471,4479.67,5819.67,4479.09,5819.13,351
338,7766,8287,5739,6480,521,741,253326,2886,250440,0.9886075649558277,8050.89,6116.29,8050.55,6115.66,353
339,3473,3580,5740,5967,107,227,14527,0,14527,1.0,3528.36,5839.87,3527.86,5839.51,352
340,2061,2219,5742,5834,158,92,7157,1318,5839,0.8158446276372782,2142.42,5783.52,2141.33,5783.35,354
341,4029,4239,5744,5892,210,148,18647,0,18647,1.0,4132.34,5816.05,4132.05,5815.63,355
342,6817,8020,5745,6844,1203,1099,764034,6332,757702,0.9917124107042357,7362.12,6301.56,7361.75,6300.71,356
343,4241,4333,5750,5838,92,88,4972,0,4972,1.0,4281.62,5796.72,4281.27,5796.23,357
344,2207,2303,5754,5823,96,69,4475,0,4475,1.0,2256.84,5789.97,2256.3,5789.43,359
345,4426,4462,5754,5808,36,54,1484,46,1438,0.9690026954177897,4444.83,5780.63,4444.35,5780.18,358
346,3004,3139,5759,5967,135,208,15122,1233,13889,0.9184631662478508,3065.85,5867.65,3065.37,5867.1,360
347,4513,4574,5767,5805,61,38,1752,0,1752,1.0,4544.31,5783.73,4543.82,5783.24,361
348,2777,2953,5772,5927,176,155,14943,1398,13545,0.906444489058422,2866.48,5855.9,2865.96,5855.34,362
349,3560,3724,5779,5958,164,179,21250,0,21250,1.0,3627.3,5860.14,3626.99,5859.67,363
350,2283,2355,5785,5870,72,85,4407,0,4407,1.0,2321.25,5824.83,2320.68,5824.37,364
351,2743,2795,5786,5844,52,58,1967,0,1967,1.0,2767.24,5812.72,2766.75,5812.32,365
352,2129,2215,5788,5924,86,136,7871,0,7871,1.0,2176.63,5858.96,2176.22,5858.22,366
353,4547,4618,5788,5876,71,88,3552,0,3552,1.0,4578.36,5836.76,4577.91,5836.0,367
354,992,1030,5795,5848,38,53,1268,0,1268,1.0,1008.14,5822.15,1007.81,5821.67,368
355,3418,3505,5798,6000,87,202,14779,0,14779,1.0,3459.24,5895.16,3458.71,5894.73,370
356,2380,2441,5799,5888,61,89,3588,0,3588,1.0,2416.86,5841.87,2416.18,5841.32,369
357,4707,4801,5800,5965,94,165,8571,8,8563,0.9990666199976665,4748.21,5890.14,4747.81,5889.5,371
358,5841,6310,5801,6342,469,541,169790,0,169790,1.0,6055.94,6073.94,6055.25,6073.7,372
359,4513,4553,5805,5870,40,65,1732,0,1732,1.0,4535.65,5843.09,4535.13,5842.23,373
360,2200,2229,5810,5858,29,48,844,0,844,1.0,2213.55,5832.42,2213.09,5832.05,375
361,2068,2132,5811,5889,64,78,3170,972,2198,0.6933753943217665,2103.15,5847.65,2102.64,5847.22,374
362,4228,4261,5815,5864,33,49,1037,0,1037,1.0,4244.81,5836.59,4244.28,5836.32,376
363,2257,2306,5816,5893,49,77,2427,0,2427,1.0,2279.22,5858.71,2278.82,5858.03,377
364,2016,2094,5819,5905,78,86,3909,0,3909,1.0,2055.76,5868.88,2055.14,5868.12,378
365,2215,2272,5819,5904,57,85,2972,1363,1609,0.5413862718707941,2238.64,5859.32,2238.3,5858.71,379
366,2330,2399,5819,5911,69,92,3999,0,3999,1.0,2365.49,5867.55,2364.86,5867.0,380
367,4242,4369,5830,5963,127,133,10406,0,10406,1.0,4313.96,5891.47,4313.35,5891.04,381
368,4604,4646,5831,5877,42,46,1340,0,1340,1.0,4625.59,5852.43,4625.0,5852.07,382
369,4395,4443,5834,5874,48,40,1187,0,1187,1.0,4419.04,5855.13,4418.59,5854.61,383
370,4636,4716,5835,5904,80,69,3776,0,3776,1.0,4676.49,5865.3,4675.89,5864.9,384
371,0,174,5840,6105,174,265,26505,0,26505,1.0,68.81,5987.69,68.98,5987.42,385
372,3210,3393,5848,6081,183,233,28306,254,28052,0.9910266374620221,3301.55,5954.07,3300.93,5953.7,386
373,4054,4210,5861,6009,156,148,15454,0,15454,1.0,4140.16,5926.41,4139.55,5925.98,387
374,2275,2337,5862,5924,62,62,2214,0,2214,1.0,2310.2,5896.28,2309.55,5895.55,393
375,4509,4597,5863,5939,88,76,4073,0,4073,1.0,4552.54,5900.61,4552.13,5900.17,388
376,3924,4139,5865,6155,215,290,31760,3916,27844,0.8767002518891688,4037.75,6010.51,4037.25,6009.99,390
377,4201,4300,5865,6019,99,154,9863,0,9863,1.0,4245.83,5942.01,4245.4,5941.51,391
378,4347,4517,5865,6093,170,228,24956,0,24956,1.0,4427.83,5982.85,4427.46,5982.39,389
379,4441,4537,5866,5957,96,91,3832,0,3832,1.0,4485.97,5910.08,4485.52,5909.61,392
380,4576,4614,5868,5912,38,44,1194,0,1194,1.0,4596.67,5888.15,4596.08,5887.71,394
381,4611,4655,5868,5919,44,51,1482,0,1482,1.0,4632.32,5894.43,4631.82,5893.92,395
382,2084,2171,5873,5954,87,81,4130,0,4130,1.0,2130.07,5914.2,2129.4,5913.47,396
383,2362,2452,5873,5965,90,92,5500,0,5500,1.0,2406.26,5920.22,2405.86,5919.56,397
384,2226,2277,5882,5953,51,71,2472,0,2472,1.0,2250.3,5917.4,2249.86,5916.89,398
385,4629,4722,5892,5974,93,82,4560,0,4560,1.0,4674.67,5929.04,4674.25,5928.64,399
386,2192,2232,5902,5948,40,46,1009,0,1009,1.0,2214.24,5925.88,2213.7,5925.46,400
387,3104,3239,5902,6132,135,230,23195,0,23195,1.0,3175.68,6015.23,3175.12,6014.72,401
388,2013,2125,5904,6032,112,128,7069,0,7069,1.0,2075.36,5963.91,2074.27,5963.95,402
389,2819,2925,5904,6005,106,101,7158,0,7158,1.0,2865.22,5952.33,2864.91,5951.85,403
390,2304,2373,5906,5985,69,79,3623,0,3623,1.0,2337.87,5945.7,2337.49,5945.17,404
391,4777,4807,5908,5944,30,36,701,0,701,1.0,4792.94,5924.84,4792.43,5924.45,405
392,4576,4634,5909,5975,58,66,2454,0,2454,1.0,4608.49,5941.36,4607.91,5940.92,406
393,2238,2309,5914,5998,71,84,3577,0,3577,1.0,2278.88,5955.34,2278.24,5954.89,408
394,7188,7350,5914,6070,162,156,9359,0,9359,1.0,7281.45,5984.71,7280.36,5984.91,407
395,2156,2223,5924,5979,67,55,2107,0,2107,1.0,2186.76,5949.86,2186.43,5949.45,409
396,4676,4747,5925,6003,71,78,2898,0,2898,1.0,4710.63,5966.25,4710.22,5965.63,410
397,3550,3825,5927,6167,275,240,42632,978,41654,0.9770594858322387,3685.26,6045.63,3684.81,6045.12,411
398,4509,4548,5927,5980,39,53,1432,0,1432,1.0,4529.33,5955.08,4528.84,5954.42,412
399,4543,4582,5929,5984,39,55,1662,0,1662,1.0,4561.54,5958.55,4561.05,5957.94,413
400,2782,2823,5930,6003,41,73,1867,0,1867,1.0,2803.82,5972.59,2803.43,5971.77,415
401,2417,2477,5931,5977,60,46,1852,0,1852,1.0,2448.5,5955.92,2447.95,5955.42,414
402,2897,2950,5939,5979,53,40,1155,0,1155,1.0,2923.59,5959.35,2923.07,5958.9,416
403,2936,2994,5939,5970,58,31,1056,0,1056,1.0,2969.97,5952.18,2968.91,5951.56,417
404,4784,4862,5948,6066,78,118,4476,0,4476,1.0,4821.88,6006.35,4821.47,6005.97,418
405,2170,2256,5949,6034,86,85,3756,0,3756,1.0,2213.58,5993.83,2213.04,5993.31,419
406,4259,4359,5951,6064,100,113,7819,0,7819,1.0,4313.35,6009.58,4312.74,6009.07,420
407,2123,2195,5953,6003,72,50,2134,0,2134,1.0,2157.11,5976.0,2156.79,5975.59,421
408,3022,3121,5954,6100,99,146,11343,0,11343,1.0,3076.65,6027.86,3076.06,6027.28,422
409,4621,4681,5954,6020,60,66,2256,0,2256,1.0,4652.39,5984.51,4651.81,5984.09,423
410,3398,3601,5958,6204,203,246,36761,0,36761,1.0,3491.17,6091.64,3490.78,6091.04,425
411,2369,2434,5959,6032,65,73,3435,0,3435,1.0,2399.97,5994.08,2399.52,5993.62,424
412,4474,4649,5959,6160,175,201,20687,191,20496,0.9907671484507179,4553.2,6062.38,4553.0,6061.78,426
413,4686,4791,5959,6065,105,106,6589,0,6589,1.0,4740.68,6012.99,4740.1,6012.5,427
414,2866,3049,5960,6180,183,220,28570,0,28570,1.0,2945.43,6065.86,2945.03,6065.34,428
415,1926,2027,5963,6074,101,111,6717,2648,4069,0.6057763882685723,1972.62,6013.18,1972.14,6012.73,429
416,7058,7192,5963,6070,134,107,6320,0,6320,1.0,7125.65,6031.51,7125.16,6030.65,430
417,2288,2376,5965,6108,88,143,7970,0,7970,1.0,2327.54,6041.83,2327.01,6041.16,431
418,2348,2377,5968,6033,29,65,1328,0,1328,1.0,2363.06,6000.6,2362.56,6000.1,432
419,2426,2472,5975,6022,46,47,1596,0,1596,1.0,2450.03,5995.7,2449.52,5995.31,433
420,4605,4649,5980,6028,44,48,1358,0,1358,1.0,4625.99,6008.84,4625.52,6008.13,434
421,2102,2171,5982,6059,69,77,3511,0,3511,1.0,2136.19,6018.36,2135.62,6017.97,435
422,2221,2298,5984,6102,77,118,5581,0,5581,1.0,2260.29,6043.55,2259.74,6042.89,436
423,2031,2110,5987,6065,79,78,3434,0,3434,1.0,2073.44,6024.96,2072.76,6024.49,437
424,4088,4291,5990,6176,203,186,26514,40,26474,0.9984913630534812,4191.61,6087.4,4191.17,6086.89,438
425,4662,4699,5992,6031,37,39,821,0,821,1.0,4682.98,6012.43,4682.31,6011.93,439
426,2187,2246,5999,6052,59,53,1237,0,1237,1.0,2215.64,6031.78,2215.73,6030.64,442
427,2782,2827,5999,6015,45,16,539,0,539,1.0,2802.78,6006.56,2802.55,6006.0,440
428,2674,2870,5999,6220,196,221,30345,0,30345,1.0,2785.32,6108.91,2784.73,6108.41,441
429,4848,4958,6001,6109,110,108,5858,0,5858,1.0,4902.66,6056.98,4902.1,6056.36,443
430,4722,4841,6005,6102,119,97,6085,0,6085,1.0,4782.05,6062.53,4781.61,6061.86,444
431,2366,2442,6013,6072,76,59,2544,0,2544,1.0,2403.04,6044.61,2402.71,6043.81,445
432,3813,4076,6015,6195,263,180,26990,1168,25822,0.9567247128566135,3922.86,6108.09,3922.76,6107.68,446
433,2408,2605,6018,6256,197,238,23517,0,23517,1.0,2502.71,6141.23,2502.17,6140.51,447
434,3173,3409,6019,6253,236,234,38583,602,37981,0.9843972734105694,3300.78,6145.17,3300.26,6144.61,448
435,4647,4693,6020,6068,46,48,1560,0,1560,1.0,4670.09,6043.39,4669.55,6042.87,449
436,2123,2244,6024,6164,121,140,10226,0,10226,1.0,2183.89,6098.15,2183.39,6097.45,450
437,1955,2039,6030,6118,84,88,4725,28,4697,0.9940740740740741,1996.95,6080.99,1996.52,6080.38,451
438,2022,2085,6031,6101,63,70,3155,749,2406,0.7625990491283676,2051.62,6067.68,2051.13,6067.11,452
439,4286,4406,6039,6176,120,137,9200,1528,7672,0.8339130434782609,4348.2,6104.38,4347.79,6104.01,453
440,4617,4717,6046,6151,100,105,5190,0,5190,1.0,4660.75,6102.19,4660.52,6101.75,454
441,0,658,6047,8115,658,2068,1002027,0,1002027,1.0,263.02,7116.74,263.15,7116.1,456
442,2074,2134,6047,6117,60,70,2714,0,2714,1.0,2104.95,6082.15,2104.36,6081.71,455
443,4831,4887,6055,6105,56,50,1671,0,1671,1.0,4859.17,6082.48,4858.68,6081.83,457
444,4675,4738,6057,6127,63,70,2799,0,2799,1.0,4707.35,6090.72,4706.83,6090.25,458
445,2318,2438,6064,6206,120,142,9929,0,9929,1.0,2375.93,6135.02,2375.54,6134.65,459
446,4383,4495,6071,6197,112,126,8679,0,8679,1.0,4437.11,6125.89,4436.71,6125.62,460
447,4772,4876,6078,6201,104,123,6905,0,6905,1.0,4831.2,6134.01,4830.48,6133.65,461
448,2242,2324,6080,6151,82,71,4329,0,4329,1.0,2284.61,6114.56,2284.1,6114.07,462
449,4582,4703,6081,6195,121,114,5815,0,5815,1.0,4639.94,6144.63,4639.4,6143.88,463
450,4864,4944,6088,6177,80,89,4192,0,4192,1.0,4902.07,6139.7,4901.5,6138.92,464
451,2950,3162,6089,6257,212,168,23415,0,23415,1.0,3048.06,6172.97,3047.67,6172.4,465
452,4914,4983,6095,6170,69,75,3124,0,3124,1.0,4951.51,6128.85,4950.92,6128.48,466
453,2056,2168,6099,6237,112,138,8093,1886,6207,0.7669591004571852,2120.71,6163.16,2120.25,6162.92,467
454,2011,2082,6101,6169,71,68,3164,0,3164,1.0,2045.82,6131.97,2045.31,6131.57,468
455,4722,4796,6101,6173,74,72,3798,0,3798,1.0,4760.21,6136.77,4759.66,6136.25,469
456,3550,3772,6107,6365,222,258,32635,0,32635,1.0,3671.47,6236.8,3670.89,6236.29,470
457,1940,2021,6108,6172,81,64,3375,0,3375,1.0,1978.87,6138.21,1978.4,6137.69,471
458,4264,4363,6108,6207,99,99,4918,12,4906,0.9975599837332249,4313.71,6158.17,4313.22,6157.71,472
459,395,925,6117,6850,530,733,159500,0,159500,1.0,605.86,6458.11,605.83,6457.31,473
460,3734,3977,6118,6354,243,236,31354,0,31354,1.0,3847.49,6228.98,3847.12,6228.63,474
461,2228,2297,6121,6174,69,53,1780,0,1780,1.0,2258.66,6151.31,2258.23,6150.63,475
462,4666,4786,6127,6279,120,152,9223,0,9223,1.0,4727.97,6210.49,4727.52,6209.85,476
463,3083,3181,6128,6291,98,163,9237,0,9237,1.0,3140.3,6225.43,3139.78,6224.52,477
464,6530,6950,6134,6693,420,559,147394,0,147394,1.0,6720.62,6416.68,6720.49,6416.53,478
465,4558,4681,6138,6247,123,109,6798,28,6770,0.9958811415122095,4614.35,6193.34,4614.01,6192.8,479
466,2158,2516,6140,6523,358,383,65700,36,65664,0.9994520547945206,2326.26,6326.34,2325.79,6325.59,480
467,2078,2273,6143,6379,195,236,25242,3345,21897,0.8674827668172094,2189.74,6266.26,2189.04,6265.86,481
468,4945,5052,6143,6223,107,80,4809,2968,1841,0.38282387190684136,4995.91,6181.36,4995.38,6180.88,482
469,1915,1977,6146,6206,62,60,2121,0,2121,1.0,1946.19,6174.3,1945.66,6173.83,483
470,4451,4653,6148,6309,202,161,17224,1672,15552,0.9029261495587553,4544.68,6231.58,4544.35,6231.23,484
471,1972,2038,6150,6211,66,61,2405,0,2405,1.0,2003.08,6183.89,2002.73,6183.19,485
472,4087,4257,6155,6299,170,144,19957,0,19957,1.0,4168.86,6223.05,4168.41,6222.59,486
473,3971,4120,6156,6348,149,192,20511,12,20499,0.9994149480766418,4041.03,6254.14,4040.6,6253.66,487
474,4773,4830,6157,6225,57,68,2467,0,2467,1.0,4799.28,6190.42,4798.84,6189.91,488
475,4332,4480,6159,6336,148,177,18228,49,18179,0.9973118279569892,4402.87,6249.6,4402.42,6249.08,489
476,2814,2974,6160,6320,160,160,16669,247,16422,0.9851820745095686,2891.81,6237.3,2891.35,6236.86,490
477,2051,2089,6162,6240,38,78,1760,0,1760,1.0,2071.17,6206.69,2070.43,6205.74,493
478,2025,2059,6163,6236,34,73,1707,0,1707,1.0,2044.04,6199.12,2043.53,6198.6,491
479,4241,4333,6163,6278,92,115,7024,344,6680,0.9510250569476082,4290.82,6219.76,4290.2,6219.21,492
480,1881,1949,6167,6237,68,70,3019,529,2490,0.8247764160317986,1912.67,6205.13,1912.22,6204.46,494
481,4822,4919,6171,6232,97,61,3595,0,3595,1.0,4873.24,6200.27,4872.66,6199.74,495
482,4919,4952,6171,6202,33,31,764,0,764,1.0,4936.43,6187.85,4935.86,6187.21,496
483,3335,3562,6179,6386,227,207,31004,0,31004,1.0,3444.86,6278.02,3444.31,6277.55,497
484,4981,5092,6179,6273,111,94,5895,70,5825,0.9881255301102629,5044.5,6229.02,5043.78,6228.45,498
485,1770,1893,6183,6323,123,140,11111,2551,8560,0.7704077040770407,1835.62,6257.4,1835.07,6256.87,499
486,4884,5014,6185,6274,130,89,5885,0,5885,1.0,4950.99,6237.26,4950.3,6236.61,504
487,2072,2134,6186,6281,62,95,3987,0,3987,1.0,2106.01,6233.62,2105.36,6233.17,500
488,2552,2674,6186,6278,122,92,6302,0,6302,1.0,2610.03,6230.4,2609.51,6229.99,501
489,2683,2827,6190,6308,144,118,9641,0,9641,1.0,2761.24,6243.62,2760.57,6243.17,502
490,5982,6594,6191,6761,612,570,245975,4282,241693,0.9825917268015042,6289.98,6476.44,6289.68,6476.04,503
491,1933,1982,6198,6264,49,66,1984,0,1984,1.0,1956.09,6229.4,1955.64,6228.96,505
492,1976,2043,6200,6268,67,68,2899,0,2899,1.0,2009.15,6235.72,2008.67,6235.06,506
493,3546,3658,6201,6397,112,196,11441,0,11441,1.0,3589.97,6313.15,3589.45,6312.13,507
494,4765,4832,6206,6259,67,53,2320,0,2320,1.0,4801.31,6236.04,4800.8,6235.31,508
495,1744,1793,6211,6288,49,77,2329,732,1597,0.6857020180334907,1766.96,6249.41,1766.56,6248.84,509
496,4825,4940,6215,6316,115,101,6068,0,6068,1.0,4882.68,6265.96,4882.06,6265.38,510
497,3122,3530,6221,6714,408,493,114736,2292,112444,0.9800237065960117,3318.36,6467.24,3317.8,6466.7,511
498,2563,2774,6228,6429,211,201,30756,0,30756,1.0,2664.74,6334.15,2664.28,6333.63,512
499,4647,4713,6231,6297,66,66,2896,960,1936,0.6685082872928176,4678.1,6264.55,4677.65,6264.05,513
500,1890,1938,6233,6281,48,48,1593,0,1593,1.0,1913.21,6254.72,1912.8,6254.36,514
501,1948,2036,6234,6382,88,148,7821,0,7821,1.0,1991.72,6311.12,1991.24,6310.42,515
502,2031,2080,6235,6291,49,56,1977,0,1977,1.0,2054.37,6261.74,2053.88,6261.3,516
503,2910,3242,6245,6790,332,545,107608,0,107608,1.0,3073.77,6562.62,3073.28,6561.8,517
504,2907,3078,6247,6368,171,121,14778,210,14568,0.9857896873731222,2997.81,6308.31,2997.23,6307.76,518
505,4755,4897,6250,6460,142,210,16931,0,16931,1.0,4822.02,6349.04,4821.5,6348.55,521
506,4223,4312,6252,6342,89,90,5042,0,5042,1.0,4272.39,6295.68,4271.74,6295.19,519
507,2451,2573,6253,6397,122,144,12628,0,12628,1.0,2517.64,6328.77,2517.08,6328.17,520
508,3900,3993,6254,6365,93,111,6457,0,6457,1.0,3945.98,6313.24,3945.55,6312.6,522
509,1911,1957,6260,6309,46,49,1472,0,1472,1.0,1934.23,6287.04,1933.75,6286.41,523
510,5043,5118,6261,6368,75,107,4785,2273,2512,0.5249738766980147,5082.67,6306.36,5082.27,6306.21,524
511,4991,5049,6262,6324,58,62,2638,0,2638,1.0,5019.24,6294.53,5018.86,6294.04,526
512,4687,4789,6263,6362,102,99,5158,0,5158,1.0,4739.42,6312.35,4738.94,6311.86,525
513,1870,1916,6267,6305,46,38,996,0,996,1.0,1894.85,6287.46,1894.24,6286.94,527
514,4310,4354,6268,6311,44,43,1186,0,1186,1.0,4328.68,6293.16,4328.38,6292.5,530
515,4411,4868,6268,6669,457,401,74072,287,73785,0.9961253915109624,4653.13,6458.44,4652.54,6458.0,529
516,4914,4995,6268,6384,81,116,6926,0,6926,1.0,4954.78,6324.51,4954.25,6324.04,528
517,2019,2087,6270,6370,68,100,4486,0,4486,1.0,2053.2,6325.74,2052.83,6324.89,531
518,5869,6071,6271,6505,202,234,27481,740,26741,0.9730723045012918,5961.27,6380.41,5960.79,6379.77,532
519,2746,2918,6279,6448,172,169,20144,170,19974,0.9915607625099285,2830.56,6369.47,2830.06,6368.95,533
520,1701,1798,6286,6440,97,154,8802,507,8295,0.9423994546693933,1749.66,6368.67,1749.16,6367.99,534
521,4079,4290,6286,6492,211,206,31319,0,31319,1.0,4184.68,6386.86,4184.17,6386.31,535
522,4659,4714,6295,6353,55,58,2058,0,2058,1.0,4683.7,6324.95,4683.3,6324.4,536
523,1837,1913,6298,6336,76,38,2088,0,2088,1.0,1876.03,6317.71,1875.45,6317.21,538
524,3772,3808,6298,6331,36,33,772,0,772,1.0,3785.87,6312.17,3785.58,6311.78,537
525,1909,1966,6301,6361,57,60,2230,1093,1137,0.5098654708520179,1940.99,6329.0,1940.48,6328.56,539
526,4863,4917,6304,6368,54,64,2666,0,2666,1.0,4890.17,6335.06,4889.67,6334.64,540
527,3654,3977,6306,6651,323,345,77378,0,77378,1.0,3815.91,6480.08,3815.33,6479.53,541
528,4276,4392,6306,6442,116,136,9912,223,9689,0.977502017756255,4340.54,6367.92,4340.02,6367.56,542
529,1795,1857,6318,6365,62,47,1962,0,1962,1.0,1825.5,6339.86,1825.11,6339.47,543
530,3505,3551,6318,6366,46,48,1280,0,1280,1.0,3530.36,6339.06,3529.68,6338.72,544
531,4979,5087,6318,6408,108,90,6841,886,5955,0.8704867709399211,5030.99,6358.55,5030.59,6358.07,545
532,3921,4145,6324,6529,224,205,27404,0,27404,1.0,4032.28,6431.67,4031.75,6431.16,546
533,2109,2173,6326,6417,64,91,3826,46,3780,0.9879769994772608,2140.37,6368.57,2139.95,6368.2,547
534,1850,1914,6327,6371,64,44,1708,0,1708,1.0,1887.32,6348.33,1886.64,6347.78,548
535,4387,4493,6332,6429,106,97,5528,0,5528,1.0,4430.95,6382.61,4430.83,6382.17,549
536,4692,4809,6332,6466,117,134,7268,0,7268,1.0,4749.15,6398.51,4748.75,6398.09,550
537,1854,1971,6335,6504,117,169,9318,44,9274,0.9952779566430564,1917.72,6425.99,1917.09,6425.5,552
538,3470,3520,6338,6383,50,45,1430,0,1430,1.0,3496.97,6360.06,3496.39,6359.56,551
539,2063,2128,6341,6415,65,74,2618,0,2618,1.0,2094.79,6379.44,2094.35,6378.97,553
540,3564,3679,6343,6527,115,184,13425,0,13425,1.0,3626.31,6442.28,3625.76,6441.45,554
541,5094,5139,6343,6403,45,60,1548,0,1548,1.0,5118.78,6374.95,5118.19,6374.34,555
542,3509,3557,6344,6398,48,54,1369,0,1369,1.0,3535.69,6377.4,3535.22,6376.44,557
543,2353,2483,6346,6471,130,125,11229,0,11229,1.0,2415.0,6408.7,2414.55,6408.19,556
544,1793,1852,6348,6396,59,48,1558,0,1558,1.0,1816.34,6371.79,1816.2,6371.25,558
545,2853,2990,6350,6530,137,180,13583,0,13583,1.0,2922.2,6440.17,2921.68,6439.73,559
546,1822,1897,6358,6473,75,115,5552,1803,3749,0.6752521613832853,1863.18,6410.84,1862.6,6410.44,560
547,4893,4970,6358,6470,77,112,4731,0,4731,1.0,4928.52,6413.86,4928.18,6413.52,561
548,5048,5113,6361,6435,65,74,2691,0,2691,1.0,5078.84,6399.37,5078.4,6398.86,562
549,2006,2128,6366,6477,122,111,8406,0,8406,1.0,2053.77,6424.69,2053.6,6424.13,563
550,1628,1712,6370,6520,84,150,8937,2587,6350,0.710529260378203,1673.46,6443.21,1672.9,6442.81,564
551,4482,4559,6371,6498,77,127,6132,0,6132,1.0,4518.83,6440.46,4518.35,6439.77,565
552,4949,5007,6371,6429,58,58,1935,0,1935,1.0,4977.96,6398.48,4977.53,6398.05,566
553,1954,2015,6373,6456,61,83,3823,0,3823,1.0,1983.16,6413.28,1982.82,6412.79,567
554,3497,3596,6381,6524,99,143,8239,0,8239,1.0,3545.79,6454.93,3545.19,6454.12,568
555,1783,1829,6383,6434,46,51,1422,0,1422,1.0,1801.66,6406.68,1801.3,6406.27,569
556,5113,5203,6384,6469,90,85,4193,0,4193,1.0,5155.1,6430.11,5154.7,6429.55,570
557,2445,2614,6386,6563,169,177,20059,0,20059,1.0,2533.28,6467.53,2532.73,6467.07,571
558,4224,4392,6391,6576,168,185,19302,0,19302,1.0,4312.04,6494.78,4311.45,6494.1,572
559,1758,1790,6392,6451,32,59,1077,1,1076,0.9990714948932219,1774.22,6423.07,1773.79,6422.52,573
560,4856,4916,6398,6446,60,48,1727,0,1727,1.0,4883.23,6424.42,4882.97,6423.96,574
561,4370,4493,6401,6528,123,127,11521,0,11521,1.0,4430.52,6467.61,4429.97,6467.02,575
562,4985,5066,6402,6488,81,86,4517,0,4517,1.0,5026.29,6441.27,5025.77,6440.89,576
563,2606,2771,6405,6533,165,128,14793,0,14793,1.0,2684.84,6468.47,2684.45,6467.89,577
564,5064,5144,6406,6515,80,109,5064,0,5064,1.0,5102.94,6461.74,5102.51,6461.17,578
565,2103,2214,6410,6569,111,159,9923,0,9923,1.0,2151.46,6496.15,2151.08,6495.6,579
566,1790,1839,6412,6461,49,49,1466,980,486,0.3315143246930423,1818.04,6438.81,1817.39,6438.2,580
567,4956,4991,6417,6465,35,48,1091,0,1091,1.0,4974.33,6440.4,4973.85,6439.94,581
568,7902,8415,6419,6987,513,568,190057,123,189934,0.999352825731228,8147.27,6719.76,8146.75,6719.07,582
569,1650,1834,6433,6666,184,233,22606,1791,20815,0.9207732460408741,1747.69,6542.27,1747.05,6541.96,583
570,2096,2119,6433,6471,23,38,549,0,549,1.0,2107.93,6452.87,2107.45,6452.29,584
571,1777,1861,6438,6527,84,89,4059,1829,2230,0.5493964030549396,1823.29,6484.05,1822.48,6483.24,585
572,4824,4946,6439,6514,122,75,5939,0,5939,1.0,4888.57,6473.61,4887.96,6473.08,586
573,2732,2873,6442,6568,141,126,13016,0,13016,1.0,2807.21,6504.71,2806.62,6504.24,587
574,1591,1654,6449,6589,63,140,6247,1351,4896,0.783736193372819,1622.8,6518.54,1622.36,6518.05,589
575,1906,2008,6449,6578,102,129,6919,2163,4756,0.6873825697355109,1957.2,6507.5,1956.77,6506.97,588
576,2284,2384,6449,6576,100,127,8314,0,8314,1.0,2335.48,6513.54,2334.99,6512.94,590
577,5078,5219,6455,6703,141,248,20436,0,20436,1.0,5151.76,6569.36,5151.28,6569.25,591
578,4796,4847,6458,6528,51,70,2397,0,2397,1.0,4819.26,6490.26,4818.82,6489.91,593
579,4907,4991,6458,6581,84,123,6249,0,6249,1.0,4951.05,6524.77,4950.72,6523.97,592
580,2360,2487,6462,6600,127,138,11048,0,11048,1.0,2418.85,6526.92,2418.4,6526.57,594
581,1930,2129,6463,6740,199,277,30941,623,30318,0.9798649041724573,2029.93,6591.52,2029.35,6591.09,596
582,5029,5099,6463,6576,70,113,5648,0,5648,1.0,5062.72,6522.92,5062.24,6522.28,595
583,4975,5031,6465,6549,56,84,3470,0,3470,1.0,5005.35,6508.63,5004.77,6508.07,597
584,5196,5343,6476,6655,147,179,19400,2174,17226,0.8879381443298969,5268.4,6563.73,5267.84,6563.17,598
585,625,814,6479,6853,189,374,38891,519,38372,0.9866550101565915,716.75,6650.91,716.09,6650.8,599
586,4117,4271,6486,6629,154,143,15621,0,15621,1.0,4189.91,6555.6,4189.48,6555.12,600
587,4460,4572,6486,6590,112,104,8201,0,8201,1.0,4522.25,6537.97,4521.6,6537.4,601
588,4823,4863,6489,6539,40,50,954,0,954,1.0,4845.15,6514.4,4844.46,6514.0,602
589,1825,1974,6499,6675,149,176,12486,0,12486,1.0,1903.03,6585.78,1902.33,6585.11,603
590,1896,1931,6500,6544,35,44,1052,237,815,0.7747148288973384,1911.72,6524.07,1911.29,6523.43,604
591,3953,4168,6500,6746,215,246,32259,3,32256,0.9999070026969218,4059.86,6617.48,4059.36,6617.02,605
592,2531,2652,6502,6643,121,141,11428,0,11428,1.0,2595.92,6575.49,2595.37,6574.89,606
593,2185,2312,6504,6643,127,139,11843,0,11843,1.0,2246.07,6571.68,2245.63,6571.23,607
594,3638,3679,6504,6560,41,56,1608,0,1608,1.0,3661.62,6532.08,3661.09,6531.55,608
595,8800,9237,6504,7034,437,530,150707,470,150237,0.9968813658290591,9008.86,6792.09,9008.41,6791.3,610
596,4824,4925,6505,6653,101,148,10503,0,10503,1.0,4874.76,6579.55,4874.36,6579.06,609
597,2826,2935,6507,6626,109,119,6719,0,6719,1.0,2886.66,6566.16,2886.11,6565.67,611
598,8360,8836,6508,6973,476,465,161581,0,161581,1.0,8609.6,6735.04,8609.07,6734.64,612
599,3007,3916,6513,7160,909,647,290002,0,290002,1.0,3427.12,6852.39,3426.91,6851.86,614
600,2632,2788,6514,6647,156,133,12759,0,12759,1.0,2706.1,6582.03,2705.69,6581.53,613
601,3416,3543,6522,6681,127,159,11402,1566,9836,0.8626556744430801,3489.28,6609.15,3488.51,6608.54,615
602,4344,4510,6526,6735,166,209,25226,0,25226,1.0,4422.6,6625.52,4422.15,6625.01,616
603,2399,2555,6540,6719,156,179,18224,0,18224,1.0,2474.97,6627.72,2474.51,6627.26,617
604,7402,8191,6540,7445,789,905,452497,0,452497,1.0,7777.04,7008.45,7776.63,7007.88,620
605,4974,5008,6541,6565,34,24,599,0,599,1.0,4989.01,6554.58,4988.66,6553.97,618
606,5005,5060,6541,6635,55,94,2785,0,2785,1.0,5029.43,6588.32,5029.0,6588.15,619
607,9124,9460,6542,7024,336,482,80920,1686,79234,0.9791646070192783,9291.33,6796.73,9290.56,6796.07,621
608,4605,4889,6543,6921,284,378,42939,301,42638,0.9929900556603554,4739.09,6748.06,4738.67,6747.38,622
609,4444,4689,6548,6929,245,381,51771,0,51771,1.0,4571.0,6747.93,4570.57,6747.55,623
610,2088,2203,6557,6684,115,127,9728,0,9728,1.0,2142.25,6617.41,2141.79,6617.01,624
611,4972,5011,6560,6610,39,50,1324,0,1324,1.0,4993.06,6584.43,4992.61,6583.93,627
612,1802,1884,6561,6688,82,127,6584,0,6584,1.0,1845.11,6620.21,1844.57,6619.87,625
613,1497,1631,6562,6671,134,109,6637,0,6637,1.0,1577.8,6620.08,1576.63,6620.17,626
614,1617,1662,6564,6648,45,84,2523,0,2523,1.0,1641.06,6608.1,1640.53,6607.46,628
615,2752,2872,6565,6689,120,124,8464,0,8464,1.0,2820.65,6624.88,2819.96,6624.4,629
616,2257,2401,6569,6725,144,156,15152,0,15152,1.0,2333.37,6644.15,2332.85,6643.71,630
617,4230,4354,6571,6728,124,157,13816,0,13816,1.0,4302.18,6642.05,4301.55,6641.66,631
618,5044,5089,6572,6636,45,64,1935,0,1935,1.0,5066.26,6602.72,5065.63,6602.22,632
619,4915,5002,6575,6662,87,87,4879,336,4543,0.9311334289813487,4953.45,6617.36,4953.12,6616.74,633
620,1649,1737,6577,6664,88,87,4776,0,4776,1.0,1694.79,6620.5,1694.24,6620.08,634
621,3775,4057,6597,6905,282,308,48451,0,48451,1.0,3926.27,6728.25,3925.83,6728.08,635
622,767,980,6600,6900,213,300,39733,1390,38343,0.9650164850376262,876.72,6743.91,876.22,6743.5,636
623,1525,1556,6606,6638,31,32,566,0,566,1.0,1542.71,6625.68,1542.06,6624.98,638
624,4986,5026,6606,6658,40,52,1451,0,1451,1.0,5006.65,6632.98,5006.15,6632.42,637
625,2858,2931,6609,6697,73,88,4065,0,4065,1.0,2894.2,6651.76,2893.64,6651.38,639
626,2693,3031,6615,7009,338,394,84171,0,84171,1.0,2857.1,6828.82,2856.53,6828.15,640
627,2615,2706,6616,6703,91,87,5046,0,5046,1.0,2656.59,6662.54,2656.26,6662.08,641
628,4965,5129,6617,6787,164,170,15104,0,15104,1.0,5051.99,6713.43,5051.55,6712.86,643
629,1736,1844,6618,6722,108,104,6588,0,6588,1.0,1788.26,6675.98,1787.82,6675.46,642
630,4124,4319,6620,6851,195,231,29652,11,29641,0.9996290300822879,4221.52,6741.96,4221.07,6741.4,644
631,6041,6759,6622,7129,718,507,205531,2488,203043,0.9878947701319996,6445.73,6849.27,6444.57,6848.83,645
632,4867,4978,6628,6753,111,125,6255,0,6255,1.0,4919.13,6687.89,4919.05,6687.7,646
633,2130,2270,6630,6775,140,145,12338,0,12338,1.0,2195.38,6697.06,2194.92,6696.65,647
634,5210,5262,6631,6727,52,96,2599,0,2599,1.0,5238.33,6680.96,5237.57,6680.11,648
635,6692,7152,6634,7176,460,542,180967,0,180967,1.0,6932.53,6905.55,6931.92,6905.12,649
636,2471,2774,6636,6983,303,347,52640,0,52640,1.0,2629.04,6801.89,2628.68,6801.54,650
637,5130,5242,6636,6772,112,136,9272,0,9272,1.0,5183.9,6704.59,5183.26,6704.3,651
638,5250,5333,6637,6777,83,140,6761,146,6615,0.9784055613074989,5293.35,6698.89,5292.8,6698.68,652
639,1605,1688,6641,6760,83,119,6590,0,6590,1.0,1645.99,6699.34,1645.68,6698.83,653
640,1518,1612,6644,6695,94,51,3280,0,3280,1.0,1566.89,6669.74,1566.38,6669.27,654
641,4937,5034,6648,6721,97,73,4491,0,4491,1.0,4986.89,6684.36,4986.41,6683.84,655
642,1667,1747,6653,6710,80,57,2301,0,2301,1.0,1704.85,6678.77,1704.62,6678.84,656
643,2019,2133,6654,6790,114,136,10957,0,10957,1.0,2075.85,6720.84,2075.34,6720.35,658
644,4775,4901,6654,6790,126,136,11966,547,11419,0.9542871469162627,4834.93,6716.62,4834.47,6716.19,657
645,1874,2030,6658,6808,156,150,10282,14,10268,0.9986383971989885,1940.22,6731.49,1939.87,6730.97,659
646,1837,1941,6660,6816,104,156,5095,0,5095,1.0,1885.21,6743.53,1884.88,6742.94,660
647,1416,1523,6664,6769,107,105,4106,0,4106,1.0,1474.0,6722.44,1473.36,6721.8,662
648,2331,2482,6668,6894,151,226,25356,0,25356,1.0,2401.91,6782.53,2401.45,6781.99,663
649,5092,5147,6678,6757,55,79,2635,0,2635,1.0,5119.38,6719.2,5118.78,6718.55,664
650,7112,7496,6679,7205,384,526,112693,0,112693,1.0,7295.59,6971.12,7295.22,6970.09,665
651,1683,1718,6685,6729,35,44,1030,0,1030,1.0,1699.14,6704.45,1698.62,6704.13,666
652,1489,1635,6687,6827,146,140,12215,0,12215,1.0,1551.78,6747.57,1551.37,6747.37,667
653,2189,2339,6688,6921,150,233,25190,0,25190,1.0,2267.26,6809.27,2266.72,6808.69,668
654,1673,1866,6698,6869,193,171,18953,0,18953,1.0,1761.26,6774.37,1760.92,6773.83,669
655,4302,4518,6698,6901,216,203,22375,3645,18730,0.8370949720670391,4411.74,6798.29,4410.99,6797.73,670
656,5233,5301,6719,6810,68,91,3725,0,3725,1.0,5266.0,6765.36,5265.56,6764.91,671
657,7080,7188,6719,6826,108,107,3747,0,3747,1.0,7132.6,6775.16,7131.98,6774.44,672
658,995,1261,6725,6978,266,253,39939,0,39939,1.0,1137.39,6851.94,1136.77,6851.42,673
659,4897,4969,6728,6767,72,39,1682,0,1682,1.0,4931.85,6744.57,4931.45,6744.21,674
660,4052,4080,6735,6772,28,37,558,0,558,1.0,4062.62,6749.83,4062.24,6749.68,675
661,1601,1692,6739,6839,91,100,4771,0,4771,1.0,1650.68,6790.18,1650.32,6789.61,676
662,4872,4965,6739,6860,93,121,6250,0,6250,1.0,4914.84,6805.67,4914.36,6805.0,677
663,2057,2211,6743,6982,154,239,27149,0,27149,1.0,2130.4,6863.1,2129.93,6862.59,678
664,3987,4234,6744,7045,247,301,47075,3790,43285,0.9194901752522571,4103.6,6898.91,4103.16,6898.51,679
665,5178,5267,6746,6851,89,105,4762,0,4762,1.0,5224.94,6794.74,5224.43,6794.23,681
666,1425,1499,6747,6834,74,87,4252,0,4252,1.0,1463.88,6788.54,1463.3,6788.1,680
667,1326,1455,6752,6925,129,173,12513,0,12513,1.0,1396.41,6846.14,1395.77,6845.49,682
668,1805,1931,6754,6878,126,124,9328,0,9328,1.0,1863.65,6818.21,1863.26,6817.67,683
669,4928,4968,6755,6822,40,67,1704,0,1704,1.0,4951.11,6782.15,4950.66,6782.01,684
670,5145,5205,6756,6825,60,69,2320,0,2320,1.0,5177.36,6792.36,5176.63,6791.86,685
671,610,957,6765,7219,347,454,83859,475,83384,0.9943357302138113,751.87,6968.17,751.4,6967.74,686
672,5053,5131,6766,6868,78,102,5362,0,5362,1.0,5093.4,6814.16,5092.94,6813.65,687
673,3002,3093,6768,6887,91,119,7229,0,7229,1.0,3044.44,6828.5,3043.98,6827.93,688
674,4959,5095,6768,6904,136,136,11205,0,11205,1.0,5020.09,6837.99,5019.74,6837.62,691
675,5112,5163,6768,6845,51,77,2026,0,2026,1.0,5141.08,6810.08,5140.29,6809.59,690
676,1881,2061,6769,7001,180,232,29524,1727,27797,0.9415052160953801,1978.77,6885.21,1978.24,6884.73,689
677,1557,1615,6774,6832,58,58,1937,19,1918,0.9901910170366546,1590.68,6800.21,1589.92,6799.77,692
678,955,1040,6778,6918,85,140,6631,0,6631,1.0,998.82,6864.03,998.23,6863.13,693
679,2481,2565,6779,6850,84,71,2759,0,2759,1.0,2519.14,6813.78,2518.87,6813.42,694
680,4171,4414,6786,7125,243,339,50574,600,49974,0.9881361964645865,4292.73,6967.53,4292.31,6966.81,695
681,1336,1379,6790,6843,43,53,1619,101,1518,0.9376158122297714,1358.38,6819.84,1357.89,6819.16,696
682,1524,1603,6791,6932,79,141,6404,2049,4355,0.6800437226733291,1562.15,6862.38,1561.7,6861.87,697
683,3788,4025,6808,7090,237,282,37595,1618,35977,0.9569623620162255,3914.63,6945.61,3914.06,6945.01,698
684,1437,1527,6812,6941,90,129,7516,294,7222,0.9608834486428952,1483.24,6875.03,1482.76,6874.56,699
685,4630,4799,6813,7032,169,219,17649,0,17649,1.0,4720.65,6923.23,4719.78,6922.3,700
686,5249,5381,6814,6964,132,150,8212,0,8212,1.0,5311.32,6899.18,5310.71,6898.41,702
687,2366,2753,6815,7269,387,454,103541,26,103515,0.9997488917433673,2556.84,7039.83,2556.4,7039.51,701
688,8340,8376,6815,6892,36,77,1550,0,1550,1.0,8355.89,6853.44,8355.45,6852.63,703
689,1586,1656,6816,6887,70,71,3562,0,3562,1.0,1619.51,6851.52,1619.06,6851.0,704
690,1643,1759,6817,6922,116,105,8329,0,8329,1.0,1697.9,6871.14,1697.48,6870.63,705
691,5155,5258,6818,6916,103,98,6139,0,6139,1.0,5205.6,6865.39,5205.04,6864.86,706
692,5080,5176,6833,6925,96,92,5714,0,5714,1.0,5130.88,6883.33,5130.35,6882.79,707
693,4745,5049,6835,7200,304,365,49022,20,49002,0.9995920199094285,4896.09,7015.46,4895.32,7014.85,708
694,1731,1889,6847,7011,158,164,17310,1281,16029,0.925996533795494,1810.51,6925.38,1810.02,6924.95,709
695,1492,1577,6849,6971,85,122,4082,435,3647,0.8934345908868202,1528.92,6924.01,1528.7,6922.75,711
696,8116,8639,6852,7417,523,565,198575,0,198575,1.0,8380.07,7144.96,8379.8,7144.51,710
697,4385,4551,6865,7079,166,214,23743,208,23535,0.9912395232278988,4466.82,6967.92,4466.36,6967.48,712
698,8584,9309,6867,7822,725,955,429485,1358,428127,0.9968380735066417,8962.99,7352.52,8962.33,7351.99,713
699,2127,2396,6868,7090,269,222,31278,0,31278,1.0,2274.7,6976.11,2274.01,6975.61,714
700,1312,1433,6874,7054,121,180,11181,0,11181,1.0,1359.84,6974.01,1359.34,6973.24,715
701,5361,5426,6878,6952,65,74,2891,720,2171,0.7509512279488066,5394.23,6911.6,5393.64,6911.28,716
702,3622,3883,6879,7141,261,262,41690,0,41690,1.0,3729.91,6999.23,3729.62,6998.91,717
703,1583,1667,6883,6974,84,91,5325,0,5325,1.0,1622.32,6927.62,1621.92,6927.12,718
704,5996,6334,6886,7193,338,307,51797,0,51797,1.0,6142.66,7029.13,6142.29,7028.92,719
705,4983,5087,6887,6980,104,93,5726,0,5726,1.0,5033.93,6927.18,5033.42,6926.67,720
706,5208,5300,6887,6969,92,82,4666,0,4666,1.0,5259.95,6926.2,5259.3,6925.78,721
707,5137,5229,6892,6991,92,99,5629,0,5629,1.0,5180.41,6946.14,5179.96,6945.47,722
708,1390,1452,6897,6998,62,101,3608,0,3608,1.0,1419.73,6940.25,1419.43,6940.06,723
709,4519,4709,6900,7087,190,187,24396,0,24396,1.0,4614.67,6990.16,4614.18,6989.73,724
710,4783,4898,6901,7022,115,121,9691,0,9691,1.0,4841.42,6962.73,4840.77,6961.95,725
711,633,1175,6904,7311,542,407,96068,161,95907,0.9983241037598368,907.93,7112.83,907.68,7112.39,726
712,1645,1747,6915,7015,102,100,6889,0,6889,1.0,1694.92,6960.23,1694.44,6959.79,727
713,5076,5113,6915,6982,37,67,1207,0,1207,1.0,5093.08,6942.93,5092.85,6943.26,728
714,9150,9516,6916,7237,366,321,58247,4030,54217,0.9308118873075009,9331.87,7094.48,9330.78,7093.61,729
715,5102,5140,6919,6964,38,45,1274,0,1274,1.0,5121.03,6940.38,5120.54,6939.98,730
716,1433,1540,6932,7037,107,105,7836,338,7498,0.9568657478305258,1483.2,6986.11,1482.75,6985.67,731
717,1526,1608,6933,7021,82,88,4174,0,4174,1.0,1568.72,6978.73,1568.41,6978.28,732
718,8098,8183,6937,7021,85,84,4436,0,4436,1.0,8139.78,6977.18,8139.29,6976.72,733
719,1973,2160,6938,7168,187,230,31837,0,31837,1.0,2065.12,7060.68,2064.62,7060.12,734
720,5210,5265,6946,7001,55,55,1915,0,1915,1.0,5238.99,6973.65,5238.42,6973.18,735
721,5315,5387,6948,7009,72,61,3027,0,3027,1.0,5349.69,6976.78,5349.29,6976.3,736
722,5036,5098,6949,6998,62,49,1666,0,1666,1.0,5064.91,6971.41,5064.56,6971.1,737
723,1809,1976,6950,7160,167,210,25229,2869,22360,0.8862816599944509,1894.92,7058.03,1894.41,7057.49,738
724,5243,5337,6953,7073,94,120,6498,0,6498,1.0,5287.06,7013.75,5286.66,7013.28,739
725,2703,3075,6958,7553,372,595,119047,678,118369,0.994304770384806,2859.57,7261.35,2859.1,7261.07,740
726,5100,5168,6960,7020,68,60,2617,0,2617,1.0,5132.66,6990.27,5132.19,6989.66,741
727,1596,1688,6967,7047,92,80,4132,0,4132,1.0,1639.09,7006.73,1638.82,7006.24,742
728,1678,1818,6969,7117,140,148,13948,0,13948,1.0,1747.2,7045.95,1746.71,7045.37,743
729,2891,3135,6970,7247,244,277,36503,5,36498,0.9998630249568529,3014.59,7102.28,3014.04,7101.79,744
730,5052,5115,6978,7046,63,68,3167,0,3167,1.0,5083.61,7011.69,5083.1,7011.19,746
731,5180,5246,6981,7052,66,71,3260,0,3260,1.0,5210.19,7016.2,5209.67,7015.83,747
732,5151,5185,6988,7060,34,72,1715,0,1715,1.0,5167.55,7025.2,5167.05,7024.67,748
733,6262,7084,6989,7730,822,741,302177,6,302171,0.9999801440877366,6676.57,7342.89,6676.0,7342.53,749
734,5329,5411,6992,7099,82,107,3954,0,3954,1.0,5373.77,7036.2,5373.48,7036.18,750
735,5022,5079,6993,7082,57,89,2633,1185,1448,0.5499430307633878,5044.11,7039.64,5043.79,7039.05,751
736,1402,1497,7002,7159,95,157,9542,3614,5928,0.6212534059945504,1442.03,7083.69,1441.62,7083.18,752
737,3969,4280,7006,7356,311,350,73205,0,73205,1.0,4116.29,7190.55,4115.87,7190.03,753
738,1532,1678,7012,7083,146,71,5177,74,5103,0.9857060073401583,1591.26,7043.28,1591.43,7042.94,754
739,2369,2429,7014,7066,60,52,2029,0,2029,1.0,2402.25,7037.51,2401.6,7037.01,755
740,5080,5158,7015,7149,78,134,7079,0,7079,1.0,5117.09,7082.24,5116.71,7081.72,756
741,2335,2468,7020,7192,133,172,11010,0,11010,1.0,2386.12,7105.3,2386.1,7105.22,757
742,2155,2249,7022,7102,94,80,5537,0,5537,1.0,2199.34,7058.44,2198.81,7058.03,758
743,3746,4013,7023,7222,267,199,29777,0,29777,1.0,3882.5,7123.38,3882.14,7122.91,759
744,4618,4785,7023,7245,167,222,24487,0,24487,1.0,4697.43,7131.01,4696.88,7130.52,760
745,4316,4471,7024,7216,155,192,19882,378,19504,0.9809878281862991,4401.53,7124.08,4400.97,7123.5,761
746,1477,1543,7026,7115,66,89,4344,681,3663,0.8432320441988951,1507.89,7066.29,1507.51,7065.91,762
747,1346,1411,7028,7157,65,129,5913,3,5910,0.9994926433282597,1381.12,7088.69,1380.69,7088.39,763
748,5219,5303,7030,7130,84,100,4998,2519,2479,0.4959983993597439,5260.9,7086.94,5260.27,7086.11,764
749,5287,5417,7034,7185,130,151,11889,0,11889,1.0,5350.21,7116.87,5349.6,7116.18,765
750,3388,3783,7036,7327,395,291,71618,0,71618,1.0,3569.12,7179.3,3568.93,7178.86,766
751,2315,2351,7039,7101,36,62,1419,0,1419,1.0,2332.4,7072.59,2331.93,7071.92,767
752,4466,4637,7041,7274,171,233,30035,0,30035,1.0,4552.7,7157.34,4552.21,7156.85,768
753,5343,5397,7042,7093,54,51,887,0,887,1.0,5370.94,7069.52,5370.17,7068.73,771
754,5043,5088,7046,7126,45,80,2034,0,2034,1.0,5066.9,7086.41,5066.55,7085.77,769
755,5177,5234,7046,7124,57,78,3309,0,3309,1.0,5204.44,7085.43,5203.93,7084.89,770
756,1528,1722,7049,7193,194,144,15968,2329,13639,0.8541457915831663,1619.31,7114.02,1618.85,7113.7,772
757,4800,5077,7050,7549,277,499,54217,0,54217,1.0,4974.96,7260.44,4974.54,7260.56,773
758,9407,9704,7051,7435,297,384,67290,0,67290,1.0,9564.3,7227.13,9563.85,7226.72,774
759,5145,5191,7053,7130,46,77,2183,0,2183,1.0,5166.61,7092.72,5166.28,7092.32,775
760,2152,2354,7070,7256,202,186,21336,0,21336,1.0,2267.9,7154.71,2267.24,7154.15,776
761,1702,1819,7083,7211,117,128,6631,0,6631,1.0,1750.56,7143.22,1750.39,7142.58,777
762,3034,3457,7094,7520,423,426,127708,0,127708,1.0,3242.8,7304.51,3242.34,7303.81,778
763,1680,1850,7099,7300,170,201,13226,0,13226,1.0,1775.59,7207.41,1775.0,7206.67,779
764,1484,1563,7106,7219,79,113,5041,801,4240,0.8411029557627455,1517.61,7161.28,1517.12,7160.79,780
765,5015,5091,7106,7165,76,59,2777,0,2777,1.0,5051.02,7135.67,5050.62,7135.13,781
766,5175,5296,7109,7212,121,103,5792,0,5792,1.0,5219.82,7156.94,5219.9,7156.31,782
767,5079,5183,7112,7213,104,101,5971,0,5971,1.0,5133.62,7163.38,5133.08,7162.75,783
768,1900,2034,7113,7336,134,223,18774,0,18774,1.0,1966.08,7211.65,1965.6,7211.38,784
769,1463,1501,7117,7161,38,44,1000,0,1000,1.0,1484.67,7139.64,1484.03,7139.24,785
770,4233,4468,7121,7483,235,362,50372,0,50372,1.0,4343.19,7311.92,4342.69,7311.3,786
771,3330,3389,7127,7177,59,50,1995,0,1995,1.0,3361.08,7153.89,3360.59,7153.39,787
772,7024,7678,7132,7916,654,784,385193,0,385193,1.0,7351.32,7520.04,7350.81,7519.54,789
773,2106,2245,7134,7345,139,211,20789,0,20789,1.0,2165.69,7235.61,2165.26,7235.18,788
774,1659,1706,7135,7199,47,64,1980,0,1980,1.0,1685.61,7167.91,1685.01,7167.39,790
775,5243,5316,7139,7229,73,90,3969,0,3969,1.0,5278.66,7178.61,5278.2,7178.32,791
776,1748,1990,7143,7428,242,285,33822,0,33822,1.0,1864.54,7301.8,1863.97,7301.2,792
777,1607,1636,7147,7184,29,37,762,107,655,0.8595800524934383,1621.54,7165.71,1621.08,7165.21,793
778,1370,1516,7149,7297,146,148,13724,0,13724,1.0,1442.2,7222.61,1441.82,7222.27,794
779,2319,2529,7153,7454,210,301,42328,0,42328,1.0,2424.68,7305.01,2424.21,7304.54,795
780,1494,1688,7161,7312,194,151,15150,1516,13634,0.8999339933993399,1579.74,7229.48,1579.5,7229.05,796
781,1982,2108,7161,7349,126,188,17260,0,17260,1.0,2054.13,7263.21,2053.55,7262.66,797
782,2614,2710,7161,7226,96,65,3822,0,3822,1.0,2657.78,7191.28,2657.47,7190.94,798
783,5042,5184,7161,7421,142,260,23269,0,23269,1.0,5108.04,7300.15,5107.56,7299.43,799
784,5265,5379,7163,7348,114,185,11437,1202,10235,0.894902509399318,5326.88,7254.35,5326.47,7253.91,800
785,4626,4813,7165,7294,187,129,12962,2,12960,0.9998457028236384,4738.04,7241.16,4737.14,7240.58,801
786,5348,5482,7169,7311,134,142,8527,3769,4758,0.5579922598803799,5412.69,7238.1,5412.34,7237.79,802
787,3714,4015,7172,7392,301,220,42560,0,42560,1.0,3850.13,7272.78,3849.84,7272.31,803
788,5227,5268,7175,7248,41,73,1740,0,1740,1.0,5245.87,7216.7,5245.34,7215.81,804
789,9169,9462,7179,7607,293,428,77856,2167,75689,0.9721665639128648,9336.82,7387.36,9336.31,7386.79,806
790,5151,5194,7180,7220,43,40,990,0,990,1.0,5167.84,7198.71,5167.63,7198.3,805
791,2517,2767,7185,7559,250,374,61832,3301,58531,0.9466134040626213,2637.05,7367.3,2636.67,7366.77,807
792,566,1282,7187,7953,716,766,260186,3271,256915,0.9874282244240659,937.81,7566.28,937.36,7565.57,808
793,4203,4275,7191,7300,72,109,4618,0,4618,1.0,4242.47,7237.71,4241.91,7237.58,809
794,4428,4620,7200,7363,192,163,18837,0,18837,1.0,4510.8,7289.28,4510.47,7288.73,810
795,5160,5203,7202,7254,43,52,1607,0,1607,1.0,5182.76,7228.53,5182.27,7227.99,811
796,5145,5236,7205,7340,91,135,6909,0,6909,1.0,5194.69,7281.1,5194.38,7280.16,812
797,4782,4893,7220,7343,111,123,9437,0,9437,1.0,4842.88,7281.18,4842.26,7280.7,813
798,1635,1800,7225,7475,165,250,24474,0,24474,1.0,1714.54,7356.82,1714.09,7356.36,814
799,5222,5297,7238,7356,75,118,4509,968,3541,0.7853182523841207,5255.27,7293.82,5254.79,7293.67,815
800,1579,1651,7240,7364,72,124,6187,0,6187,1.0,1614.93,7299.92,1614.58,7299.56,816
801,2168,2342,7240,7471,174,231,28259,0,28259,1.0,2257.13,7353.05,2256.59,7352.6,817
802,4878,4973,7248,7432,95,184,9837,0,9837,1.0,4931.01,7331.96,4930.51,7331.82,818
803,5366,5407,7254,7307,41,53,1346,0,1346,1.0,5383.23,7281.53,5382.85,7280.98,819
804,2508,2539,7260,7301,31,41,676,0,676,1.0,2522.94,7280.46,2522.29,7279.86,820
805,1742,1794,7269,7326,52,57,1681,0,1681,1.0,1766.92,7291.74,1766.23,7291.68,821
806,4539,4797,7270,7611,258,341,56680,0,56680,1.0,4660.15,7454.43,4659.67,7453.85,822
807,7613,8092,7274,7839,479,565,175184,0,175184,1.0,7842.24,7594.73,7841.48,7593.9,823
808,3409,3992,7275,7849,583,574,171092,0,171092,1.0,3675.89,7547.45,3675.65,7547.22,824
809,1516,1546,7279,7308,30,29,712,0,712,1.0,1531.51,7293.2,1530.96,7292.7,825
810,5281,5314,7284,7335,33,51,1301,0,1301,1.0,5297.14,7310.04,5296.64,7309.55,826
811,5359,5481,7284,7433,122,149,10714,0,10714,1.0,5410.33,7352.76,5409.88,7352.37,827
812,1393,1519,7287,7422,126,135,9668,0,9668,1.0,1447.24,7348.29,1446.94,7347.71,828
813,4701,4826,7290,7469,125,179,12108,0,12108,1.0,4767.09,7355.7,4766.67,7355.75,829
814,8374,8852,7294,7810,478,516,164217,0,164217,1.0,8599.4,7563.44,8598.93,7562.8,830
815,3782,4147,7302,7856,365,554,100745,0,100745,1.0,3966.4,7562.09,3966.03,7561.94,832
816,1486,1596,7304,7426,110,122,9261,882,8379,0.9047619047619048,1540.45,7358.95,1540.22,7358.89,831
817,1988,2185,7315,7511,197,196,22453,0,22453,1.0,2094.77,7404.52,2094.2,7404.13,833
818,5208,5250,7316,7359,42,43,1243,0,1243,1.0,5229.92,7338.17,5229.38,7337.64,834
819,5308,5362,7326,7370,54,44,1755,0,1755,1.0,5334.56,7348.68,5334.06,7348.14,835
820,5280,5322,7327,7405,42,78,1771,0,1771,1.0,5298.55,7369.26,5298.25,7368.29,839
821,8033,8497,7328,7894,464,566,164663,0,164663,1.0,8240.04,7614.31,8239.66,7613.71,836
822,5178,5228,7332,7396,50,64,2387,0,2387,1.0,5201.61,7366.89,5201.22,7366.31,837
823,4793,4915,7333,7486,122,153,14385,0,14385,1.0,4856.26,7413.47,4855.73,7412.94,838
824,4055,4241,7335,7542,186,207,27631,0,27631,1.0,4140.34,7430.29,4139.88,7429.87,840
825,5245,5291,7338,7404,46,66,1958,0,1958,1.0,5266.41,7370.83,5266.0,7370.22,841
826,4426,4559,7345,7540,133,195,19313,0,19313,1.0,4498.68,7435.54,4498.14,7435.16,842
827,1590,1629,7348,7432,39,84,2329,1557,772,0.33147273507943326,1608.31,7389.07,1607.89,7388.63,843
828,9294,9790,7355,8073,496,718,202800,0,202800,1.0,9540.08,7715.03,9539.63,7714.65,844
829,1621,1662,7356,7415,41,59,1503,0,1503,1.0,1640.66,7383.64,1640.12,7383.27,845
830,5226,5247,7360,7394,21,34,597,0,597,1.0,5236.91,7375.88,5236.4,7375.48,846
831,5300,5360,7367,7418,60,51,2137,0,2137,1.0,5331.81,7392.26,5331.26,7391.72,847
832,5376,5461,7373,7561,85,188,9492,11,9481,0.9988411293721028,5417.04,7477.69,5416.56,7476.53,848
833,4166,4381,7374,7609,215,235,21849,700,21149,0.9679619204540254,4273.06,7501.68,4272.72,7501.25,849
834,1832,2200,7378,8077,368,699,120709,0,120709,1.0,2012.75,7722.38,2012.22,7721.89,850
835,2797,3159,7382,7806,362,424,111126,0,111126,1.0,2980.53,7600.48,2980.15,7600.04,853
836,1457,1547,7383,7515,90,132,6675,47,6628,0.9929588014981273,1501.26,7457.7,1500.69,7456.99,852
837,2244,2418,7383,7622,174,239,28752,0,28752,1.0,2329.92,7503.27,2329.4,7502.73,851
838,4852,5322,7387,7970,470,583,118358,2719,115639,0.9770273238817824,5146.15,7681.59,5145.61,7681.12,854
839,5025,5156,7388,7577,131,189,13838,0,13838,1.0,5088.79,7478.57,5088.1,7478.27,855
840,1526,1578,7391,7463,52,72,2256,532,1724,0.7641843971631206,1551.47,7422.9,1550.96,7422.59,856
841,5231,5293,7392,7478,62,86,2666,829,1837,0.6890472618154538,5257.49,7438.97,5257.16,7438.43,857
842,2491,2551,7394,7451,60,57,1966,0,1966,1.0,2525.04,7429.26,2524.39,7428.62,858
843,1430,1476,7396,7481,46,85,2401,89,2312,0.9629321116201582,1454.88,7434.72,1454.4,7434.44,859
844,1622,1686,7397,7490,64,93,3875,0,3875,1.0,1653.97,7444.36,1653.49,7443.85,860
845,5261,5314,7400,7461,53,61,2122,110,2012,0.9481621112158342,5289.24,7427.14,5288.7,7426.74,861
846,513,807,7402,7804,294,402,61010,6,61004,0.999901655466317,643.72,7595.59,643.35,7595.04,862
847,1978,2097,7402,7553,119,151,10818,0,10818,1.0,2031.46,7493.88,2030.93,7493.01,863
848,5312,5375,7407,7448,63,41,1831,0,1831,1.0,5344.24,7428.56,5343.74,7428.02,864
849,1794,1832,7410,7461,38,51,1425,0,1425,1.0,1813.44,7435.45,1812.98,7434.93,865
850,1544,1604,7423,7499,60,76,3341,95,3246,0.9715653995809638,1576.4,7463.6,1575.85,7463.04,866
851,1601,1629,7427,7477,28,50,1023,47,976,0.9540566959921799,1615.04,7450.78,1614.49,7450.35,867
852,4888,4995,7428,7537,107,109,7735,0,7735,1.0,4943.0,7480.79,4942.45,7480.35,868
853,3287,3453,7430,7601,166,171,14426,0,14426,1.0,3384.92,7510.35,3384.3,7509.89,869
854,2383,2586,7434,7674,203,240,33172,11,33161,0.9996683950319547,2487.4,7556.11,2486.9,7555.72,870
855,5308,5389,7437,7493,81,56,2472,551,1921,0.7771035598705501,5350.81,7462.1,5350.24,7461.46,871
856,1660,1788,7439,7620,128,181,11817,4,11813,0.9996615046119997,1732.64,7523.22,1732.03,7522.85,872
857,2082,2256,7441,7611,174,170,19863,0,19863,1.0,2182.27,7534.82,2181.62,7534.2,873
858,4332,4506,7447,7671,174,224,23594,0,23594,1.0,4422.38,7558.99,4421.75,7558.37,874
859,6665,7196,7452,8016,531,564,173654,0,173654,1.0,6915.34,7738.04,6915.1,7737.66,875
860,1773,1859,7453,7580,86,127,8259,0,8259,1.0,1814.43,7521.06,1813.93,7520.49,876
861,5281,5357,7455,7607,76,152,8161,0,8161,1.0,5315.24,7530.46,5314.84,7529.97,877
862,1598,1652,7468,7524,54,56,1824,0,1824,1.0,1625.32,7493.51,1624.81,7493.11,878
863,6038,6794,7469,7972,756,503,200801,4179,196622,0.9791883506556243,6391.05,7738.16,6391.8,7737.32,879
864,4778,4935,7477,7630,157,153,17643,0,17643,1.0,4853.67,7552.09,4853.24,7551.59,880
865,1440,1486,7478,7611,46,133,3915,0,3915,1.0,1462.75,7549.81,1462.22,7548.82,881
866,5351,5389,7483,7535,38,52,1509,0,1509,1.0,5370.58,7509.61,5370.09,7509.08,882
867,3144,3200,7487,7577,56,90,2958,0,2958,1.0,3170.42,7532.26,3169.75,7531.63,884
868,1473,1550,7488,7616,77,128,5278,0,5278,1.0,1508.11,7558.04,1507.95,7556.9,883
869,1618,1686,7489,7587,68,98,4175,0,4175,1.0,1657.85,7536.1,1657.18,7535.73,885
870,1531,1578,7491,7540,47,49,1663,0,1663,1.0,1553.79,7517.58,1553.3,7517.0,887
871,1574,1632,7491,7553,58,62,2195,0,2195,1.0,1599.29,7524.01,1598.93,7523.44,886
872,3197,3296,7507,7559,99,52,3838,0,3838,1.0,3243.1,7530.55,3242.74,7530.1,888
873,3402,3547,7514,7733,145,219,14954,0,14954,1.0,3465.1,7627.53,3464.9,7627.45,891
874,3265,3347,7516,7560,82,44,1650,0,1650,1.0,3304.79,7543.67,3304.19,7543.04,892
875,4047,4255,7517,7754,208,237,26865,1407,25458,0.9476270240089335,4136.53,7638.81,4136.38,7638.64,889
876,4835,5028,7519,7669,193,150,17460,0,17460,1.0,4954.28,7608.03,4953.39,7607.51,890
877,2724,2804,7523,7556,80,33,1345,0,1345,1.0,2759.73,7537.92,2760.11,7537.83,893
878,5348,5381,7529,7563,33,34,783,0,783,1.0,5363.57,7547.43,5363.09,7546.81,894
879,2565,2846,7532,7788,281,256,51776,2470,49306,0.952294499381953,2695.97,7657.89,2695.59,7657.42,895
880,4484,4629,7533,7749,145,216,21346,0,21346,1.0,4553.33,7641.98,4552.89,7641.48,896
881,1539,1596,7536,7579,57,43,1674,0,1674,1.0,1568.04,7555.66,1567.57,7555.22,897
882,4169,4262,7537,7612,93,75,4375,2440,1935,0.4422857142857143,4211.47,7574.25,4211.03,7573.72,898
883,3134,3479,7548,7917,345,369,92566,0,92566,1.0,3288.55,7729.67,3288.15,7729.21,900
884,1588,1623,7549,7600,35,51,1237,0,1237,1.0,1607.5,7572.97,1606.98,7572.56,899
885,5306,5445,7549,7688,139,139,11005,229,10776,0.9791912766924126,5376.05,7612.93,5375.63,7612.4,902
886,5104,5142,7550,7584,38,34,1011,0,1011,1.0,5122.2,7567.19,5121.74,7566.71,901
887,1668,1741,7555,7637,73,82,2902,968,1934,0.6664369400413508,1707.12,7591.11,1706.66,7590.9,903
888,1616,1660,7558,7604,44,46,1094,0,1094,1.0,1635.9,7585.68,1635.35,7584.95,904
889,1707,1892,7561,7746,185,185,20134,785,19349,0.961011224793881,1800.88,7651.93,1800.25,7651.62,905
890,1524,1583,7563,7629,59,66,2360,0,2360,1.0,1557.48,7596.13,1556.79,7595.58,906
891,4203,4368,7569,7703,165,134,14290,0,14290,1.0,4285.4,7631.8,4284.88,7631.3,907
892,2268,2425,7570,7710,157,140,13774,0,13774,1.0,2356.38,7645.84,2355.77,7645.21,908
893,4615,4849,7574,7762,234,188,27513,1522,25991,0.9446806963980664,4714.85,7656.08,4714.56,7655.71,909
894,1582,1611,7576,7625,29,49,907,0,907,1.0,1594.85,7605.16,1594.29,7604.24,910
895,2095,2284,7579,7773,189,194,25591,0,25591,1.0,2183.05,7678.48,2182.55,7677.93,911
896,1657,1729,7582,7653,72,71,2405,0,2405,1.0,1685.98,7617.64,1685.92,7617.45,912
897,1501,1563,7594,7668,62,74,2400,0,2400,1.0,1529.99,7630.25,1529.55,7629.77,913
898,1625,1688,7598,7673,63,75,2447,848,1599,0.6534532080098079,1655.16,7638.29,1654.65,7637.51,914
899,1605,1637,7600,7667,32,67,1248,2,1246,0.9983974358974359,1623.31,7630.38,1622.79,7630.19,915
900,1537,1629,7618,7704,92,86,5314,2387,2927,0.5508091832894242,1583.43,7664.79,1582.93,7664.21,916
901,4332,4390,7619,7673,58,54,1702,0,1702,1.0,4362.23,7652.22,4361.74,7651.49,917
902,1470,1548,7629,7733,78,104,4409,0,4409,1.0,1508.14,7683.54,1507.7,7683.13,918
903,5287,5350,7636,7747,63,111,4114,0,4114,1.0,5317.04,7694.12,5316.58,7693.49,920
904,2502,2577,7639,7699,75,60,2731,0,2731,1.0,2541.72,7672.03,2541.05,7671.68,919
905,1686,1720,7644,7674,34,30,659,0,659,1.0,1705.05,7657.3,1704.47,7656.93,921
906,4205,4569,7652,7904,364,252,61191,0,61191,1.0,4392.49,7778.32,4391.94,7777.75,922
907,1854,1898,7656,7695,44,39,1189,632,557,0.46846089150546677,1873.93,7672.58,1873.42,7672.22,923
908,2446,2516,7659,7697,70,38,1802,0,1802,1.0,2483.71,7676.88,2483.07,7676.33,924
909,1665,1723,7660,7732,58,72,2984,0,2984,1.0,1692.99,7695.49,1692.5,7695.0,925
910,1855,1924,7663,7731,69,68,2312,0,2312,1.0,1894.73,7700.01,1894.08,7699.34,926
911,1624,1670,7665,7715,46,50,1659,0,1659,1.0,1646.35,7690.03,1645.85,7689.61,927
912,4688,4879,7668,7959,191,291,39922,4012,35910,0.899504032864085,4784.76,7810.55,4784.26,7810.07,928
913,2351,2480,7671,7850,129,179,14830,659,14171,0.9555630478759272,2425.44,7757.92,2424.83,7757.34,929
914,2227,2394,7676,7913,167,237,24609,0,24609,1.0,2311.74,7795.33,2311.2,7794.81,930
915,9179,9535,7687,8010,356,323,33048,0,33048,1.0,9313.54,7875.63,9314.13,7875.45,933
916,2456,2659,7688,7927,203,239,33163,1483,31680,0.9552814884057534,2552.0,7815.44,2551.67,7814.87,931
917,1592,1643,7690,7739,51,49,1782,0,1782,1.0,1616.48,7717.36,1616.04,7716.75,932
918,4102,4205,7691,7806,103,115,6712,0,6712,1.0,4154.81,7745.28,4154.26,7744.92,934
919,3407,3815,7695,8146,408,451,124570,0,124570,1.0,3617.34,7916.06,3616.87,7915.44,935
920,1539,1603,7696,7763,64,67,2789,0,2789,1.0,1569.78,7728.71,1569.33,7728.28,936
921,1804,1934,7701,7849,130,148,11677,0,11677,1.0,1869.39,7773.38,1869.0,7773.05,937
922,1484,1537,7705,7777,53,72,2162,1145,1017,0.4703977798334875,1504.49,7736.85,1504.22,7736.57,938
923,1639,1691,7711,7760,52,49,1816,0,1816,1.0,1663.37,7736.04,1662.94,7735.54,939
924,1746,1822,7712,7821,76,109,5000,0,5000,1.0,1781.84,7765.48,1781.34,7765.1,940
925,8634,9247,7714,8053,613,339,107458,0,107458,1.0,8946.04,7876.76,8945.37,7876.27,941
926,4547,4694,7721,7950,147,229,25748,0,25748,1.0,4623.02,7835.34,4622.48,7834.84,942
927,462,1027,7726,8236,565,510,141294,0,141294,1.0,782.29,7943.85,781.7,7943.41,943
928,1682,1717,7731,7789,35,58,1544,0,1544,1.0,1701.28,7760.5,1700.76,7759.99,944
929,1504,1558,7734,7801,54,67,1893,0,1893,1.0,1528.66,7769.02,1528.37,7768.29,945
930,1711,1751,7735,7794,40,59,1674,0,1674,1.0,1731.93,7764.45,1731.31,7763.83,946
931,3726,3830,7738,7894,104,156,6216,0,6216,1.0,3789.66,7814.04,3788.59,7813.26,947
932,1582,1655,7739,7793,73,54,2926,0,2926,1.0,1620.08,7766.06,1619.51,7765.52,948
933,2861,3188,7740,8107,327,367,82434,0,82434,1.0,3027.73,7930.72,3027.31,7930.18,949
934,2630,2887,7741,7988,257,247,45008,0,45008,1.0,2767.25,7864.38,2766.77,7863.77,950
935,8176,8723,7742,8144,547,402,128407,2108,126299,0.9835834495004167,8467.32,7956.02,8466.94,7955.62,951
936,4858,5012,7747,7945,154,198,21041,1191,19850,0.9433962264150944,4934.06,7847.31,4933.51,7846.8,952
937,5283,5366,7747,7870,83,123,4940,0,4940,1.0,5316.52,7804.69,5316.14,7804.38,953
938,1528,1605,7755,7857,77,102,4808,0,4808,1.0,1571.08,7806.16,1570.43,7805.62,954
939,1650,1697,7757,7815,47,58,1753,0,1753,1.0,1673.16,7785.67,1672.73,7785.15,955
940,4155,4210,7762,7827,55,65,1950,0,1950,1.0,4189.35,7796.76,4188.62,7796.21,956
941,2169,2262,7764,7873,93,109,7437,0,7437,1.0,2213.96,7821.65,2213.49,7821.11,957
942,5259,5295,7767,7869,36,102,2136,0,2136,1.0,5277.19,7818.97,5276.93,7818.75,958
943,7936,8253,7769,8107,317,338,57340,0,57340,1.0,8088.73,7941.24,8087.96,7940.14,959
944,2852,2925,7772,7855,73,83,3630,0,3630,1.0,2882.96,7811.65,2882.63,7811.16,960
945,4208,4237,7778,7818,29,40,787,0,787,1.0,4220.12,7800.56,4219.64,7799.86,961
946,1601,1665,7782,7827,64,45,1624,0,1624,1.0,1628.76,7805.82,1628.62,7805.24,962
947,5011,5127,7784,7918,116,134,10762,0,10762,1.0,5068.37,7847.48,5067.91,7847.06,963
948,1687,1771,7786,7896,84,110,5913,0,5913,1.0,1730.26,7835.34,1729.82,7834.91,964
949,7338,8055,7789,8502,717,713,355287,0,355287,1.0,7702.42,8126.45,7701.94,8126.11,965
950,1759,1830,7792,7860,71,68,2733,0,2733,1.0,1801.26,7827.4,1800.69,7827.01,966
951,5252,5400,7798,7958,148,160,13152,943,12209,0.9282998783454988,5334.33,7882.87,5333.72,7882.2,967
952,1511,1558,7801,7879,47,78,2098,0,2098,1.0,1529.12,7835.91,1528.67,7835.73,968
953,3950,4375,7803,8182,425,379,103940,0,103940,1.0,4178.34,7985.08,4177.57,7984.48,969
954,950,1254,7807,8121,304,314,38682,541,38141,0.9860141667959258,1088.63,7964.27,1088.4,7963.54,970
955,3815,3888,7808,7905,73,97,3979,0,3979,1.0,3846.92,7861.58,3846.42,7860.87,971
956,1592,1707,7810,7907,115,97,8353,0,8353,1.0,1653.07,7859.38,1652.5,7858.87,972
957,1823,1919,7816,7883,96,67,3643,0,3643,1.0,1868.33,7848.45,1867.72,7848.03,973
958,1912,1970,7820,7897,58,77,2924,0,2924,1.0,1943.4,7862.02,1942.82,7861.42,974
959,2305,2492,7841,8037,187,196,22655,0,22655,1.0,2413.83,7931.82,2413.14,7931.4,975
960,1516,1615,7843,7944,99,101,6631,0,6631,1.0,1563.58,7896.06,1563.11,7895.51,976
961,3773,4067,7844,8163,294,319,61757,0,61757,1.0,3909.85,8015.09,3909.47,8014.5,977
962,1754,1789,7845,7895,35,50,1217,0,1217,1.0,1771.85,7867.06,1771.38,7866.77,978
963,4315,4619,7846,8198,304,352,61481,0,61481,1.0,4462.98,8017.2,4462.33,8016.71,979
964,1782,1831,7849,7901,49,52,1564,0,1564,1.0,1803.38,7874.95,1802.99,7874.54,980
965,6105,6894,7852,8511,789,659,338098,0,338098,1.0,6537.1,8165.05,6536.5,8164.57,981
966,6848,7470,7853,8392,622,539,178283,0,178283,1.0,7129.2,8087.11,7129.11,8086.94,982
967,5081,5183,7864,7998,102,134,9678,0,9678,1.0,5132.64,7931.69,5132.13,7931.17,983
968,1834,1966,7865,7984,132,119,8449,0,8449,1.0,1908.72,7915.5,1908.11,7915.14,984
969,2143,2306,7872,8021,163,149,17096,0,17096,1.0,2216.81,7940.62,2216.43,7940.18,985
970,1696,1720,7877,7910,24,33,485,0,485,1.0,1708.21,7895.56,1707.66,7894.88,986
971,4936,5088,7878,8063,152,185,19178,1109,18069,0.9421733235999583,5010.97,7972.28,5010.49,7971.75,987
972,1785,1844,7881,7951,59,70,2276,0,2276,1.0,1810.94,7915.94,1810.69,7915.27,988
973,2636,2680,7883,7935,44,52,1340,0,1340,1.0,2661.22,7913.23,2660.65,7912.56,990
974,3106,3537,7883,8266,431,383,96434,0,96434,1.0,3306.78,8054.93,3306.53,8054.68,989
975,1702,1791,7886,7977,89,91,5269,0,5269,1.0,1749.08,7928.37,1748.45,7927.91,991
976,4763,4949,7892,8096,186,204,25563,3095,22468,0.8789265735633532,4857.85,7998.36,4857.38,7997.79,992
977,1605,1658,7895,7976,53,81,2855,0,2855,1.0,1633.41,7937.38,1632.75,7936.76,993
978,1649,1707,7900,7961,58,61,2270,34,2236,0.9850220264317181,1677.07,7925.7,1676.55,7925.43,994
979,7423,7472,7900,7935,49,35,826,0,826,1.0,7451.78,7919.82,7451.06,7919.0,995
980,1817,1860,7903,7970,43,67,1797,0,1797,1.0,1838.48,7937.94,1837.97,7937.38,996
981,4569,4793,7910,8214,224,304,42593,0,42593,1.0,4679.3,8055.64,4678.8,8055.26,998
982,2463,2715,7911,8149,252,238,43881,0,43881,1.0,2597.26,8026.16,2596.72,8025.68,997
983,8326,9250,7914,8680,924,766,457522,0,457522,1.0,8805.51,8313.8,8804.89,8313.33,999
984,1825,1913,7921,8020,88,99,4941,0,4941,1.0,1872.15,7971.06,1871.63,7970.59,1000
985,2204,2430,7921,8162,226,241,32519,0,32519,1.0,2315.34,8054.84,2314.87,8054.16,1002
986,5333,5426,7922,8026,93,104,7003,2784,4219,0.602456090247037,5383.91,7975.96,5383.4,7975.41,1001
987,1533,1684,7927,8084,151,157,13508,1308,12200,0.90316849274504,1604.92,8005.04,1604.36,8004.29,1003
988,9055,9346,7932,8265,291,333,46961,0,46961,1.0,9210.57,8085.73,9209.54,8085.07,1004
989,1655,1733,7937,8022,78,85,4888,2052,2836,0.5801963993453355,1694.95,7981.91,1694.45,7981.36,1005
990,5271,5371,7939,8075,100,136,7864,0,7864,1.0,5317.59,8008.61,5317.09,8008.11,1006
991,1757,1828,7948,8012,71,64,3146,0,3146,1.0,1795.73,7978.05,1795.09,7977.59,1007
992,5135,5254,7948,8087,119,139,11218,0,11218,1.0,5196.39,8018.42,5195.84,8017.87,1008
993,402,892,7953,8439,490,486,127012,0,127012,1.0,631.38,8168.85,631.7,8169.09,1009
994,5234,5281,7959,8025,47,66,1764,0,1764,1.0,5260.15,7990.93,5259.46,7990.36,1010
995,1884,2031,7961,8091,147,130,11703,2111,9592,0.8196189011364607,1956.96,8027.33,1956.32,8026.87,1011
996,2689,2928,7962,8283,239,321,52809,0,52809,1.0,2808.73,8114.79,2808.4,8114.41,1012
997,9146,9589,7967,8485,443,518,115453,0,115453,1.0,9384.27,8231.03,9383.37,8230.57,1013
998,1718,1779,7975,8044,61,69,2655,0,2655,1.0,1747.68,8008.66,1747.18,8008.27,1014
999,5019,5160,7981,8132,141,151,14411,0,14411,1.0,5092.46,8065.03,5091.92,8064.39,1015
1000,1810,1890,7996,8057,80,61,3294,0,3294,1.0,1847.81,8027.41,1847.36,8026.89,1016
1001,2059,2211,8003,8161,152,158,16018,0,16018,1.0,2143.12,8080.06,2142.57,8079.58,1017
1002,1766,1822,8008,8060,56,52,1817,0,1817,1.0,1794.34,8034.19,1793.8,8033.65,1018
1003,862,1133,8013,8391,271,378,59438,0,59438,1.0,992.41,8208.98,991.79,8208.47,1020
1004,0,687,8014,10201,687,2187,918179,2917,915262,0.9968230595559253,235.7,8994.59,236.06,8994.51,1019
1005,1512,1598,8016,8125,86,109,5115,0,5115,1.0,1547.34,8065.07,1546.94,8064.8,1021
1006,5239,5288,8019,8069,49,50,1534,0,1534,1.0,5263.15,8045.65,5262.69,8045.1,1023
1007,1672,1740,8020,8095,68,75,3483,0,3483,1.0,1705.69,8056.9,1705.21,8056.45,1022
1008,2411,2559,8023,8218,148,195,17520,0,17520,1.0,2480.74,8122.81,2480.28,8122.27,1025
1009,5331,5448,8023,8163,117,140,11588,0,11588,1.0,5393.3,8095.07,5392.77,8094.52,1024
1010,1747,1799,8024,8108,52,84,2363,0,2363,1.0,1771.38,8070.85,1770.9,8070.12,1026
1011,4903,5038,8040,8188,135,148,13751,0,13751,1.0,4971.36,8114.95,4970.84,8114.42,1027
1012,1735,1758,8044,8089,23,45,637,0,637,1.0,1744.49,8070.18,1744.07,8069.43,1028
1013,1850,1897,8044,8109,47,65,1904,0,1904,1.0,1875.59,8075.08,1875.11,8074.63,1031
1014,5270,5342,8044,8132,72,88,3358,0,3358,1.0,5307.22,8084.81,5306.8,8084.49,1029
1015,1782,1880,8045,8150,98,105,5389,0,5389,1.0,1832.47,8095.88,1831.83,8095.4,1030
1016,1960,2122,8048,8220,162,172,14088,708,13380,0.9497444633730835,2033.81,8139.65,2033.37,8139.13,1033
1017,7879,8399,8048,8583,520,535,187056,78,186978,0.9995830125737747,8166.54,8339.1,8165.98,8338.38,1032
1018,1638,1693,8057,8163,55,106,3938,0,3938,1.0,1667.12,8106.79,1666.64,8106.43,1034
1019,5205,5314,8060,8157,109,97,6498,0,6498,1.0,5255.97,8112.77,5255.38,8112.41,1035
1020,1866,1983,8062,8179,117,117,8438,0,8438,1.0,1928.54,8115.6,1927.9,8115.41,1036
1021,2887,3210,8065,8414,323,349,75269,0,75269,1.0,3033.66,8238.1,3033.11,8237.61,1037
1022,1535,1609,8074,8176,74,102,4758,46,4712,0.9903320722992854,1573.06,8130.8,1572.78,8130.1,1038
1023,5070,5214,8074,8193,144,119,8448,0,8448,1.0,5149.44,8137.16,5148.79,8136.62,1040
1024,1591,1658,8075,8180,67,105,4605,139,4466,0.969815418023887,1624.99,8130.04,1624.41,8129.39,1041
1025,4744,4924,8075,8253,180,178,21325,0,21325,1.0,4835.34,8156.32,4834.79,8155.9,1039
1026,3650,3968,8079,8394,318,315,65642,0,65642,1.0,3801.72,8245.09,3801.21,8244.64,1042
1027,1690,1768,8083,8149,78,66,3636,0,3636,1.0,1725.95,8115.67,1725.58,8115.15,1043
1028,3305,3893,8089,8706,588,617,188519,3567,184952,0.9810788302505318,3555.18,8397.13,3554.58,8396.67,1044
1029,2173,2332,8095,8238,159,143,13652,0,13652,1.0,2246.04,8174.09,2245.54,8173.44,1045
1030,4440,4653,8097,8359,213,262,38506,0,38506,1.0,4543.05,8226.75,4542.54,8226.27,1046
1031,1733,1833,8106,8186,100,80,5356,0,5356,1.0,1786.78,8147.01,1786.15,8146.55,1047
1032,2331,2444,8113,8234,113,121,8828,0,8828,1.0,2388.97,8178.05,2388.51,8177.45,1049
1033,4041,4082,8115,8150,41,35,735,0,735,1.0,4062.77,8134.57,4062.14,8133.93,1050
1034,5021,5129,8123,8218,108,95,4496,0,4496,1.0,5073.66,8172.12,5073.16,8171.49,1051
1035,4293,4387,8124,8215,94,91,4219,0,4219,1.0,4336.38,8170.03,4336.05,8169.64,1052
1036,5303,5384,8126,8183,81,57,3017,0,3017,1.0,5338.68,8156.53,5338.38,8156.03,1053
1037,5137,5249,8133,8315,112,182,11633,0,11633,1.0,5195.3,8234.4,5194.78,8233.63,1054
1038,5221,5316,8135,8207,95,72,4485,0,4485,1.0,5266.98,8174.89,5266.48,8174.32,1055
1039,4019,4179,8136,8305,160,169,17296,0,17296,1.0,4098.36,8212.5,4097.86,8212.06,1057
1040,4251,4300,8136,8170,49,34,1053,0,1053,1.0,4275.96,8151.76,4275.4,8151.3,1056
1041,3939,4141,8138,8387,202,249,27192,0,27192,1.0,4014.88,8275.76,4014.71,8275.01,1058
1042,1651,1756,8140,8244,105,104,6830,0,6830,1.0,1707.81,8191.38,1707.08,8190.8,1060
1043,2528,2748,8141,8383,220,242,37783,270,37513,0.9928539290156949,2643.24,8249.92,2642.68,8249.52,1059
1044,1827,1906,8142,8228,79,86,4718,0,4718,1.0,1865.6,8183.24,1865.12,8182.84,1061
1045,4642,4796,8143,8312,154,169,15976,0,15976,1.0,4719.37,8235.94,4718.95,8235.32,1062
1046,2097,2236,8148,8307,139,159,13141,0,13141,1.0,2161.86,8232.42,2161.46,8231.93,1063
1047,1870,2035,8151,8347,165,196,19624,0,19624,1.0,1948.83,8256.59,1948.31,8256.35,1064
1048,4161,4352,8153,8354,191,201,26567,0,26567,1.0,4252.92,8251.45,4252.48,8250.89,1065
1049,5312,5446,8156,8249,134,93,8782,0,8782,1.0,5382.87,8203.38,5382.21,8202.93,1066
1050,3907,3944,8159,8204,37,45,925,0,925,1.0,3927.83,8175.51,3927.41,8175.4,1067
1051,4845,5012,8162,8406,167,244,18002,0,18002,1.0,4933.73,8294.08,4933.07,8293.27,1068
1052,4940,5132,8163,8437,192,274,26520,0,26520,1.0,5042.28,8280.69,5041.95,8280.65,1069
1053,1569,1706,8167,8285,137,118,8316,3329,4987,0.5996873496873497,1635.05,8221.33,1634.65,8220.93,1070
1054,1744,1873,8167,8298,129,131,8442,0,8442,1.0,1802.78,8234.26,1802.28,8233.81,1071
1055,2001,2140,8180,8421,139,241,19663,0,19663,1.0,2074.36,8293.96,2073.88,8293.63,1072
1056,5098,5175,8188,8255,77,67,3078,0,3078,1.0,5137.63,8222.17,5137.07,8221.61,1073
1057,2361,2496,8191,8326,135,135,10731,1,10730,0.9999068120398844,2428.12,8263.03,2427.68,8262.36,1074
1058,4331,4473,8192,8387,142,195,20323,0,20323,1.0,4401.74,8289.07,4401.24,8288.63,1075
1059,2224,2386,8197,8338,162,141,14224,0,14224,1.0,2302.23,8268.56,2301.84,8267.99,1076
1060,2467,2570,8201,8362,103,161,10518,1,10517,0.9999049248906636,2521.5,8284.25,2520.99,8283.72,1077
1061,5231,5317,8202,8312,86,110,7162,1128,6034,0.8425020943870427,5273.9,8251.48,5273.3,8251.16,1078
1062,420,876,8205,8753,456,548,114930,579,114351,0.9949621508744453,638.19,8474.82,637.74,8474.27,1079
1063,1825,1887,8212,8284,62,72,2531,0,2531,1.0,1856.96,8242.84,1856.6,8242.66,1080
1064,3147,3413,8215,8589,266,374,60516,0,60516,1.0,3279.12,8388.93,3278.73,8388.19,1081
1065,7019,7642,8226,8605,623,379,135319,0,135319,1.0,7321.13,8427.64,7320.53,8426.79,1082
1066,1713,1770,8232,8292,57,60,2185,0,2185,1.0,1743.69,8259.98,1743.09,8259.54,1083
1067,2716,2920,8238,8508,204,270,34538,58,34480,0.9983206902542128,2819.65,8367.59,2819.18,8367.19,1084
1068,6647,7562,8239,9110,915,871,400376,0,400376,1.0,7142.11,8731.17,7141.34,8730.28,1085
1069,4739,4847,8243,8377,108,134,9666,42,9624,0.9956548727498448,4797.25,8311.13,4796.66,8310.62,1086
1070,1676,1742,8244,8303,66,59,2035,0,2035,1.0,1708.88,8275.93,1708.48,8275.44,1087
1071,4795,4918,8250,8462,123,212,14190,0,14190,1.0,4865.7,8371.31,4865.04,8370.31,1088
1072,5095,5173,8255,8381,78,126,5361,0,5361,1.0,5129.6,8316.96,5129.23,8316.56,1089
1073,2122,2182,8266,8367,60,101,3112,0,3112,1.0,2146.39,8313.96,2145.89,8313.53,1091
1074,1771,1851,8270,8332,80,62,2754,0,2754,1.0,1807.18,8300.61,1806.85,8300.11,1090
1075,1734,1788,8275,8355,54,80,2379,0,2379,1.0,1763.54,8318.62,1763.0,8317.88,1092
1076,4142,4174,8282,8312,32,30,549,0,549,1.0,4159.3,8300.21,4158.69,8299.49,1093
1077,1673,1811,8284,8453,138,169,10863,3520,7343,0.6759642824265857,1732.26,8374.48,1732.02,8374.02,1094
1078,768,1112,8293,8612,344,319,55608,65,55543,0.9988311034383542,959.6,8446.81,958.54,8446.31,1095
1079,4641,4757,8294,8408,116,114,9853,0,9853,1.0,4694.37,8348.07,4693.96,8347.64,1096
1080,9396,9681,8294,8882,285,588,79019,0,79019,1.0,9552.39,8566.2,9551.65,8566.42,1100
1081,1829,1901,8296,8383,72,87,4014,0,4014,1.0,1867.19,8338.71,1866.66,8338.26,1097
1082,4556,4685,8297,8519,129,222,15764,0,15764,1.0,4623.8,8429.75,4623.26,8428.72,1098
1083,5164,5249,8298,8416,85,118,6481,0,6481,1.0,5207.03,8351.77,5206.44,8351.45,1099
1084,2282,2398,8302,8385,116,83,5943,0,5943,1.0,2336.31,8347.47,2336.06,8346.78,1102
1085,2136,2460,8303,8822,324,519,78949,1466,77483,0.9814310504249579,2300.34,8550.74,2299.83,8550.57,1101
1086,2354,2536,8305,8432,182,127,14973,1132,13841,0.924397248380418,2442.74,8372.88,2442.29,8372.33,1103
1087,4075,4260,8306,8549,185,243,29015,0,29015,1.0,4168.25,8432.78,4167.75,8432.0,1104
1088,4083,4157,8310,8377,74,67,2352,0,2352,1.0,4123.76,8340.72,4122.7,8340.6,1105
1089,1902,1983,8314,8412,81,98,4905,0,4905,1.0,1948.73,8365.63,1947.85,8365.01,1106
1090,4473,4605,8321,8450,132,129,11338,0,11338,1.0,4541.71,8385.36,4541.24,8384.81,1107
1091,1787,1838,8322,8369,51,47,1736,0,1736,1.0,1813.03,8345.03,1812.5,8344.53,1108
1092,5145,5176,8322,8379,31,57,1251,0,1251,1.0,5160.81,8352.67,5160.37,8351.96,1110
1093,4240,4396,8324,8472,156,148,17556,0,17556,1.0,4312.3,8401.5,4311.89,8400.93,1109
1094,1911,2123,8330,8501,212,171,18728,0,18728,1.0,2018.43,8424.86,2017.81,8424.34,1111
1095,6190,6777,8332,8777,587,445,136161,0,136161,1.0,6441.43,8542.54,6441.46,8542.14,1112
1096,2514,2645,8336,8470,131,134,11705,0,11705,1.0,2582.78,8404.93,2582.22,8404.39,1113
1097,1764,1806,8342,8411,42,69,1373,0,1373,1.0,1783.57,8371.87,1783.28,8371.75,1114
1098,4987,5056,8344,8403,69,59,2388,0,2388,1.0,5026.06,8370.31,5025.5,8369.82,1115
1099,1887,1928,8348,8391,41,43,1073,0,1073,1.0,1910.96,8368.41,1910.22,8368.09,1116
1100,2636,2764,8350,8487,128,137,11203,0,11203,1.0,2704.89,8416.49,2704.39,8416.07,1117
1101,2790,3364,8353,8921,574,568,198995,0,198995,1.0,3094.47,8647.68,3093.6,8647.32,1118
1102,4371,4495,8361,8500,124,139,11616,0,11616,1.0,4433.29,8434.99,4432.81,8434.49,1120
1103,3905,3982,8362,8402,77,40,1797,0,1797,1.0,3944.82,8381.95,3944.25,8381.38,1121
1104,4684,4798,8362,8485,114,123,8268,0,8268,1.0,4749.8,8428.97,4749.2,8428.29,1123
1105,1790,1869,8364,8439,79,75,4211,168,4043,0.9601044882450724,1827.55,8399.12,1827.09,8398.63,1122
1106,3671,4102,8370,8787,431,417,105752,242,105510,0.997711627203268,3913.68,8579.95,3913.2,8579.43,1124
1107,4784,4837,8376,8462,53,86,2294,0,2294,1.0,4807.46,8425.13,4806.91,8424.25,1125
1108,5109,5193,8377,8484,84,107,4700,32,4668,0.9931914893617021,5150.22,8428.07,5149.65,8427.82,1126
1109,1870,1928,8378,8462,58,84,3115,0,3115,1.0,1901.2,8419.25,1900.58,8418.65,1127
1110,1859,1885,8384,8434,26,50,663,0,663,1.0,1869.11,8410.66,1869.05,8410.3,1129
1111,4964,5048,8385,8555,84,170,9301,0,9301,1.0,5003.72,8461.8,5003.33,8461.55,1128
1112,2056,2187,8389,8508,131,119,8383,0,8383,1.0,2131.86,8464.09,2131.16,8463.49,1130
1113,5027,5126,8392,8529,99,137,8499,0,8499,1.0,5071.74,8461.89,5071.25,8461.5,1131
1114,4879,5003,8393,8583,124,190,11741,0,11741,1.0,4937.47,8482.78,4937.15,8482.92,1132
1115,2364,2553,8413,8582,189,169,22207,0,22207,1.0,2451.01,8491.08,2450.65,8490.61,1133
1116,1807,1895,8425,8503,88,78,3506,0,3506,1.0,1844.35,8457.34,1844.3,8456.9,1134
1117,4673,4763,8427,8543,90,116,5533,0,5533,1.0,4715.97,8493.25,4715.33,8492.49,1135
1118,1723,1790,8437,8464,67,27,1053,0,1053,1.0,1753.36,8450.8,1753.35,8450.19,1136
1119,9231,9521,8440,8758,290,318,64791,1465,63326,0.9773888348690405,9379.03,8583.65,9378.63,8583.4,1137
1120,4449,4588,8442,8577,139,135,13233,0,13233,1.0,4522.31,8511.13,4521.73,8510.61,1138
1121,1731,1849,8445,8559,118,114,8644,0,8644,1.0,1790.49,8512.8,1789.97,8512.17,1139
1122,2609,2748,8445,8617,139,172,17479,0,17479,1.0,2680.8,8528.62,2680.28,8528.14,1140
1123,4810,4889,8450,8508,79,58,3088,0,3088,1.0,4843.28,8479.43,4843.04,8478.83,1141
1124,1843,1910,8452,8572,67,120,4981,0,4981,1.0,1874.97,8509.91,1874.54,8509.44,1142
1125,2507,2627,8456,8610,120,154,13454,0,13454,1.0,2571.37,8538.66,2570.81,8538.08,1143
1126,1722,1772,8460,8515,50,55,1510,0,1510,1.0,1742.29,8482.99,1742.02,8482.57,1145
1127,1889,2033,8460,8638,144,178,11722,0,11722,1.0,1960.77,8559.49,1960.03,8558.61,1146
1128,4742,4820,8460,8592,78,132,6521,0,6521,1.0,4784.58,8530.65,4784.16,8529.93,1144
1129,7474,8102,8460,8832,628,372,157844,0,157844,1.0,7792.12,8645.29,7791.73,8644.76,1147
1130,4198,4404,8465,8638,206,173,24759,0,24759,1.0,4301.83,8543.98,4301.34,8543.49,1148
1131,1941,2046,8469,8542,105,73,4087,0,4087,1.0,1998.1,8508.9,1997.25,8508.14,1149
1132,2736,2897,8474,8703,161,229,18828,0,18828,1.0,2821.7,8579.6,2821.28,8579.07,1150
1133,4620,4748,8475,8639,128,164,9848,1431,8417,0.8546913078797725,4686.56,8562.19,4685.98,8561.43,1151
1134,8004,8538,8477,9079,534,602,212927,0,212927,1.0,8291.02,8798.23,8290.52,8797.81,1152
1135,4788,4900,8482,8646,112,164,9699,124,9575,0.9872151768223528,4846.7,8562.41,4846.12,8562.13,1153
1136,2042,2235,8498,8622,193,124,18172,0,18172,1.0,2136.18,8557.03,2135.74,8556.54,1154
1137,4365,4469,8500,8623,104,123,8407,0,8407,1.0,4420.66,8562.58,4420.07,8562.09,1155
1138,8481,9496,8507,9139,1015,632,397359,0,397359,1.0,8954.53,8830.65,8954.46,8830.11,1156
1139,4097,4124,8509,8548,27,39,535,0,535,1.0,4107.53,8529.57,4107.12,8529.03,1157
1140,4526,4653,8514,8624,127,110,8417,0,8417,1.0,4595.94,8579.13,4595.27,8578.52,1158
1141,5009,5098,8518,8604,89,86,3832,349,3483,0.9089248434237995,5043.03,8561.52,5043.01,8560.42,1159
1142,5053,5113,8519,8678,60,159,5175,2508,2667,0.5153623188405797,5082.75,8594.03,5082.35,8593.67,1160
1143,8077,8170,8532,8614,93,82,4561,0,4561,1.0,8115.33,8567.34,8115.1,8566.88,1161
1144,8012,8082,8534,8594,70,60,2996,0,2996,1.0,8050.68,8566.32,8050.33,8565.74,1163
1145,4031,4231,8535,8697,200,162,22953,3493,19460,0.8478194571515706,4124.93,8617.89,4124.53,8617.34,1162
1146,4883,4931,8538,8609,48,71,2211,0,2211,1.0,4905.25,8570.03,4904.77,8569.62,1165
1147,1989,2045,8539,8587,56,48,1552,0,1552,1.0,2021.29,8557.6,2020.6,8557.21,1164
1148,1889,1967,8544,8683,78,139,6597,1730,4867,0.7377595876913748,1924.87,8621.52,1924.26,8620.64,1166
1149,2462,2540,8547,8638,78,91,4546,0,4546,1.0,2498.02,8596.3,2497.61,8595.67,1167
1150,4923,4992,8548,8589,69,41,1576,0,1576,1.0,4960.67,8568.71,4959.97,8568.29,1168
1151,4976,5019,8553,8620,43,67,2113,0,2113,1.0,4998.84,8588.55,4998.32,8587.94,1169
1152,1746,1912,8554,8741,166,187,19702,3308,16394,0.8320982641356207,1839.03,8633.84,1838.5,8633.43,1170
1153,4423,4531,8555,8651,108,96,6039,0,6039,1.0,4483.25,8603.18,4482.45,8602.81,1171
1154,2386,2486,8558,8672,100,114,5794,0,5794,1.0,2434.07,8612.75,2433.58,8612.36,1172
1155,2027,2109,8561,8667,82,106,4685,0,4685,1.0,2069.15,8622.42,2068.29,8621.45,1173
1156,4722,4801,8574,8683,79,109,5672,21,5651,0.9962976022566996,4756.29,8626.1,4755.9,8625.75,1175
1157,4916,4987,8583,8640,71,57,2268,0,2268,1.0,4954.04,8606.27,4953.45,8605.92,1176
1158,993,1044,8588,8661,51,73,2385,455,1930,0.8092243186582809,1018.93,8626.96,1018.37,8626.13,1177
1159,3497,3686,8591,8761,189,170,21273,0,21273,1.0,3583.16,8666.89,3582.69,8666.44,1178
1160,2689,2845,8593,8756,156,163,15841,0,15841,1.0,2772.05,8672.33,2771.49,8671.93,1179
1161,2613,2717,8594,8701,104,107,7620,0,7620,1.0,2664.81,8640.56,2664.33,8640.16,1180
1162,4442,4688,8597,8861,246,264,30260,0,30260,1.0,4600.49,8706.78,4599.83,8706.47,1181
1163,2518,2629,8600,8690,111,90,6464,0,6464,1.0,2573.45,8641.99,2572.91,8641.57,1182
1164,4905,4965,8600,8644,60,44,1329,0,1329,1.0,4929.25,8624.87,4929.26,8624.4,1183
1165,4316,4451,8603,8767,135,164,16916,0,16916,1.0,4381.49,8688.68,4380.97,8688.15,1184
1166,4816,4847,8605,8663,31,58,1215,0,1215,1.0,4832.11,8632.81,4831.59,8632.42,1185
1167,4844,4913,8605,8644,69,39,1977,819,1158,0.5857359635811836,4877.08,8625.17,4876.63,8624.7,1186
1168,4965,5082,8605,8798,117,193,14171,287,13884,0.97974737139228,5020.85,8689.17,5020.36,8688.86,1187
1169,4168,4326,8610,8764,158,154,17904,0,17904,1.0,4254.6,8691.98,4253.99,8691.43,1188
1170,2096,2227,8615,8750,131,135,8718,0,8718,1.0,2163.71,8664.05,2163.62,8664.34,1189
1171,3349,3580,8617,8904,231,287,43267,0,43267,1.0,3459.27,8778.89,3458.85,8778.28,1190
1172,5869,7064,8625,9473,1195,848,532357,6571,525786,0.9876567791914073,6545.8,8987.79,6544.67,8987.5,1191
1173,2006,2063,8628,8689,57,61,1623,0,1623,1.0,2038.72,8656.95,2038.0,8656.32,1192
1174,4668,4757,8632,8863,89,231,12274,0,12274,1.0,4707.7,8742.33,4707.25,8742.44,1193
1175,2428,2569,8634,8781,141,147,12411,0,12411,1.0,2492.48,8705.72,2492.04,8705.22,1194
1176,1960,2042,8635,8710,82,75,4240,0,4240,1.0,1999.14,8673.46,1998.67,8672.99,1195
1177,4831,4914,8638,8681,83,43,2179,0,2179,1.0,4871.47,8657.65,4871.05,8657.13,1196
1178,4784,4828,8641,8683,44,42,1191,0,1191,1.0,4804.75,8661.58,4804.34,8661.12,1197
1179,4911,4968,8641,8675,57,34,1662,0,1662,1.0,4940.32,8657.71,4939.76,8657.2,1198
1180,4837,4923,8656,8717,86,61,2867,0,2867,1.0,4886.04,8690.02,4885.26,8689.49,1199
1181,2061,2128,8657,8764,67,107,4566,0,4566,1.0,2095.78,8706.91,2095.28,8706.51,1200
1182,2215,2325,8657,8749,110,92,5284,85,5199,0.9839137017411053,2259.22,8712.7,2258.99,8712.11,1201
1183,4797,4853,8664,8732,56,68,2174,0,2174,1.0,4821.77,8698.02,4821.44,8697.38,1203
1184,4736,4814,8665,8783,78,118,5968,0,5968,1.0,4767.98,8722.78,4767.75,8722.31,1202
1185,1927,1972,8666,8704,45,38,865,0,865,1.0,1954.34,8686.82,1953.57,8686.17,1204
1186,3620,3884,8668,8925,264,257,30793,0,30793,1.0,3732.58,8789.38,3732.2,8788.71,1205
1187,2554,2681,8669,8802,127,133,11849,0,11849,1.0,2616.96,8733.18,2616.46,8732.72,1206
1188,4921,4975,8673,8708,54,35,1443,0,1443,1.0,4948.3,8691.12,4947.81,8690.65,1207
1189,1896,1984,8681,8754,88,73,3764,0,3764,1.0,1939.31,8719.88,1938.67,8719.09,1208
1190,4436,4674,8681,8983,238,302,28008,421,27587,0.9849685804055984,4554.71,8826.29,4554.23,8825.88,1209
1191,2029,2082,8687,8767,53,80,2724,0,2724,1.0,2056.77,8725.61,2056.26,8725.2,1210
1192,4047,4213,8688,8806,166,118,14298,0,14298,1.0,4128.33,8747.52,4127.88,8747.01,1211
1193,4890,4989,8693,8773,99,80,4758,0,4758,1.0,4942.54,8734.94,4941.84,8734.31,1213
1194,2145,2214,8694,8766,69,72,3182,0,3182,1.0,2180.3,8728.1,2179.78,8727.67,1212
1195,2662,2807,8695,8851,145,156,12777,0,12777,1.0,2732.61,8774.16,2732.09,8773.67,1214
1196,2117,2194,8706,8788,77,82,3321,0,3321,1.0,2148.51,8752.43,2148.22,8751.86,1215
1197,1957,2050,8707,8803,93,96,6043,0,6043,1.0,2007.54,8754.84,2006.95,8754.32,1216
1198,4823,4929,8708,8836,106,128,7668,0,7668,1.0,4879.48,8766.78,4878.88,8766.37,1217
1199,2978,3054,8717,8817,76,100,6104,0,6104,1.0,3016.55,8768.55,3016.05,8767.98,1218
1200,7487,8094,8725,9284,607,559,230029,0,230029,1.0,7775.0,9015.28,7774.61,9014.68,1219
1201,3935,4090,8729,8919,155,190,23109,0,23109,1.0,4010.58,8831.67,4010.07,8831.04,1220
1202,4783,4832,8731,8797,49,66,2145,0,2145,1.0,4806.58,8764.76,4806.15,8764.22,1222
1203,3544,3677,8732,8945,133,213,14661,0,14661,1.0,3622.35,8820.01,3621.87,8819.86,1221
1204,2424,2815,8737,9356,391,619,103345,0,103345,1.0,2599.81,9058.92,2599.6,9058.7,1223
1205,2192,2479,8738,9018,287,280,32910,0,32910,1.0,2340.5,8862.6,2339.92,8862.17,1224
1206,4310,4529,8741,9082,219,341,44457,1794,42663,0.9596463998920305,4416.27,8897.8,4415.68,8897.37,1225
1207,4199,4362,8753,8882,163,129,12309,0,12309,1.0,4286.58,8809.7,4286.01,8809.2,1227
1208,1936,1975,8754,8820,39,66,1490,0,1490,1.0,1953.96,8784.78,1953.52,8784.48,1226
1209,3772,3944,8756,8984,172,228,29439,0,29439,1.0,3860.88,8869.88,3860.39,8869.38,1228
1210,2071,2128,8758,8829,57,71,2836,0,2836,1.0,2102.43,8789.93,2101.78,8789.53,1229
1211,4895,5033,8759,8912,138,153,12246,0,12246,1.0,4962.91,8832.9,4962.24,8832.81,1230
1212,4813,4866,8760,8830,53,70,2468,932,1536,0.6223662884927067,4843.05,8795.2,4842.43,8794.71,1231
1213,2039,2089,8762,8845,50,83,2726,0,2726,1.0,2064.22,8805.67,2063.68,8805.05,1232
1214,4729,4785,8768,8826,56,58,1523,0,1523,1.0,4753.26,8794.56,4752.93,8794.02,1233
1215,2122,2232,8770,8869,110,99,6010,0,6010,1.0,2181.93,8822.19,2181.04,8821.46,1234
1216,2594,2750,8777,8933,156,156,15443,0,15443,1.0,2669.0,8858.73,2668.52,8858.16,1235
1217,1954,2023,8784,8915,69,131,4811,0,4811,1.0,1992.4,8844.78,1991.95,8844.52,1236
1218,4074,4280,8784,9005,206,221,27677,0,27677,1.0,4170.93,8887.11,4170.56,8886.68,1237
1219,4764,4795,8787,8835,31,48,993,0,993,1.0,4780.36,8810.5,4779.8,8810.07,1238
1220,4778,4843,8795,8867,65,72,2947,0,2947,1.0,4808.18,8834.63,4807.76,8833.98,1239
1221,2228,2277,8798,8848,49,50,1870,0,1870,1.0,2250.9,8823.12,2250.44,8822.62,1240
1222,2006,2057,8800,8849,51,49,1614,0,1614,1.0,2028.43,8823.52,2028.09,8823.22,1242
1223,2732,2961,8800,9008,229,208,33894,0,33894,1.0,2844.5,8909.22,2844.01,8908.69,1241
1224,2933,3120,8812,8958,187,146,20732,0,20732,1.0,3021.31,8888.64,3020.88,8888.12,1243
1225,2106,2177,8813,8920,71,107,3778,0,3778,1.0,2142.07,8864.3,2141.4,8863.84,1244
1226,2410,2458,8816,8875,48,59,2193,0,2193,1.0,2433.3,8844.94,2432.84,8844.52,1245
1227,3247,3457,8826,9014,210,188,20594,0,20594,1.0,3355.02,8932.87,3354.6,8932.28,1250
1228,4727,4781,8826,8895,54,69,2578,0,2578,1.0,4755.27,8863.27,4754.75,8862.67,1246
1229,4827,4919,8826,8899,92,73,3875,0,3875,1.0,4874.43,8857.76,4874.02,8857.6,1248
1230,1887,2000,8827,8971,113,144,7523,0,7523,1.0,1950.36,8883.76,1950.0,8883.75,1249
1231,2074,2135,8827,8898,61,71,2591,0,2591,1.0,2103.55,8861.41,2103.12,8860.96,1247
1232,4604,4676,8829,8893,72,64,3214,0,3214,1.0,4641.64,8858.68,4641.12,8858.25,1251
1233,2215,2295,8832,8921,80,89,3783,0,3783,1.0,2258.94,8875.62,2258.37,8875.16,1252
1234,2016,2082,8843,8922,66,79,3123,0,3123,1.0,2044.53,8874.5,2043.91,8874.66,1253
1235,4659,4736,8844,8964,77,120,5401,0,5401,1.0,4696.87,8900.07,4696.31,8899.69,1254
1236,3533,3640,8858,9061,107,203,16792,386,16406,0.977012863268223,3584.78,8960.28,3584.3,8959.71,1255
1237,4802,4840,8861,8901,38,40,1152,0,1152,1.0,4819.89,8883.08,4819.4,8882.47,1256
1238,4767,4805,8864,8918,38,54,1344,0,1344,1.0,4786.88,8888.9,4786.3,8888.56,1257
1239,4201,4333,8865,8992,132,127,9188,0,9188,1.0,4277.61,8937.76,4276.71,8937.33,1259
1240,2143,2263,8867,8963,120,96,6997,0,6997,1.0,2203.2,8913.41,2202.76,8913.13,1258
1241,4834,4898,8872,8933,64,61,2409,0,2409,1.0,4870.27,8899.46,4869.82,8899.11,1260
1242,2037,2121,8879,8959,84,80,4640,0,4640,1.0,2081.36,8918.5,2080.79,8917.94,1261
1243,4505,4566,8891,8965,61,74,3413,0,3413,1.0,4536.13,8928.55,4535.58,8928.05,1262
1244,4713,4781,8893,8967,68,74,3962,0,3962,1.0,4746.84,8929.64,4746.33,8929.14,1263
1245,3453,3535,8894,9024,82,130,8302,0,8302,1.0,3500.47,8955.4,3499.89,8954.84,1264
1246,4888,4980,8894,8967,92,73,4177,0,4177,1.0,4933.19,8928.33,4932.52,8927.8,1265
1247,3421,3475,8897,9016,54,119,2929,0,2929,1.0,3452.35,8950.45,3451.86,8950.13,1266
1248,2260,2322,8901,8953,62,52,2391,46,2345,0.9807611877875366,2291.64,8929.97,2291.12,8929.38,1269
1249,4781,4890,8901,9011,109,110,7606,0,7606,1.0,4832.07,8947.83,4831.61,8947.52,1267
1250,359,702,8902,9202,343,300,55045,0,55045,1.0,547.51,9046.72,546.72,9046.02,1268
1251,3893,4253,8905,9186,360,281,50448,876,49572,0.9826355851569933,4082.45,9025.22,4082.14,9024.91,1270
1252,2080,2218,8908,9037,138,129,8432,0,8432,1.0,2151.74,8979.45,2151.1,8978.76,1272
1253,3628,3822,8908,9076,194,168,22120,4,22116,0.9998191681735985,3713.39,8987.2,3713.08,8986.72,1271
1254,3102,3284,8910,9048,182,138,18058,0,18058,1.0,3197.45,8975.1,3196.87,8974.62,1273
1255,1994,2062,8916,8963,68,47,1975,0,1975,1.0,2026.2,8937.93,2025.7,8937.61,1274
1256,2650,2780,8916,9025,130,109,9513,0,9513,1.0,2708.34,8969.94,2708.01,8969.5,1275
1257,2377,2517,8923,9077,140,154,9533,0,9533,1.0,2446.98,9015.1,2446.23,9014.28,1276
1258,2181,2247,8940,8996,66,56,2125,0,2125,1.0,2215.57,8967.59,2214.99,8967.05,1277
1259,2239,2315,8942,9045,76,103,4929,0,4929,1.0,2274.07,8992.13,2273.76,8991.67,1278
1260,2931,3174,8942,9168,243,226,35307,0,35307,1.0,3046.98,9047.12,3046.58,9046.64,1279
1261,8357,9132,8945,9882,775,937,439557,0,439557,1.0,8701.17,9446.32,8700.73,9445.72,1281
1262,1982,2079,8947,9031,97,84,5210,0,5210,1.0,2029.55,8985.94,2029.11,8985.33,1280
1263,4456,4521,8948,8989,65,41,1797,0,1797,1.0,4490.76,8970.57,4490.21,8970.03,1282
1264,4499,4621,8949,9065,122,116,5728,0,5728,1.0,4545.98,9001.11,4546.08,9000.74,1283
1265,4660,4724,8949,9015,64,66,2412,0,2412,1.0,4691.32,8981.16,4690.87,8980.68,1284
1266,4884,4938,8949,8984,54,35,1334,0,1334,1.0,4908.41,8969.18,4907.97,8968.57,1285
1267,4772,4821,8950,9030,49,80,1848,0,1848,1.0,4795.28,8994.38,4794.61,8993.5,1287
1268,8866,9412,8951,9448,546,497,128234,0,128234,1.0,9160.17,9186.41,9159.67,9185.91,1288
1269,4627,4674,8952,9008,47,56,1829,0,1829,1.0,4648.55,8978.19,4648.12,8977.72,1286
1270,4712,4772,8957,9003,60,46,1586,0,1586,1.0,4742.37,8979.51,4741.97,8979.01,1289
1271,2034,2103,8965,9093,69,128,3744,0,3744,1.0,2066.53,9036.69,2066.39,9035.58,1290
1272,7825,8793,8970,10373,968,1403,704056,0,704056,1.0,8240.71,9701.88,8240.57,9701.36,1291
1273,4746,4796,8973,9043,50,70,1948,0,1948,1.0,4769.46,9012.4,4769.03,9011.73,1294
1274,4793,4892,8973,9076,99,103,4695,0,4695,1.0,4842.26,9024.61,4841.89,9023.99,1292
1275,3698,3889,8975,9155,191,180,23145,0,23145,1.0,3812.26,9069.17,3811.53,9068.68,1293
1276,4241,4383,8979,9134,142,155,11121,82,11039,0.9926265623595001,4312.15,9049.59,4311.8,9049.36,1295
1277,4574,4639,8981,9038,65,57,2205,0,2205,1.0,4606.58,9009.06,4606.19,9008.58,1297
1278,3873,4167,8982,9256,294,274,29771,0,29771,1.0,3983.95,9122.92,3984.62,9122.92,1296
1279,2286,2357,8983,9033,71,50,2360,0,2360,1.0,2320.98,9008.53,2320.5,9008.01,1298
1280,4456,4511,8983,9030,55,47,1976,0,1976,1.0,4481.71,9005.18,4481.2,9004.65,1299
1281,5857,6357,8986,9568,500,582,182600,0,182600,1.0,6101.7,9297.7,6101.29,9297.36,1300
1282,3243,3553,8987,9223,310,236,44997,445,44552,0.9901104518078983,3386.16,9089.46,3385.76,9089.0,1301
1283,2782,2974,8990,9195,192,205,26528,2694,23834,0.8984469240048251,2879.48,9086.94,2879.04,9086.55,1302
1284,2073,2166,8993,9085,93,92,3762,0,3762,1.0,2117.97,9030.51,2116.91,9030.67,1306
1285,2206,2262,8994,9064,56,70,2560,0,2560,1.0,2234.41,9030.57,2233.89,9030.02,1303
1286,2707,2795,8994,9095,88,101,6985,0,6985,1.0,2753.67,9046.98,2753.17,9046.41,1304
1287,4687,4766,8994,9079,79,85,3878,0,3878,1.0,4728.19,9035.26,4727.58,9034.66,1305
1288,572,813,8999,9294,241,295,43735,0,43735,1.0,698.3,9152.03,697.94,9151.61,1307
1289,4603,4682,9000,9090,79,90,4347,0,4347,1.0,4640.81,9047.42,4640.42,9046.8,1308
1290,2356,2435,9012,9094,79,82,2518,0,2518,1.0,2405.07,9053.71,2403.89,9052.61,1309
1291,4669,4710,9012,9074,41,62,1643,0,1643,1.0,4690.91,9046.87,4690.37,9046.1,1310
1292,4554,4605,9014,9075,51,61,2398,0,2398,1.0,4578.98,9046.67,4578.49,9046.1,1311
1293,4350,4399,9019,9080,49,61,1988,0,1988,1.0,4374.48,9044.45,4373.92,9044.22,1312
1294,2338,2407,9022,9124,69,102,3880,0,3880,1.0,2374.97,9077.43,2374.18,9076.69,1313
1295,4416,4558,9022,9179,142,157,13920,0,13920,1.0,4487.44,9101.3,4487.1,9100.75,1314
1296,2159,2236,9025,9130,77,105,5098,0,5098,1.0,2192.57,9079.06,2192.24,9078.48,1315
1297,2298,2361,9028,9098,63,70,3156,0,3156,1.0,2328.41,9061.15,2327.95,9060.74,1316
1298,4703,4827,9038,9148,124,110,6788,0,6788,1.0,4763.6,9090.84,4763.01,9090.48,1317
1299,2259,2301,9044,9085,42,41,1227,0,1227,1.0,2280.54,9062.09,2280.09,9061.68,1318
1300,2062,2167,9045,9153,105,108,6572,0,6572,1.0,2113.05,9093.1,2112.44,9092.77,1319
1301,3074,3320,9045,9265,246,220,35842,0,35842,1.0,3195.75,9163.88,3195.27,9163.33,1320
1302,3450,3611,9045,9234,161,189,20647,843,19804,0.9591708238485009,3545.72,9151.51,3545.05,9150.89,1321
1303,6879,7926,9045,10289,1047,1244,668151,0,668151,1.0,7397.67,9648.44,7397.24,9647.93,1323
1304,5930,6005,9046,9155,75,109,4874,0,4874,1.0,5963.02,9089.94,5962.37,9089.74,1322
1305,3591,3746,9049,9287,155,238,24454,0,24454,1.0,3664.44,9180.94,3663.95,9180.36,1324
1306,4193,4345,9052,9146,152,94,6694,472,6222,0.9294890947116821,4266.25,9105.0,4266.14,9104.7,1325
1307,4365,4402,9057,9096,37,39,874,0,874,1.0,4385.24,9076.96,4384.68,9076.42,1326
1308,2215,2284,9063,9139,69,76,3777,324,3453,0.9142176330420969,2245.54,9100.26,2245.16,9099.79,1327
1309,4636,4715,9064,9130,79,66,3337,0,3337,1.0,4674.85,9094.88,4674.34,9094.46,1328
1310,2430,2531,9066,9142,101,76,4888,0,4888,1.0,2477.89,9100.32,2477.64,9099.79,1330
1311,4532,4569,9066,9111,37,45,1070,0,1070,1.0,4550.72,9086.86,4550.18,9086.49,1329
1312,4546,4608,9073,9128,62,55,2210,0,2210,1.0,4580.98,9100.98,4580.29,9100.53,1331
1313,2279,2330,9075,9132,51,57,1850,0,1850,1.0,2305.94,9103.88,2305.36,9103.32,1333
1314,4380,4418,9075,9128,38,53,1349,0,1349,1.0,4400.31,9103.49,4399.85,9102.88,1332
1315,895,1336,9085,9737,441,652,138200,365,137835,0.9973589001447178,1097.82,9437.77,1097.25,9436.74,1335
1316,4569,4655,9086,9165,86,79,3810,837,2973,0.7803149606299212,4617.85,9129.8,4617.07,9129.16,1336
1317,2695,2820,9093,9207,125,114,10283,0,10283,1.0,2753.8,9148.55,2753.38,9148.04,1337
1318,2402,2482,9094,9189,80,95,4152,0,4152,1.0,2431.79,9142.07,2431.47,9141.52,1338
1319,2319,2402,9098,9187,83,89,3577,0,3577,1.0,2361.73,9142.69,2361.21,9142.2,1339
1320,2225,2300,9108,9173,75,65,3160,0,3160,1.0,2264.96,9147.16,2264.54,9146.4,1340
1321,2095,2230,9112,9224,135,112,10232,0,10232,1.0,2168.33,9165.3,2167.79,9164.85,1341
1322,2380,2406,9112,9165,26,53,746,0,746,1.0,2395.35,9131.96,2394.97,9132.01,1342
1323,4317,4477,9114,9220,160,106,9506,0,9506,1.0,4388.95,9165.82,4388.57,9165.38,1343
1324,4605,4709,9115,9239,104,124,5010,2156,2854,0.5696606786427145,4660.28,9175.66,4659.58,9175.39,1344
1325,4674,4777,9115,9205,103,90,4973,0,4973,1.0,4728.34,9162.97,4727.73,9162.35,1345
1326,4166,4335,9117,9239,169,122,7911,0,7911,1.0,4271.23,9166.78,4269.58,9166.73,1346
1327,3711,3848,9123,9297,137,174,15721,0,15721,1.0,3780.99,9208.05,3780.4,9207.6,1347
1328,4181,4212,9123,9159,31,36,657,0,657,1.0,4195.06,9138.81,4194.53,9138.5,1348
1329,4515,4617,9126,9243,102,117,6588,0,6588,1.0,4570.2,9183.67,4569.59,9183.16,1349
1330,2293,2345,9129,9194,52,65,2354,0,2354,1.0,2315.96,9162.86,2315.55,9162.31,1350
1331,2894,3125,9131,9382,231,251,36719,0,36719,1.0,3007.84,9254.74,3007.34,9254.26,1351
1332,3824,4013,9135,9301,189,166,15038,0,15038,1.0,3911.44,9217.08,3911.05,9216.71,1352
1333,2424,2531,9140,9225,107,85,4235,0,4235,1.0,2485.37,9182.04,2484.68,9181.67,1353
1334,2778,2911,9151,9279,133,128,11657,0,11657,1.0,2846.78,9219.34,2846.23,9218.73,1354
1335,5466,5942,9157,9761,476,604,187754,1700,186054,0.9909455990285161,5714.26,9460.72,5713.6,9460.23,1355
1336,4611,4646,9161,9206,35,45,1232,280,952,0.7727272727272727,4627.78,9182.11,4627.32,9181.68,1356
1337,2308,2408,9164,9257,100,93,5532,1545,3987,0.7207158351409978,2356.53,9211.82,2356.1,9211.33,1357
1338,4030,4112,9164,9222,82,58,2596,0,2596,1.0,4065.5,9190.96,4065.17,9190.66,1358
1339,4161,4266,9167,9266,105,99,6419,0,6419,1.0,4219.19,9211.28,4218.62,9210.97,1359
1340,2226,2317,9172,9287,91,115,7661,2,7659,0.9997389374755253,2273.31,9224.28,2272.82,9223.94,1360
1341,4127,4167,9173,9207,40,34,978,0,978,1.0,4144.23,9191.1,4143.94,9190.58,1361
1342,3362,3490,9176,9292,128,116,10057,0,10057,1.0,3425.05,9241.01,3424.64,9240.36,1362
1343,4476,4574,9177,9249,98,72,4258,0,4258,1.0,4516.52,9215.67,4516.37,9215.26,1363
1344,2392,2428,9178,9244,36,66,1508,0,1508,1.0,2411.42,9209.85,2410.89,9209.4,1364
1345,4396,4481,9179,9265,85,86,3898,0,3898,1.0,4432.9,9214.46,4432.62,9214.09,1365
1346,2418,2565,9186,9323,147,137,11638,1061,10577,0.9088331328406942,2493.2,9255.2,2492.58,9254.48,1366
1347,370,702,9192,9792,332,600,123013,0,123013,1.0,530.28,9493.05,529.77,9492.39,1367
1348,485,603,9193,9258,118,65,5329,0,5329,1.0,546.66,9225.88,546.01,9225.33,1368
1349,6179,6976,9196,10024,797,828,404882,0,404882,1.0,6599.21,9610.89,6598.55,9610.33,1369
1350,2694,2761,9198,9244,67,46,1618,0,1618,1.0,2723.34,9221.08,2723.11,9220.47,1370
1351,4052,4233,9201,9295,181,94,10830,0,10830,1.0,4132.88,9246.98,4132.79,9246.48,1371
1352,4420,4496,9202,9285,76,83,2632,0,2632,1.0,4458.67,9246.95,4458.15,9246.3,1374
1353,3221,3375,9203,9347,154,144,15641,0,15641,1.0,3299.42,9282.29,3298.95,9281.69,1372
1354,4323,4415,9205,9275,92,70,4275,0,4275,1.0,4366.67,9237.64,4366.44,9237.31,1373
1355,4274,4324,9207,9254,50,47,1275,0,1275,1.0,4303.19,9227.46,4302.41,9227.13,1375
1356,4017,4069,9218,9278,52,60,2097,0,2097,1.0,4042.87,9247.83,4042.41,9247.37,1376
1357,3571,3831,9222,9551,260,329,37974,1343,36631,0.9646336967398746,3680.49,9368.95,3680.06,9368.75,1377
1358,3474,3608,9225,9443,134,218,17641,890,16751,0.9495493452752112,3536.84,9333.83,3536.4,9333.29,1378
1359,4257,4303,9230,9275,46,45,1353,0,1353,1.0,4277.88,9253.69,4277.5,9253.15,1379
1360,3814,3904,9232,9343,90,111,4922,0,4922,1.0,3858.79,9285.47,3858.21,9285.16,1380
1361,4287,4335,9235,9295,48,60,1359,0,1359,1.0,4312.02,9267.54,4311.57,9266.88,1384
1362,7478,8061,9235,9808,583,573,157535,0,157535,1.0,7748.4,9490.83,7748.15,9490.67,1381
1363,2310,2375,9236,9314,65,78,3021,0,3021,1.0,2343.01,9274.0,2342.51,9273.58,1382
1364,2368,2417,9236,9324,49,88,2956,0,2956,1.0,2390.75,9277.42,2390.33,9276.94,1383
1365,2550,2634,9239,9350,84,111,4401,417,3984,0.9052488070892979,2590.62,9299.01,2590.03,9298.27,1385
1366,2402,2460,9241,9334,58,93,3700,0,3700,1.0,2429.72,9290.91,2429.21,9290.32,1386
1367,4412,4558,9244,9404,146,160,12557,0,12557,1.0,4485.85,9323.25,4485.31,9322.76,1387
1368,4513,4574,9244,9286,61,42,1887,0,1887,1.0,4547.19,9262.96,4546.52,9262.48,1388
1369,3992,4048,9254,9290,56,36,1330,0,1330,1.0,4016.74,9273.85,4016.48,9273.32,1389
1370,4196,4265,9258,9326,69,68,3164,0,3164,1.0,4229.31,9291.77,4228.85,9291.19,1390
1371,3106,3402,9261,9480,296,219,26110,0,26110,1.0,3257.25,9373.86,3256.54,9373.29,1391
1372,4291,4411,9263,9379,120,116,8991,0,8991,1.0,4351.94,9316.17,4351.42,9315.76,1392
1373,4398,4436,9265,9313,38,48,1170,0,1170,1.0,4417.85,9286.98,4417.22,9286.73,1393
1374,2770,2948,9270,9428,178,158,18619,453,18166,0.9756700145013159,2852.85,9344.46,2852.45,9343.96,1394
1375,4019,4125,9270,9371,106,101,6992,0,6992,1.0,4071.97,9321.55,4071.41,9321.1,1395
1376,3911,3978,9272,9316,67,44,1695,0,1695,1.0,3944.25,9294.23,3943.76,9293.72,1396
1377,4253,4302,9272,9316,49,44,1555,0,1555,1.0,4277.17,9296.16,4276.71,9295.58,1397
1378,3324,3507,9273,9409,183,136,15974,0,15974,1.0,3419.26,9342.86,3418.72,9342.28,1399
1379,4175,4201,9274,9302,26,28,532,0,532,1.0,4188.15,9288.64,4187.66,9288.11,1398
1380,3945,4037,9280,9354,92,74,3655,0,3655,1.0,3995.17,9312.88,3994.64,9312.62,1400
1381,2290,2354,9283,9342,64,59,2410,1028,1382,0.5734439834024896,2319.06,9310.95,2318.72,9310.5,1401
1382,4120,4177,9291,9323,57,32,1242,0,1242,1.0,4143.6,9306.57,4143.43,9306.04,1402
1383,2456,2611,9299,9388,155,89,7669,0,7669,1.0,2540.46,9343.1,2539.61,9342.61,1403
1384,8961,9003,9300,9380,42,80,2081,0,2081,1.0,8979.86,9344.21,8979.24,9343.36,1404
1385,3848,3947,9301,9384,99,83,5107,0,5107,1.0,3896.86,9339.57,3896.38,9339.09,1405
1386,4153,4214,9302,9353,61,51,2021,0,2021,1.0,4180.46,9326.63,4180.03,9326.17,1406
1387,3047,3288,9304,9610,241,306,34390,0,34390,1.0,3169.76,9453.33,3169.23,9452.78,1407
1388,2332,2412,9312,9395,80,83,3900,15,3885,0.9961538461538462,2371.74,9348.8,2371.32,9348.41,1408
1389,4186,4322,9312,9403,136,91,7480,0,7480,1.0,4253.88,9355.15,4253.41,9354.76,1409
1390,4344,4448,9313,9425,104,112,7005,219,6786,0.9687366167023554,4402.84,9375.9,4402.28,9375.23,1410
1391,2429,2467,9316,9359,38,43,1048,0,1048,1.0,2448.45,9337.71,2447.93,9337.16,1411
1392,2603,2706,9320,9444,103,124,6559,0,6559,1.0,2655.94,9386.44,2655.34,9385.85,1412
1393,2675,2788,9320,9411,113,91,6660,0,6660,1.0,2729.72,9369.72,2729.23,9369.11,1413
1394,4098,4156,9321,9390,58,69,3048,0,3048,1.0,4126.88,9354.86,4126.45,9354.33,1414
1395,3934,4021,9325,9393,87,68,4000,0,4000,1.0,3977.82,9359.0,3977.16,9358.39,1415
1396,2387,2448,9334,9418,61,84,2737,0,2737,1.0,2421.11,9374.39,2420.7,9374.12,1416
1397,3792,3855,9337,9388,63,51,2341,0,2341,1.0,3821.52,9361.34,3821.07,9360.87,1417
1398,2861,3037,9341,9520,176,179,20669,1481,19188,0.928346799554889,2951.78,9433.87,2951.28,9433.3,1418
1399,2464,2547,9344,9441,83,97,3725,0,3725,1.0,2508.98,9396.7,2508.21,9395.74,1422
1400,2441,2485,9345,9415,44,70,2014,0,2014,1.0,2462.8,9382.94,2462.13,9382.4,1419
1401,4127,4235,9345,9437,108,92,5132,0,5132,1.0,4174.38,9393.99,4174.06,9393.62,1420
1402,3809,3879,9353,9461,70,108,3490,0,3490,1.0,3850.72,9402.2,3850.16,9401.9,1421
1403,4007,4049,9358,9397,42,39,995,0,995,1.0,4027.29,9375.76,4026.81,9375.38,1423
1404,3903,3960,9359,9430,57,71,2352,0,2352,1.0,3930.65,9393.76,3930.1,9393.49,1424
1405,4235,4353,9366,9438,118,72,4045,388,3657,0.904079110012361,4291.34,9402.33,4291.13,9401.66,1425
1406,4026,4113,9369,9442,87,73,4690,0,4690,1.0,4067.03,9404.22,4066.57,9403.77,1426
1407,2536,2609,9376,9437,73,61,2939,0,2939,1.0,2573.91,9404.56,2573.41,9404.09,1427
1408,3027,3109,9376,9490,82,114,6527,0,6527,1.0,3064.64,9435.72,3064.15,9435.12,1429
1409,3722,3769,9376,9416,47,40,1015,0,1015,1.0,3747.27,9395.15,3746.63,9394.76,1428
1410,3747,3843,9376,9450,96,74,4007,0,4007,1.0,3789.1,9415.97,3788.92,9415.54,1430
1411,2581,2647,9380,9466,66,86,2988,0,2988,1.0,2614.75,9429.26,2614.21,9428.44,1432
1412,3379,3534,9380,9571,155,191,19139,3427,15712,0.8209415329954544,3458.8,9476.09,3458.33,9475.56,1431
1413,3865,3915,9380,9443,50,63,1713,0,1713,1.0,3887.61,9407.98,3886.98,9407.69,1433
1414,551,1038,9387,10056,487,669,206890,995,205895,0.9951906810382328,799.67,9717.51,799.05,9717.04,1434
1415,2629,2803,9388,9536,174,148,13945,0,13945,1.0,2710.35,9468.14,2710.19,9467.34,1435
1416,3943,4036,9388,9465,93,77,5355,0,5355,1.0,3989.46,9425.75,3989.01,9425.26,1436
1417,4101,4134,9390,9430,33,40,916,0,916,1.0,4118.85,9411.95,4118.29,9411.31,1437
1418,2388,2438,9394,9424,50,30,767,0,767,1.0,2411.8,9408.33,2411.38,9407.81,1438
1419,4276,4390,9403,9461,114,58,3690,392,3298,0.8937669376693766,4332.5,9432.32,4332.18,9431.87,1439
1420,3384,3405,9406,9440,21,34,527,0,527,1.0,3394.9,9420.49,3394.46,9420.26,1441
1421,3700,3755,9406,9442,55,36,1215,0,1215,1.0,3728.28,9423.32,3727.72,9422.83,1440
1422,4226,4262,9408,9450,36,42,936,0,936,1.0,4242.2,9429.87,4241.75,9429.33,1442
1423,2760,2884,9410,9542,124,132,10936,0,10936,1.0,2820.57,9476.15,2820.09,9475.68,1444
1424,2413,2527,9411,9522,114,111,6485,0,6485,1.0,2480.81,9458.08,2479.95,9457.61,1443
1425,3551,3626,9412,9467,75,55,2078,0,2078,1.0,3588.19,9437.61,3587.71,9437.2,1445
1426,4118,4238,9412,9539,120,127,9734,0,9734,1.0,4178.2,9474.4,4177.72,9473.86,1446
1427,2521,2651,9416,9544,130,128,7954,1490,6464,0.8126728689967312,2581.61,9481.13,2581.27,9480.71,1447
1428,3856,3954,9419,9476,98,57,3539,0,3539,1.0,3911.58,9448.83,3910.74,9448.4,1448
1429,4067,4139,9423,9498,72,75,4012,0,4012,1.0,4102.21,9460.58,4101.72,9460.0,1449
1430,3719,3805,9435,9502,86,67,3588,0,3588,1.0,3758.88,9468.56,3758.33,9468.09,1451
1431,3799,3853,9435,9483,54,48,1827,0,1827,1.0,3823.81,9457.26,3823.37,9456.85,1450
1432,4238,4295,9436,9487,57,51,1723,0,1723,1.0,4268.49,9459.67,4267.95,9459.27,1452
1433,3527,3577,9440,9498,50,58,1906,0,1906,1.0,3549.16,9470.52,3548.8,9470.14,1454
1434,3585,3641,9440,9496,56,56,1835,0,1835,1.0,3618.38,9465.17,3617.68,9464.81,1453
1435,4014,4080,9440,9525,66,85,3904,940,2964,0.7592213114754098,4047.63,9483.06,4047.11,9482.54,1455
1436,3944,4024,9453,9520,80,67,3282,0,3282,1.0,3988.16,9486.04,3987.44,9485.49,1456
1437,3828,3890,9461,9529,62,68,2549,0,2549,1.0,3859.03,9489.45,3858.56,9489.13,1457
1438,3219,3401,9464,9628,182,164,16353,0,16353,1.0,3312.5,9541.02,3311.75,9540.75,1458
1439,3568,3627,9465,9509,59,44,1439,0,1439,1.0,3595.58,9487.66,3595.25,9487.2,1459
1440,2950,3063,9469,9608,113,139,10926,0,10926,1.0,3010.12,9541.05,3009.57,9540.48,1460
1441,3875,3987,9470,9538,112,68,5007,2057,2950,0.5891751547833034,3926.15,9505.77,3925.84,9505.31,1461
1442,3745,3863,9476,9612,118,136,10235,0,10235,1.0,3802.6,9540.53,3802.2,9540.06,1462
1443,2992,3202,9482,9664,210,182,18596,2402,16194,0.8708324370832438,3102.25,9588.79,3101.43,9588.16,1463
1444,3697,3749,9492,9522,52,30,955,0,955,1.0,3720.05,9505.28,3719.83,9504.86,1464
1445,3514,3588,9494,9538,74,44,2549,0,2549,1.0,3550.88,9516.44,3550.43,9515.89,1465
1446,2484,2640,9499,9606,156,107,11346,200,11146,0.9823726423409131,2561.84,9551.11,2561.33,9550.61,1466
1447,2836,2968,9501,9627,132,126,11284,0,11284,1.0,2903.4,9563.85,2902.87,9563.37,1467
1448,3568,3649,9501,9577,81,76,4023,0,4023,1.0,3608.57,9539.83,3607.98,9539.23,1468
1449,2696,2811,9507,9654,115,147,8390,0,8390,1.0,2751.43,9575.59,2751.05,9575.12,1469
1450,3704,3747,9512,9562,43,50,1504,0,1504,1.0,3726.67,9535.92,3726.08,9535.52,1470
1451,3875,3998,9515,9607,123,92,5978,0,5978,1.0,3939.28,9563.47,3938.79,9562.71,1471
1452,3866,3900,9517,9545,34,28,581,0,581,1.0,3883.63,9530.18,3883.05,9529.71,1472
1453,2660,2720,9519,9567,60,48,1931,0,1931,1.0,2693.31,9540.95,2692.67,9540.48,1473
1454,5731,6282,9521,9983,551,462,150972,0,150972,1.0,6025.44,9761.83,6024.75,9761.07,1475
1455,3647,3708,9522,9569,61,47,1357,0,1357,1.0,3680.97,9546.9,3680.3,9546.36,1474
1456,3483,3520,9527,9568,37,41,945,0,945,1.0,3501.74,9547.33,3501.17,9546.87,1476
1457,4122,4195,9527,9605,73,78,2963,0,2963,1.0,4155.68,9563.95,4155.26,9563.36,1478
1458,3850,3890,9528,9583,40,55,1220,0,1220,1.0,3867.05,9558.16,3866.68,9557.4,1477
1459,5895,5991,9529,9604,96,75,4121,0,4121,1.0,5931.75,9570.53,5931.99,9569.83,1479
1460,2631,2717,9535,9635,86,100,4926,2227,2699,0.547909053999188,2669.53,9588.11,2669.09,9587.59,1480
1461,3510,3575,9537,9586,65,49,2128,0,2128,1.0,3540.45,9558.33,3540.06,9557.92,1481
1462,2767,2864,9538,9650,97,112,6749,0,6749,1.0,2812.52,9597.72,2812.12,9597.13,1482
1463,3380,3421,9539,9577,41,38,955,370,585,0.612565445026178,3401.1,9558.16,3400.57,9557.67,1483
1464,3725,3776,9546,9603,51,57,1504,0,1504,1.0,3749.62,9575.96,3749.13,9575.37,1484
1465,3664,3750,9548,9642,86,94,5058,0,5058,1.0,3703.76,9596.54,3703.46,9596.16,1485
1466,3399,3500,9554,9640,101,86,5132,845,4287,0.8353468433359315,3447.35,9595.67,3446.87,9595.36,1486
1467,3614,3666,9555,9616,52,61,2318,0,2318,1.0,3642.59,9585.23,3642.01,9584.72,1487
1468,3537,3590,9559,9616,53,57,1784,0,1784,1.0,3563.34,9589.0,3562.91,9588.36,1488
1469,3477,3543,9560,9657,66,97,3465,0,3465,1.0,3511.78,9609.04,3511.13,9608.42,1489
1470,3298,3419,9566,9648,121,82,6323,1799,4524,0.7154831567294005,3365.98,9608.5,3365.25,9608.04,1490
1471,3857,3908,9575,9607,51,32,1024,0,1024,1.0,3885.7,9589.13,3884.92,9588.65,1491
1472,3571,3626,9576,9624,55,48,1733,0,1733,1.0,3599.51,9601.24,3598.97,9600.76,1492
1473,3789,3853,9582,9660,64,78,2489,0,2489,1.0,3821.32,9624.89,3821.0,9624.11,1493
1474,3739,3804,9587,9663,65,76,2926,0,2926,1.0,3771.32,9622.77,3770.89,9622.34,1494
1475,2526,2620,9593,9729,94,136,5755,0,5755,1.0,2573.23,9654.51,2572.89,9654.37,1495
1476,2581,2676,9593,9726,95,133,7914,233,7681,0.970558503917109,2631.2,9658.67,2630.69,9658.08,1496
1477,2920,3012,9597,9700,92,103,6440,66,6374,0.989751552795031,2965.25,9650.93,2964.8,9650.37,1498
1478,1089,1707,9598,10309,618,711,189721,456,189265,0.9975964706068384,1416.79,10020.48,1415.65,10019.25,1497
1479,3092,3229,9604,9751,137,147,10574,5,10569,0.9995271420465293,3156.08,9677.17,3155.88,9676.54,1499
1480,2822,2923,9606,9683,101,77,4970,0,4970,1.0,2871.86,9646.38,2871.34,9645.81,1500
1481,2703,2737,9607,9653,34,46,962,0,962,1.0,2721.15,9632.27,2720.54,9631.54,1501
1482,3600,3689,9607,9672,89,65,3946,519,3427,0.8684744044602128,3639.84,9639.7,3639.53,9639.06,1502
1483,3285,3348,9610,9693,63,83,2687,0,2687,1.0,3319.91,9649.66,3319.2,9649.12,1504
1484,3528,3606,9610,9687,78,77,4135,0,4135,1.0,3565.16,9647.28,3564.6,9646.91,1503
1485,3228,3289,9613,9639,61,26,1026,0,1026,1.0,3263.19,9625.97,3262.16,9625.5,1505
1486,2662,2758,9621,9737,96,116,6774,0,6774,1.0,2705.91,9679.46,2705.47,9678.85,1506
1487,3329,3463,9621,9707,134,86,6046,1115,4931,0.8155805491233874,3408.39,9665.33,3407.32,9665.02,1507
1488,3461,3538,9627,9675,77,48,1944,0,1944,1.0,3490.55,9654.01,3490.73,9653.67,1508
1489,3666,3772,9631,9721,106,90,6118,0,6118,1.0,3721.38,9673.93,3720.65,9673.45,1509
1490,3227,3323,9632,9690,96,58,3240,1575,1665,0.5138888888888888,3269.8,9659.81,3269.71,9659.54,1510
1491,2753,2827,9637,9692,74,55,2426,0,2426,1.0,2788.89,9666.18,2788.43,9665.55,1511
1492,2980,3107,9638,9809,127,171,13066,55,13011,0.9957906015613042,3043.28,9717.8,3042.72,9717.45,1512
1493,2530,2588,9646,9725,58,79,2371,0,2371,1.0,2555.59,9688.99,2555.14,9688.4,1513
1494,2811,2993,9652,9849,182,197,17674,0,17674,1.0,2897.91,9749.33,2897.38,9748.86,1514
1495,3642,3686,9656,9707,44,51,1645,0,1645,1.0,3663.36,9684.91,3662.88,9684.19,1515
1496,2715,2852,9664,9815,137,151,12184,0,12184,1.0,2789.57,9737.95,2789.13,9737.61,1516
1497,3335,3405,9678,9716,70,38,1439,88,1351,0.9388464211257818,3376.82,9697.48,3375.87,9697.01,1517
1498,316,568,9681,9984,252,303,42247,1068,41179,0.9747200984685304,426.4,9845.59,425.82,9844.89,1518
1499,1340,1557,9694,9931,217,237,14707,44,14663,0.9970082273747195,1455.38,9808.1,1455.02,9807.66,1519
1500,918,1376,9697,10117,458,420,119722,0,119722,1.0,1133.95,9907.45,1133.39,9906.93,1520
1501,5344,5801,9703,10106,457,403,114768,0,114768,1.0,5558.04,9894.71,5557.19,9894.29,1521
1502,5117,5355,9710,9942,238,232,28114,0,28114,1.0,5234.93,9833.72,5234.46,9833.24,1522
1503,2625,2748,9717,9831,123,114,7684,0,7684,1.0,2689.12,9770.83,2688.61,9770.29,1523
1504,2573,2670,9724,9816,97,92,4424,0,4424,1.0,2618.21,9768.18,2618.01,9767.91,1524
1505,3055,3147,9731,9849,92,118,5351,0,5351,1.0,3094.22,9785.11,3093.77,9784.73,1526
1506,2907,3020,9739,9855,113,116,7731,0,7731,1.0,2970.6,9799.69,2970.01,9799.21,1527
1507,6086,6731,9740,10491,645,751,233006,0,233006,1.0,6449.8,10095.28,6449.14,10094.8,1528
1508,6842,7517,9804,10596,675,792,293383,0,293383,1.0,7212.23,10116.04,7211.86,10116.27,1529
1509,2813,2868,9821,9897,55,76,2789,0,2789,1.0,2836.41,9861.61,2836.21,9860.76,1530
1510,496,755,9827,10185,259,358,45180,2876,42304,0.9363435148295706,609.7,10019.6,609.17,10019.02,1531
1511,2906,2977,9828,9889,71,61,3128,0,3128,1.0,2940.6,9859.92,2940.04,9859.41,1532
1512,4803,5584,9833,10593,781,760,272979,0,272979,1.0,5167.05,10249.55,5167.05,10248.63,1533
1513,8713,8877,9843,10099,164,256,21962,0,21962,1.0,8805.99,9970.07,8805.37,9969.63,1534
1514,3064,3093,9849,9901,29,52,958,0,958,1.0,3078.02,9877.37,3077.62,9876.62,1535
1515,4913,5176,9869,10098,263,229,38107,883,37224,0.9768284042301939,5036.46,9980.74,5035.83,9980.26,1536
1516,5566,6175,9903,10433,609,530,217669,0,217669,1.0,5856.51,10161.65,5856.24,10161.16,1537
1517,108,616,9910,10480,508,570,188935,419,188516,0.997782306084103,354.22,10204.79,353.78,10204.4,1538
1518,744,1201,9931,10379,457,448,84414,352,84062,0.9958300755798801,981.96,10168.31,981.37,10167.74,1539
1519,6641,7153,9974,10633,512,659,181374,0,181374,1.0,6872.89,10294.09,6872.24,10293.49,1540
1520,1702,1779,9975,10042,77,67,3038,0,3038,1.0,1736.15,10002.08,1735.71,10001.79,1541
1521,1616,2032,10012,10386,416,374,86721,0,86721,1.0,1819.08,10214.97,1819.0,10214.73,1542
1522,7772,8369,10048,10538,597,490,142121,0,142121,1.0,8071.91,10311.88,8071.43,10311.27,1543
1523,5950,6442,10060,10686,492,626,172549,0,172549,1.0,6204.53,10377.85,6204.04,10377.29,1544
1524,8777,8894,10086,10255,117,169,7498,3977,3521,0.46959189117097894,8830.33,10162.49,8830.3,10162.64,1545
1525,548,1020,10112,10733,472,621,179212,962,178250,0.9946320558891145,791.24,10403.4,790.74,10403.13,1546
1526,57,140,10122,10221,83,99,4385,0,4385,1.0,100.61,10172.07,99.84,10171.79,1547
1527,0,149,10190,10357,149,167,17065,0,17065,1.0,62.1,10276.75,62.49,10276.54,1548
1528,5316,5972,10193,10852,656,659,218518,7839,210679,0.9641265250459916,5612.85,10496.51,5612.37,10496.3,1549
1529,1135,1524,10197,10522,389,325,79316,122,79194,0.9984618488073025,1329.75,10352.3,1329.12,10352.11,1550
1530,4476,5191,10209,11174,715,965,342974,157,342817,0.9995422393534203,4850.33,10764.46,4849.12,10762.62,1551
1531,1472,1832,10242,10664,360,422,87296,4578,82718,0.9475577346041055,1627.24,10444.7,1626.78,10444.3,1552
1532,1777,2205,10250,10606,428,356,87214,0,87214,1.0,1979.78,10453.16,1979.37,10452.59,1553
1533,7388,8203,10254,10923,815,669,308646,0,308646,1.0,7752.79,10583.28,7752.75,10583.24,1554
1534,8257,8550,10320,10747,293,427,64159,0,64159,1.0,8398.81,10530.24,8398.38,10529.77,1556
1535,0,285,10322,10756,285,434,84968,857,84111,0.9899138499199699,111.03,10543.02,111.3,10542.36,1557
1536,107,632,10333,11196,525,863,298496,0,298496,1.0,400.96,10788.7,400.61,10788.27,1558
1537,582,1542,10347,11617,960,1270,534172,2166,532006,0.9959451262889107,1036.15,10908.6,1035.27,10908.72,1559
1538,6255,6871,10376,11087,616,711,280053,0,280053,1.0,6534.06,10734.7,6533.72,10734.02,1560
1539,4969,5507,10419,10917,538,498,144752,0,144752,1.0,5292.46,10677.71,5291.43,10676.89,1561
1540,7993,8351,10437,10817,358,380,83497,0,83497,1.0,8171.99,10635.77,8171.49,10635.24,1563
1541,6794,7680,10438,11594,886,1156,561638,3362,558276,0.9940139378033538,7220.67,10990.98,7220.55,10991.09,1562
1542,4143,4709,10453,11083,566,630,196949,0,196949,1.0,4452.28,10739.88,4451.71,10739.19,1564
1543,3934,4253,10502,10768,319,266,47271,24,47247,0.999492289141334,4067.99,10629.92,4067.88,10629.21,1565
1544,3612,4172,10511,11043,560,532,153179,0,153179,1.0,3857.96,10759.02,3857.85,10758.71,1566
1545,5718,6307,10523,11080,589,557,212541,0,212541,1.0,6026.84,10818.49,6026.34,10817.9,1567
1546,570,813,10538,11188,243,650,74851,0,74851,1.0,674.4,10842.18,673.72,10841.83,1568
1547,1461,2213,10557,11298,752,741,389579,0,389579,1.0,1843.94,10916.84,1843.44,10916.39,1569
1548,5015,5107,10574,10649,92,75,3941,0,3941,1.0,5058.96,10607.79,5058.54,10607.03,1570
1549,2176,2542,10666,11122,366,456,93524,0,93524,1.0,2341.56,10894.58,2341.1,10894.34,1571
1550,2666,3143,10667,11033,477,366,99006,170,98836,0.9982829323475345,2920.78,10834.93,2920.04,10834.54,1572
1551,4039,4215,10692,10884,176,192,17951,239,17712,0.9866859784970197,4135.7,10787.37,4135.18,10786.73,1573
1552,7375,7902,10698,11321,527,623,182617,3373,179244,0.9815296494849877,7630.37,11004.42,7629.89,11003.84,1574
1553,3322,3924,10723,11418,602,695,262915,0,262915,1.0,3612.9,11066.77,3612.41,11066.18,1576
1554,8287,8477,10723,10947,190,224,20040,118,19922,0.9941117764471058,8396.64,10814.62,8396.13,10814.43,1577
1555,0,220,10724,11320,220,596,97011,0,97011,1.0,86.06,11043.56,86.43,11042.79,1575
1556,5490,5977,10738,11286,487,548,143758,0,143758,1.0,5712.2,11008.87,5711.93,11008.64,1578
1557,3103,3436,10741,11010,333,269,48947,55,48892,0.9988763356283327,3255.0,10867.54,3254.67,10867.04,1580
1558,3456,3499,10741,10791,43,50,1375,0,1375,1.0,3475.19,10762.58,3474.63,10762.29,1579
1559,4154,4348,10750,10971,194,221,20541,58,20483,0.9971763789494182,4239.74,10889.05,4239.48,10887.7,1581
1560,8159,8315,10783,10888,156,105,9083,0,9083,1.0,8251.83,10838.72,8250.72,10838.48,1582
1561,8229,8460,10791,11154,231,363,36359,803,35556,0.9779146841222256,8340.99,10987.04,8340.06,10986.29,1583
1562,2407,2727,10803,11150,320,347,66393,0,66393,1.0,2559.96,10978.2,2559.42,10977.16,1584
1563,5016,5539,10813,11353,523,540,140752,0,140752,1.0,5276.77,11091.55,5276.27,11090.92,1585
1564,7988,8325,10849,11193,337,344,63737,0,63737,1.0,8144.54,11004.57,8144.2,11003.93,1586
1565,1154,1733,10870,11513,579,643,216772,0,216772,1.0,1430.03,11208.87,1429.81,11208.27,1587
1566,7789,8065,10879,11143,276,264,36544,0,36544,1.0,7927.1,11004.17,7927.14,11003.33,1588
1567,2536,3023,10892,11403,487,511,142515,2484,140031,0.9825702557625513,2764.38,11144.12,2763.7,11143.43,1589
1568,6207,7577,10895,12458,1370,1563,1089761,4178,1085583,0.9961661318399172,6850.11,11721.31,6850.1,11721.47,1590
1569,3900,4632,10936,11825,732,889,390975,0,390975,1.0,4268.2,11336.88,4267.99,11336.72,1593
1570,6256,6334,10942,11031,78,89,3630,0,3630,1.0,6293.98,10986.21,6293.25,10985.99,1595
1571,2931,3381,10943,11438,450,495,139732,0,139732,1.0,3158.31,11177.35,3157.99,11176.87,1594
1572,2960,3012,10958,11003,52,45,1503,50,1453,0.9667332002661344,2985.57,10980.2,2985.21,10979.71,1596
1573,8392,8493,10981,11074,101,93,5649,160,5489,0.9716764029031687,8450.66,11034.55,8449.9,11034.04,1597
1574,5872,6516,11004,11734,644,730,305199,0,305199,1.0,6189.96,11330.51,6189.61,11330.16,1598
1575,4446,5052,11006,11503,606,497,166194,0,166194,1.0,4709.27,11257.42,4708.94,11256.58,1599
1576,7831,7900,11043,11126,69,83,3213,0,3213,1.0,7866.01,11083.46,7865.33,11083.08,1600
1577,2047,2593,11060,11658,546,598,211714,4980,206734,0.9764777010495291,2304.49,11350.87,2304.14,11350.46,1601
1578,5197,5919,11083,11826,722,743,358107,0,358107,1.0,5545.3,11456.52,5544.68,11455.97,1602
1579,105,653,11094,11742,548,648,219984,4199,215785,0.9809122481635028,378.31,11399.84,377.8,11399.48,1603
1580,7762,8132,11095,11399,370,304,74073,0,74073,1.0,7947.15,11244.24,7946.75,11243.6,1604
1581,569,658,11122,11368,89,246,13469,0,13469,1.0,610.11,11240.91,609.56,11240.49,1605
1582,841,1323,11124,11944,482,820,261123,0,261123,1.0,1057.88,11529.27,1057.45,11528.83,1606
1583,2443,2564,11140,11189,121,49,3379,0,3379,1.0,2504.27,11161.01,2504.23,11160.62,1607
1584,3353,3437,11185,11304,84,119,4905,0,4905,1.0,3385.94,11250.78,3385.38,11249.85,1608
1585,2006,2070,11225,11291,64,66,2301,0,2301,1.0,2039.93,11257.93,2039.49,11257.52,1609
1586,2437,3192,11226,11903,755,677,324144,0,324144,1.0,2796.23,11598.35,2795.67,11597.72,1611
1587,1534,2131,11227,12043,597,816,325824,0,325824,1.0,1821.72,11616.54,1821.09,11615.83,1610
1588,3596,4196,11247,11876,600,629,239925,0,239925,1.0,3894.08,11573.26,3893.53,11572.8,1612
1589,7711,7808,11254,11324,97,70,3322,0,3322,1.0,7750.92,11289.86,7751.18,11289.73,1613
1590,5851,5919,11268,11330,68,62,2226,0,2226,1.0,5890.23,11292.78,5889.85,11292.58,1614
1591,7616,7911,11277,11573,295,296,49474,0,49474,1.0,7761.02,11427.54,7760.24,11426.69,1615
1592,3116,3716,11281,11791,600,510,186232,708,185524,0.9961982903045663,3421.86,11525.43,3421.52,11525.29,1616
1593,0,142,11307,11582,142,275,24941,0,24941,1.0,57.19,11416.41,57.28,11416.34,1617
1594,4502,5252,11334,12082,750,748,315931,0,315931,1.0,4862.29,11639.89,4861.82,11639.88,1618
1595,2568,2636,11354,11469,68,115,4016,0,4016,1.0,2596.35,11405.63,2595.73,11406.0,1619
1596,7865,8095,11374,11596,230,222,32061,0,32061,1.0,7990.21,11482.62,7989.44,11482.28,1620
1597,1159,1602,11433,12260,443,827,242063,5806,236257,0.9760145086196569,1388.61,11834.55,1388.39,11833.8,1621
1598,5725,6229,11438,11884,504,446,84570,0,84570,1.0,5932.37,11692.9,5933.0,11692.48,1622
1599,4106,4174,11449,11548,68,99,3330,0,3330,1.0,4146.35,11490.92,4145.58,11490.66,1623
1600,0,842,11479,12730,842,1251,725366,0,725366,1.0,397.79,12095.47,397.79,12095.13,1624
1601,7227,7772,11506,12049,545,543,180306,39,180267,0.9997837010415627,7476.78,11758.98,7476.36,11758.16,1625
1602,584,689,11544,11698,105,154,9925,0,9925,1.0,637.25,11611.35,636.84,11611.27,1626
1603,1647,2970,11545,12911,1323,1366,905849,5564,900285,0.993857695929454,2223.17,12203.24,2222.82,12203.08,1627
1604,667,1027,11557,12334,360,777,111453,0,111453,1.0,859.23,11966.61,858.26,11964.95,1628
1605,5191,5313,11571,11685,122,114,6706,0,6706,1.0,5236.71,11631.56,5236.64,11631.17,1629
1606,2915,3559,11604,12299,644,695,314950,0,314950,1.0,3238.38,11966.19,3237.85,11965.67,1630
1607,4866,5511,11650,12213,645,563,243090,0,243090,1.0,5183.23,11948.96,5182.64,11948.45,1631
1608,4014,4569,11714,12051,555,337,98095,0,98095,1.0,4299.57,11888.48,4298.99,11888.18,1633
1609,5904,6259,11728,12263,355,535,119272,0,119272,1.0,6081.47,11973.98,6080.96,11973.74,1634
1610,3289,4193,11749,13237,904,1488,750511,0,750511,1.0,3752.93,12511.3,3752.42,12510.53,1635
1611,5341,6180,11754,12761,839,1007,416233,6114,410119,0.9853111118051668,5749.56,12208.1,5749.28,12207.94,1636
1612,4446,4977,11895,12511,531,616,175435,0,175435,1.0,4706.98,12190.3,4706.23,12189.66,1637
1613,946,1055,11903,12039,109,136,7801,0,7801,1.0,989.99,11963.45,989.6,11963.09,1639
1614,973,1365,11911,12653,392,742,195038,0,195038,1.0,1168.34,12279.69,1167.66,12279.64,1640
1615,1570,1641,11943,12021,71,78,2499,0,2499,1.0,1606.56,11985.85,1605.95,11985.48,1641
1616,3867,4542,11957,12645,675,688,309225,3269,305956,0.9894284097340125,4187.04,12265.19,4186.48,12264.75,1642
1617,1720,1819,11996,12095,99,99,4488,0,4488,1.0,1771.32,12034.74,1770.6,12034.73,1643
1618,1233,1984,12003,13463,751,1460,597369,6510,590859,0.9891022132049035,1591.51,12849.17,1591.16,12848.12,1644
1619,2676,3371,12136,12824,695,688,269300,0,269300,1.0,3036.02,12489.59,3035.47,12488.93,1645
1620,4810,5501,12155,12915,691,760,351824,0,351824,1.0,5179.14,12501.23,5178.7,12500.81,1646
1621,1357,1468,12222,12433,111,211,12237,0,12237,1.0,1399.94,12305.89,1399.46,12305.89,1647
1622,4360,5052,12257,14277,692,2020,705994,5585,700409,0.9920891678966111,4720.85,13304.0,4720.21,13303.24,1648
1623,6926,7068,12323,12530,142,207,16215,3875,12340,0.7610237434474252,6992.61,12427.87,6992.26,12427.26,1649
1624,1971,2916,12336,14005,945,1669,882965,0,882965,1.0,2451.18,13161.03,2450.89,13161.02,1650
1625,0,215,12347,12847,215,500,55314,0,55314,1.0,72.7,12586.86,72.89,12586.44,1651
1626,0,467,12357,13245,467,888,244696,0,244696,1.0,233.94,12874.39,234.01,12872.98,1652
1627,5425,5894,12393,12947,469,554,148872,1486,147386,0.990018270729217,5622.9,12691.76,5622.63,12691.16,1653
1628,3832,4602,12438,13420,770,982,364917,0,364917,1.0,4272.34,12970.32,4271.58,12970.04,1654
1629,5816,6118,12461,12976,302,515,80736,0,80736,1.0,5998.95,12747.42,5998.48,12746.61,1655
1630,995,1391,12530,13262,396,732,179895,0,179895,1.0,1182.34,12913.19,1181.82,12911.81,1656
1631,3121,3616,12615,13236,495,621,207770,0,207770,1.0,3348.11,12932.99,3347.64,12932.5,1657
1632,2522,3159,12702,13206,637,504,225605,0,225605,1.0,2850.37,12958.41,2849.87,12957.85,1659
1633,5244,5618,12740,13182,374,442,75932,0,75932,1.0,5415.7,12991.08,5415.35,12989.88,1661
1634,5741,5859,12778,12894,118,116,8918,0,8918,1.0,5800.85,12835.42,5800.48,12835.05,1663
1635,4868,5377,12806,13406,509,600,149394,0,149394,1.0,5125.04,13092.83,5124.52,13092.6,1664
1636,5519,5937,12872,13481,418,609,166012,4412,161600,0.9734236079319567,5741.56,13144.65,5741.39,13144.81,1665
1637,5846,6175,12890,13216,329,326,45572,1831,43741,0.9598218204160449,6034.1,13054.4,6033.07,13053.54,1666
1638,5906,5964,12992,13124,58,132,4324,0,4324,1.0,5930.65,13061.03,5929.88,13060.21,1667
1639,1913,2045,13015,13303,132,288,13962,0,13962,1.0,1988.38,13197.35,1987.79,13195.17,1668
1640,5910,6069,13080,13333,159,253,22628,668,21960,0.9704790525013258,5984.36,13206.49,5983.73,13206.06,1669
1641,3190,3895,13097,13615,705,518,250586,320,250266,0.9987229933036962,3550.43,13361.46,3549.97,13360.84,1670
1642,2757,3486,13106,14026,729,920,412969,4073,408896,0.9901372742263947,3087.03,13590.72,3086.71,13590.24,1671
1643,5416,5554,13133,13229,138,96,5086,0,5086,1.0,5507.59,13173.63,5506.4,13173.74,1672
1644,2659,2816,13155,13331,157,176,10945,0,10945,1.0,2758.31,13241.64,2756.99,13240.66,1673
1645,5188,5858,13178,13785,670,607,219950,5793,214157,0.9736621959536258,5487.18,13449.66,5487.37,13449.37,1674
1646,1861,2235,13222,13744,374,522,131552,0,131552,1.0,2043.27,13473.76,2043.05,13473.3,1675
1647,4734,5209,13231,13697,475,466,157943,0,157943,1.0,4977.49,13466.0,4976.76,13465.55,1676
1648,1573,1920,13280,13881,347,601,119005,0,119005,1.0,1754.78,13633.34,1754.51,13631.92,1677
1649,1220,1690,13316,13752,470,436,119614,292,119322,0.9975588141856304,1453.79,13536.76,1453.56,13536.24,1678
1650,3720,4247,13366,13978,527,612,233845,0,233845,1.0,3987.5,13679.81,3986.87,13679.23,1679
1651,4154,4224,13408,13523,70,115,4302,0,4302,1.0,4196.87,13460.41,4196.29,13460.0,1680
1652,4924,5292,13517,14011,368,494,91260,0,91260,1.0,5107.91,13793.0,5107.59,13791.97,1681
1653,5225,5570,13561,13959,345,398,83485,0,83485,1.0,5390.7,13747.89,5390.43,13747.39,1682
1654,2023,2422,13619,14056,399,437,109766,1672,108094,0.9847675965235136,2200.99,13826.44,2200.6,13825.96,1683
1655,1794,2082,13651,14213,288,562,100762,157,100605,0.9984418729282865,1934.71,13951.35,1934.39,13950.34,1684
1656,1365,1687,13704,14015,322,311,62859,0,62859,1.0,1533.93,13857.66,1533.45,13857.16,1685
1657,1172,1495,13840,14063,323,223,37037,0,37037,1.0,1349.02,13943.79,1348.52,13943.4,1686
1658,1627,1814,13854,14105,187,251,32454,27,32427,0.9991680532445923,1729.26,13989.9,1728.75,13988.76,1687
1659,2004,2585,13908,14324,581,416,145835,0,145835,1.0,2281.03,14123.46,2280.68,14122.86,1688
1660,2941,3357,13958,14292,416,334,100069,0,100069,1.0,3162.18,14125.23,3161.42,14124.65,1689
1661,3314,3559,14000,14249,245,249,29391,0,29391,1.0,3423.17,14108.06,3422.42,14107.89,1690
1662,4328,4670,14014,14372,342,358,69505,0,69505,1.0,4504.92,14219.09,4504.19,14218.38,1691
