ndimage_cellID,x0,x1,y0,y1,length,height,total_area,nuclei_area,cyto_area,c2t_area_ratio,orig_comX,orig_comY,ndimage_comX,ndimage_comY,orig_cellID
1,0,10720,0,15008,10720,15008,73929209,299169,73630040,0.9959533044645452,3497.39,7809.51,3500.07,7806.96,1
2,8358,8707,566,970,349,404,88895,0,88895,1.0,8538.53,763.14,8535.38,763.2,2
3,8420,10257,746,2195,1837,1449,1300751,4809,1295942,0.9963029050141033,9386.26,1371.12,9383.01,1371.22,3
4,6828,7094,821,1195,266,374,52947,234,52713,0.9955804861465238,6978.26,979.0,6975.15,979.75,4
5,7726,8514,851,2358,788,1507,654845,689,654156,0.9989478426192457,8162.58,1460.2,8159.4,1460.85,5
6,7270,7614,930,1533,344,603,136431,0,136431,1.0,7420.0,1222.8,7417.0,1222.72,6
7,5830,6134,986,1508,304,522,90543,0,90543,1.0,5960.66,1260.38,5957.59,1260.22,7
8,6863,7703,996,1960,840,964,389361,0,389361,1.0,7243.51,1529.4,7240.22,1529.0,8
9,7528,7919,1209,1791,391,582,143692,0,143692,1.0,7717.42,1462.93,7714.37,1463.46,9
10,6100,6497,1281,1955,397,674,121127,0,121127,1.0,6288.04,1651.49,6284.42,1650.88,10
11,8479,8570,1286,1455,91,169,10045,0,10045,1.0,8530.06,1376.85,8527.11,1376.66,11
12,8170,9727,1401,3583,1557,2182,1566524,8111,1558413,0.9948222944557504,8965.79,2415.03,8962.57,2415.58,12
13,7425,7552,1407,1565,127,158,8643,0,8643,1.0,7506.38,1478.21,7503.12,1478.93,13
14,5738,6172,1431,1766,434,335,100261,755,99506,0.9924696542025314,5943.55,1596.08,5940.6,1596.33,14
15,5408,5793,1474,1915,385,441,85228,907,84321,0.9893579574787629,5629.66,1673.18,5626.72,1673.56,15
16,6170,6272,1546,1628,102,82,4730,0,4730,1.0,6225.46,1582.89,6222.36,1582.97,16
17,7533,8082,1651,2405,549,754,258703,0,258703,1.0,7840.57,2033.76,7837.38,2033.9,17
18,5448,6267,1680,2490,819,810,393053,321,392732,0.999183316244883,5889.34,2075.39,5886.18,2075.58,18
19,9308,10202,1759,3220,894,1461,581878,0,581878,1.0,9763.24,2412.55,9760.3,2412.53,19
20,6155,6722,1834,2705,567,871,254877,4030,250847,0.9841884516845381,6450.2,2297.29,6446.83,2296.99,20
21,6983,7567,1856,2922,584,1066,356430,0,356430,1.0,7300.71,2332.3,7297.46,2333.01,21
22,8361,8517,1885,2005,156,120,7403,415,6988,0.943941645278941,8446.85,1948.6,8443.63,1948.78,22
23,6198,6382,1929,2088,184,159,18958,0,18958,1.0,6282.18,2003.26,6279.2,2003.57,23
24,9205,9544,1972,2351,339,379,72853,4871,67982,0.9331393353739722,9372.1,2158.63,9368.78,2158.59,24
25,10063,10502,1974,2525,439,551,164311,0,164311,1.0,10292.5,2262.8,10289.26,2262.88,25
26,7373,7984,2081,3142,611,1061,318059,3990,314069,0.9874551576908687,7667.96,2615.18,7664.51,2615.56,26
27,10426,10718,2199,2796,292,597,102846,0,102846,1.0,10608.58,2430.66,10605.07,2431.16,28
28,7947,8399,2239,2623,452,384,97391,0,97391,1.0,8178.41,2429.56,8175.2,2429.79,29
29,5745,6372,2244,3235,627,991,371001,72,370929,0.999805930442236,6075.79,2715.27,6072.7,2716.04,30
30,4978,5232,2274,2520,254,246,41437,402,41035,0.9902985254724039,5107.32,2414.19,5104.18,2414.39,31
31,6513,7012,2279,2860,499,581,162446,0,162446,1.0,6799.78,2578.93,6796.32,2578.95,32
32,8315,8849,2353,2880,534,527,193612,0,193612,1.0,8574.54,2600.4,8571.55,2600.82,33
33,7918,7992,2371,2460,74,89,3257,0,3257,1.0,7962.13,2412.17,7959.12,2412.5,34
34,4873,4954,2382,2453,81,71,3443,547,2896,0.8411269241940168,4911.76,2421.26,4908.52,2421.54,35
35,9778,10242,2386,2976,464,590,181629,230,181399,0.9987336823965336,9999.53,2641.25,9996.5,2641.53,36
36,5405,5859,2409,3063,454,654,175911,0,175911,1.0,5618.98,2721.09,5615.9,2721.05,37
37,5165,5502,2471,2993,337,522,89725,0,89725,1.0,5365.87,2690.52,5362.59,2690.98,38
38,9920,10718,2486,3619,798,1133,510335,0,510335,1.0,10296.33,3026.76,10293.15,3027.15,39
39,4898,5187,2491,2628,289,137,22036,0,22036,1.0,5047.66,2559.82,5044.37,2560.03,40
40,7686,8412,2536,3630,726,1094,431280,949,430331,0.9977995733630124,8039.64,3015.25,8036.45,3015.86,41
41,6838,7409,2594,3350,571,756,287993,0,287993,1.0,7156.8,2944.49,7153.68,2944.64,42
42,6213,7327,2606,4000,1114,1394,818597,4178,814419,0.994896145478178,6728.27,3334.25,6724.82,3334.26,43
43,7758,7867,2746,2823,109,77,5599,0,5599,1.0,7818.75,2783.81,7815.64,2784.11,44
44,3776,4302,2789,3185,526,396,127231,355,126876,0.9972097994985499,4057.73,2981.15,4054.39,2981.21,46
45,10680,10718,2789,2949,38,160,4820,0,4820,1.0,10704.74,2866.36,10701.31,2865.77,45
46,8188,8723,2806,3295,535,489,178481,0,178481,1.0,8476.28,3065.69,8473.31,3065.85,47
47,5433,6069,2916,3535,636,619,262437,0,262437,1.0,5768.33,3209.42,5765.12,3209.75,48
48,3483,3908,2991,3555,425,564,121159,5264,115895,0.9565529593344283,3735.7,3219.74,3732.55,3220.39,49
49,7258,7892,3016,3780,634,764,315033,174,314859,0.999447676910038,7564.14,3417.95,7561.03,3418.05,50
50,10378,10718,3019,3581,340,562,153424,0,153424,1.0,10565.41,3301.77,10561.77,3301.94,51
51,3453,5317,3091,4760,1864,1669,1530751,332,1530419,0.9997831129948633,4394.7,3901.8,4391.59,3901.77,52
52,9385,10154,3096,3830,769,734,307120,0,307120,1.0,9764.4,3462.3,9761.3,3462.44,53
53,5823,6519,3131,3930,696,799,298847,0,298847,1.0,6163.78,3534.97,6160.57,3535.2,54
54,9463,9532,3174,3270,69,96,3596,0,3596,1.0,9495.15,3213.09,9492.07,3213.08,55
55,8028,8597,3186,3770,569,584,195999,0,195999,1.0,8325.3,3495.26,8322.0,3495.35,56
56,4291,10718,3196,11435,6427,8239,20092308,268185,19824123,0.986652354722016,7883.6,7422.69,7879.4,7422.35,57
57,9878,9952,3240,3368,74,128,6051,0,6051,1.0,9923.91,3308.96,9920.72,3309.3,58
58,6323,6422,3271,3380,99,109,5575,33,5542,0.9940807174887892,6369.41,3329.9,6366.38,3329.85,59
59,3200,3802,3326,3743,602,417,112801,5740,107061,0.9491139262949797,3518.56,3542.18,3515.04,3542.39,60
60,3628,3639,3327,3340,11,13,96,0,96,1.0,3735.7,3219.74,3633.94,3332.55,2000
61,5186,5889,3351,3870,703,519,230128,0,230128,1.0,5519.55,3621.18,5516.29,3621.4,61
62,10115,10522,3369,4118,407,749,132502,0,132502,1.0,10332.59,3759.3,10329.11,3760.0,62
63,4628,4867,3429,3793,239,364,42516,0,42516,1.0,4756.07,3598.3,4752.79,3598.6,63
64,4628,4702,3466,3508,74,42,1829,0,1829,1.0,4667.24,3483.26,4664.45,3483.14,64
65,9143,9590,3477,4070,447,593,165833,0,165833,1.0,9353.16,3773.54,9350.02,3773.75,65
66,10165,10718,3529,4405,553,876,237309,4077,233232,0.9828198677673413,10516.26,3982.18,10512.71,3982.62,66
67,7543,8262,3539,3979,719,440,151987,919,151068,0.9939534302275852,7901.73,3763.52,7898.89,3763.61,67
68,10683,10718,3574,3655,35,81,2113,0,2113,1.0,10706.86,3610.49,10703.35,3610.22,68
69,10100,10247,3593,3758,147,165,13885,0,13885,1.0,10185.33,3665.52,10181.89,3665.92,69
70,8446,8532,3645,3745,86,100,4864,0,4864,1.0,8495.46,3700.32,8492.32,3700.07,70
71,9401,10272,3646,4155,871,509,222012,0,222012,1.0,9788.48,3904.54,9785.92,3904.81,71
72,2998,3923,3716,4970,925,1254,604659,5594,599065,0.990748504528999,3379.84,4269.45,3376.86,4270.27,72
73,5070,6392,3746,4710,1322,964,765706,955,764751,0.9987527850114796,5637.94,4259.31,5635.73,4259.63,73
74,6310,6420,3751,3850,110,99,5970,0,5970,1.0,6371.65,3804.76,6368.72,3804.69,74
75,5793,6497,3791,4160,704,369,102084,0,102084,1.0,6229.61,3945.46,6225.21,3946.38,75
76,9868,10417,3966,4550,549,584,170405,0,170405,1.0,10129.35,4251.58,10126.09,4251.62,76
77,9153,9657,3979,4490,504,511,134019,0,134019,1.0,9404.77,4220.89,9401.32,4221.1,77
78,9498,10222,4064,4678,724,614,204923,0,204923,1.0,9838.15,4392.03,9835.08,4392.08,78
79,10350,10718,4082,4696,368,614,122521,0,122521,1.0,10590.44,4433.77,10586.63,4434.03,79
80,4618,5117,4121,4900,499,779,160258,174,160084,0.9989142507706323,4868.92,4493.27,4865.82,4493.65,80
81,3443,4242,4130,4853,799,723,321983,3663,318320,0.9886236229863067,3826.52,4536.21,3823.33,4536.42,81
82,2598,2868,4316,4674,270,358,50495,456,50039,0.9909694029111793,2742.53,4492.4,2739.1,4491.86,82
83,9268,9557,4341,4740,289,399,50541,0,50541,1.0,9423.82,4562.88,9420.39,4563.09,83
84,4983,5082,4404,4475,99,71,4186,1034,3152,0.7529861442904922,5031.75,4435.69,5028.75,4435.78,84
85,5803,5924,4416,4650,121,234,11300,0,11300,1.0,5866.03,4522.26,5862.43,4522.87,85
86,4753,5239,4426,5103,486,677,165167,7536,157631,0.9543734523240115,5024.62,4768.69,5021.55,4768.86,86
87,9446,10084,4501,4890,638,389,142739,0,142739,1.0,9742.95,4679.68,9739.88,4680.01,87
88,10073,10669,4511,4853,596,342,97700,0,97700,1.0,10326.71,4667.47,10323.81,4667.75,88
89,2628,3124,4539,5075,496,536,167649,1219,166430,0.9927288561220168,2882.22,4822.59,2879.18,4822.97,89
90,5458,5822,4615,4872,364,257,50524,0,50524,1.0,5658.0,4756.18,5654.92,4756.02,90
91,4296,4939,4636,5328,643,692,254573,0,254573,1.0,4615.68,4991.99,4612.56,4992.36,91
92,10656,10718,4659,4780,62,121,4964,0,4964,1.0,10698.04,4717.34,10694.67,4717.69,92
93,3745,4523,4706,5563,778,857,373306,0,373306,1.0,4125.23,5150.31,4121.87,5150.2,94
94,9898,10309,4706,5258,411,552,79881,957,78924,0.9880196792729184,10141.67,4995.69,10138.49,4995.56,93
95,3341,3994,4716,5237,653,521,197318,270,197048,0.9986316504322971,3672.53,4972.88,3669.43,4972.59,95
96,5778,5802,4716,4747,24,31,439,0,439,1.0,5658.0,4756.18,5788.9,4731.39,2001
97,10243,10718,4729,5290,475,561,173506,664,172842,0.9961730430071583,10503.91,4958.08,10500.38,4958.45,97
98,5718,5934,4746,5220,216,474,52703,0,52703,1.0,5827.71,4976.42,5824.92,4978.74,96
99,9688,10227,4759,4989,539,230,68002,0,68002,1.0,9986.84,4867.96,9983.48,4867.97,98
100,2988,3464,4809,5428,476,619,175652,0,175652,1.0,3209.22,5106.77,3206.45,5106.86,99
101,2333,2702,4826,5250,369,424,87924,0,87924,1.0,2502.66,5056.4,2499.66,5056.16,100
102,8468,8594,4849,4963,126,114,7459,1731,5728,0.7679313580908969,8537.5,4902.58,8533.8,4902.7,101
103,8333,8429,4863,4973,96,110,7403,438,6965,0.9408347967040389,8383.74,4918.19,8380.55,4918.38,102
104,8425,8469,4864,4898,44,34,1179,608,571,0.48430873621713316,8447.96,4880.35,8444.49,4880.7,103
105,8418,8524,4885,4955,106,70,4263,2884,1379,0.32348111658456485,8467.54,4921.47,8464.09,4921.58,104
106,8258,8347,4894,4975,89,81,4520,0,4520,1.0,8306.63,4932.55,8303.42,4932.3,105
107,8181,8290,4926,5041,109,115,5657,396,5261,0.9299982322785929,8240.61,4980.81,8236.93,4981.38,107
108,8550,8662,4926,5061,112,135,6863,0,6863,1.0,8608.79,4997.57,8605.2,4997.16,106
109,8423,8532,4934,5065,109,131,7647,0,7647,1.0,8487.81,4989.15,8484.84,4989.3,108
110,8343,8492,4951,5091,149,140,11180,66,11114,0.9940966010733453,8426.97,5028.72,8423.58,5028.71,109
111,8520,8573,4955,5025,53,70,2291,0,2291,1.0,8544.69,4989.5,8541.13,4989.82,110
112,8216,8399,4964,5080,183,116,13169,0,13169,1.0,8310.85,5027.25,8307.73,5027.28,111
113,4555,5844,4986,5930,1289,944,553717,658,553059,0.9988116673318681,5179.38,5461.7,5175.75,5462.2,112
114,8503,8588,5000,5090,85,90,3837,0,3837,1.0,8552.25,5046.57,8549.38,5046.31,113
115,2388,3122,5009,5488,734,479,193441,0,193441,1.0,2778.52,5254.93,2775.19,5255.2,114
116,8133,8183,5014,5065,50,51,1647,540,1107,0.6721311475409836,8158.97,5038.28,8155.61,5038.59,115
117,8626,8702,5024,5120,76,96,5373,0,5373,1.0,8669.08,5069.38,8665.89,5068.99,116
118,8068,8199,5035,5178,131,143,11874,1107,10767,0.9067710965133906,8136.06,5110.64,8133.26,5110.63,117
119,8168,8347,5039,5250,179,211,18606,100,18506,0.9946253896592497,8255.25,5132.66,8251.8,5132.86,118
120,8470,8697,5045,5216,227,171,18480,0,18480,1.0,8599.65,5124.72,8596.53,5124.58,119
121,10095,10424,5063,5360,329,297,55947,816,55131,0.9854147675478578,10278.02,5200.0,10274.7,5200.11,121
122,8343,8413,5064,5131,70,67,3231,0,3231,1.0,8378.34,5095.07,8374.99,5095.31,120
123,10255,10718,5071,5505,463,434,99338,315,99023,0.9968290080331796,10561.4,5313.5,10557.21,5313.66,122
124,7891,8013,5076,5144,122,68,4061,3027,1034,0.2546170893868505,7952.52,5109.55,7949.03,5110.02,123
125,7545,7702,5081,5230,157,149,16114,2411,13703,0.8503785528112201,7627.96,5156.24,7624.6,5156.38,124
126,7958,8069,5081,5150,111,69,4479,3047,1432,0.31971422192453675,8017.33,5119.92,8014.05,5120.09,125
127,8386,8507,5091,5205,121,114,9579,51,9528,0.9946758534293768,8449.57,5143.01,8446.03,5143.13,126
128,7683,7787,5101,5192,104,91,6195,909,5286,0.853268765133172,7735.69,5143.6,7732.85,5144.02,127
129,3198,3927,5109,5810,729,701,302060,2029,300031,0.9932827914983778,3581.63,5474.62,3578.51,5474.61,128
130,8290,8409,5121,5250,119,129,11122,0,11122,1.0,8347.88,5183.61,8344.28,5184.14,130
131,7918,8106,5122,5250,188,128,13794,3997,9797,0.7102363346382485,8014.76,5190.06,8012.06,5189.98,129
132,7446,7547,5129,5205,101,76,4557,211,4346,0.9536976080754883,7491.43,5163.06,7488.2,5162.82,131
133,7778,7839,5131,5201,61,70,2827,96,2731,0.9660417403608065,7817.54,5163.4,7814.23,5163.87,133
134,7838,7922,5131,5211,84,80,4857,341,4516,0.9297920527074326,7881.72,5170.1,7878.46,5170.13,132
135,7336,7482,5134,5305,146,171,17953,0,17953,1.0,7403.99,5215.78,7400.72,5216.32,134
136,7910,7969,5139,5185,59,46,1583,192,1391,0.8787113076437144,7939.54,5157.76,7936.5,5157.97,135
137,8471,8567,5141,5251,96,110,7443,0,7443,1.0,8527.13,5194.3,8523.73,5194.48,136
138,7455,7559,5156,5305,104,149,7119,0,7119,1.0,7508.83,5230.84,7505.77,5230.68,138
139,8558,8674,5156,5288,116,132,9410,3422,5988,0.6363443145589798,8618.09,5229.68,8614.76,5229.63,137
140,8048,8272,5166,5342,224,176,24017,0,24017,1.0,8163.32,5249.15,8160.16,5249.26,139
141,7760,7824,5169,5265,64,96,4500,2092,2408,0.5351111111111111,7791.01,5218.5,7788.12,5218.91,140
142,7168,7347,5171,5352,179,181,18480,1892,16588,0.8976190476190476,7271.01,5267.81,7267.62,5267.97,141
143,7661,7727,5172,5240,66,68,2977,0,2977,1.0,7696.81,5206.75,7693.49,5206.55,142
144,8665,8842,5176,5327,177,151,17302,2257,15045,0.8695526528725003,8752.5,5246.59,8749.39,5247.06,143
145,7720,7764,5179,5265,44,86,2736,0,2736,1.0,7746.54,5219.77,7743.66,5220.85,144
146,1990,3796,5190,6440,1806,1250,1162095,492,1161603,0.9995766266957521,2927.49,5847.65,2923.53,5847.66,145
147,7820,7859,5194,5260,39,66,1891,0,1891,1.0,7839.87,5228.16,7836.8,5228.21,148
148,7748,7992,5194,5378,244,184,24509,628,23881,0.9743767595577135,7877.56,5301.76,7874.16,5301.41,146
149,8353,8508,5194,5315,155,121,13262,0,13262,1.0,8436.4,5255.44,8433.19,5255.6,147
150,7898,7943,5204,5253,45,49,1525,159,1366,0.8957377049180328,7920.5,5230.13,7918.01,5230.15,149
151,7523,7594,5212,5295,71,83,4021,0,4021,1.0,7562.03,5251.73,7558.87,5251.86,150
152,7586,7737,5220,5302,151,82,7570,0,7570,1.0,7656.07,5257.71,7653.59,5257.96,151
153,3705,5109,5226,6903,1404,1677,1193078,0,1193078,1.0,4492.74,6059.02,4489.63,6058.96,152
154,7968,8110,5236,5431,142,195,14415,8,14407,0.999445022545959,8046.55,5318.47,8043.63,5319.65,153
155,8493,8588,5236,5340,95,104,6798,0,6798,1.0,8544.0,5287.58,8541.16,5287.76,154
156,8223,8392,5243,5511,169,268,24229,0,24229,1.0,8307.79,5346.62,8304.76,5347.24,155
157,7036,7192,5249,5432,156,183,18227,1193,17034,0.9345476490920064,7119.31,5344.11,7116.48,5344.05,156
158,7818,7847,5259,5290,29,31,699,72,627,0.8969957081545065,7833.8,5275.74,7830.99,5275.23,157
159,7705,7759,5261,5318,54,57,1729,0,1729,1.0,7731.82,5286.94,7728.11,5287.64,158
160,7733,7784,5263,5325,51,62,1966,151,1815,0.9231943031536114,7765.27,5297.78,7761.7,5297.5,159
161,7455,7563,5269,5375,108,106,6653,2837,3816,0.5735758304524274,7514.92,5324.94,7511.99,5325.2,160
162,8533,8774,5271,5580,241,309,42283,3384,38899,0.9199678357732421,8665.23,5405.46,8662.29,5406.01,161
163,7436,7487,5276,5340,51,64,1451,0,1451,1.0,7465.69,5306.96,7462.3,5306.86,162
164,7653,7704,5279,5313,51,34,1405,0,1405,1.0,7680.13,5295.37,7676.95,5295.62,163
165,8800,8897,5279,5385,97,106,6524,392,6132,0.9399141630901288,8850.3,5323.09,8847.1,5323.46,164
166,7608,7655,5284,5328,47,44,1566,0,1566,1.0,7633.3,5306.64,7630.62,5307.08,165
167,7285,7377,5285,5370,92,85,4428,0,4428,1.0,7335.76,5326.57,7332.64,5326.77,166
168,7563,7607,5285,5338,44,53,1789,0,1789,1.0,7585.7,5311.51,7583.12,5311.48,167
169,7373,7457,5286,5361,84,75,4147,0,4147,1.0,7416.54,5321.14,7413.64,5321.49,168
170,7643,7772,5306,5405,129,99,7963,507,7456,0.9363305286952154,7706.18,5351.73,7703.13,5351.81,169
171,8748,8819,5306,5358,71,52,2477,0,2477,1.0,8786.7,5332.36,8783.59,5332.44,170
172,8333,8549,5307,5478,216,171,29775,833,28942,0.9720235096557515,8442.27,5396.79,8439.12,5396.98,171
173,8080,8274,5319,5433,194,114,15075,545,14530,0.9638474295190713,8182.34,5375.31,8179.56,5375.61,172
174,7578,7652,5324,5360,74,36,2096,73,2023,0.9651717557251909,7620.03,5344.01,7616.4,5344.41,173
175,7506,7582,5330,5423,76,93,4504,0,4504,1.0,7550.88,5378.06,7547.84,5377.94,174
176,7186,7278,5334,5452,92,118,7884,489,7395,0.9379756468797564,7235.02,5388.7,7231.6,5388.75,175
177,7731,8044,5334,5525,313,191,33753,0,33753,1.0,7896.4,5418.4,7893.13,5418.56,176
178,7410,7472,5339,5400,62,61,2636,0,2636,1.0,7440.77,5370.96,7437.7,5371.13,177
179,7327,7420,5341,5430,93,89,5108,0,5108,1.0,7377.74,5383.0,7374.77,5383.0,178
180,7266,7358,5343,5450,92,107,5431,0,5431,1.0,7311.24,5396.72,7307.83,5396.67,179
181,8735,8840,5351,5545,105,194,14568,2423,12145,0.8336765513454146,8789.96,5447.15,8786.77,5447.53,180
182,6933,7083,5354,5490,150,136,14906,0,14906,1.0,7001.49,5420.69,6998.4,5420.94,181
183,7573,7658,5361,5405,85,44,2879,1283,1596,0.5543591524835012,7615.35,5379.74,7612.54,5380.15,182
184,7101,7194,5370,5460,93,90,2811,155,2656,0.9448594806118819,7154.65,5419.0,7151.4,5419.08,183
185,7453,7512,5371,5418,59,47,1637,0,1637,1.0,7485.4,5391.98,7481.79,5392.56,184
186,8851,8952,5371,5460,101,89,3279,2522,757,0.2308630680085392,8907.78,5416.37,8904.05,5416.03,185
187,7565,7712,5385,5470,147,85,6870,1503,5367,0.7812227074235808,7639.38,5421.83,7636.28,5422.03,186
188,8835,8982,5385,5540,147,155,12347,4470,7877,0.6379687373451041,8896.85,5474.95,8893.68,5474.74,187
189,7411,7538,5395,5470,127,75,5779,627,5152,0.8915037203668454,7477.91,5430.32,7475.13,5430.56,188
190,7683,7757,5401,5455,74,54,2930,0,2930,1.0,7724.39,5429.9,7721.01,5429.97,190
191,8091,8292,5401,5508,201,107,15845,0,15845,1.0,8191.15,5462.03,8187.97,5462.57,189
192,7141,7242,5405,5499,101,94,5355,0,5355,1.0,7189.85,5455.67,7186.94,5455.6,191
193,7320,7390,5419,5480,70,61,2796,0,2796,1.0,7358.78,5450.45,7355.48,5450.32,192
194,7363,7448,5420,5512,85,92,4096,0,4096,1.0,7407.44,5464.61,7404.13,5465.06,193
195,7535,7589,5421,5458,54,37,1302,156,1146,0.880184331797235,7567.01,5439.82,7563.4,5439.64,196
196,7966,8099,5421,5590,133,169,13411,0,13411,1.0,8039.52,5490.36,8036.06,5491.12,194
197,7221,7322,5425,5520,101,95,5870,0,5870,1.0,7274.98,5472.2,7271.64,5472.25,195
198,7038,7142,5429,5505,104,76,4336,0,4336,1.0,7088.17,5468.92,7085.41,5468.68,197
199,8501,8752,5430,5808,251,378,40479,50,40429,0.9987647916203464,8637.89,5625.52,8634.57,5625.35,198
200,7518,7561,5433,5472,43,39,1009,0,1009,1.0,7539.35,5452.71,7536.47,5453.41,199
201,10503,10718,5439,5911,215,472,51466,0,51466,1.0,10637.13,5618.85,10633.77,5619.42,200
202,7623,7697,5441,5488,74,47,2139,0,2139,1.0,7664.14,5464.61,7661.11,5464.73,201
203,1948,2224,5446,5877,276,431,39652,0,39652,1.0,2083.34,5613.48,2079.74,5614.83,202
204,7505,7847,5451,5745,342,294,59951,1275,58676,0.9787326316491801,7679.35,5569.56,7676.03,5569.73,203
205,7475,7552,5456,5521,77,65,3140,698,2442,0.7777070063694268,7518.7,5488.18,7515.78,5488.5,204
206,2795,2872,5461,5515,77,54,2339,0,2339,1.0,2836.91,5486.11,2834.0,5486.25,205
207,6647,6785,5464,5635,138,171,13726,0,13726,1.0,6721.92,5551.92,6718.63,5552.1,206
208,7430,7494,5465,5520,64,55,2409,385,2024,0.8401826484018264,7464.62,5493.09,7461.29,5493.05,207
209,4111,4249,5469,5607,138,138,9880,0,9880,1.0,4192.19,5534.29,4188.7,5534.24,208
210,8300,8547,5471,5622,247,151,26197,0,26197,1.0,8430.9,5539.7,8427.86,5540.17,209
211,7087,7169,5475,5545,82,70,3913,0,3913,1.0,7130.5,5508.76,7127.51,5508.77,210
212,7298,7369,5475,5525,71,50,2581,0,2581,1.0,7338.44,5498.09,7335.0,5498.61,211
213,7825,7997,5476,5690,172,214,25855,0,25855,1.0,7906.32,5575.06,7902.75,5575.62,212
214,8798,8889,5480,5575,91,95,4571,0,4571,1.0,8843.85,5532.83,8841.02,5533.43,214
215,6918,7027,5481,5550,109,69,4898,0,4898,1.0,6972.17,5510.76,6968.86,5510.9,213
216,7155,7240,5484,5555,85,71,4115,0,4115,1.0,7202.67,5520.73,7199.53,5520.99,215
217,7000,7104,5486,5567,104,81,4769,0,4769,1.0,7057.47,5529.52,7053.76,5529.12,216
218,7381,7434,5486,5533,53,47,1647,0,1647,1.0,7409.87,5509.73,7406.72,5509.85,217
219,7225,7327,5501,5586,102,85,5384,0,5384,1.0,7277.67,5543.61,7274.3,5543.9,218
220,8008,8330,5501,5722,322,221,41319,0,41319,1.0,8167.37,5588.98,8164.32,5589.68,219
221,6866,6947,5506,5567,81,61,2757,0,2757,1.0,6906.49,5538.69,6903.92,5539.21,220
222,7296,7514,5507,5817,218,310,34719,1877,32842,0.9459373829891414,7420.96,5620.98,7417.58,5621.5,221
223,8928,9024,5509,5608,96,99,6388,0,6388,1.0,8980.7,5555.26,8977.6,5555.52,222
224,6820,6897,5529,5593,77,64,3452,0,3452,1.0,6857.98,5562.55,6854.93,5562.75,224
225,6936,7022,5531,5613,86,82,3817,0,3817,1.0,6977.27,5565.51,6974.07,5565.83,223
226,8881,8992,5531,5682,111,151,8709,0,8709,1.0,8931.89,5608.24,8928.94,5608.25,225
227,6761,6832,5536,5610,71,74,3328,0,3328,1.0,6801.9,5571.89,6798.36,5571.82,226
228,7073,7161,5536,5598,88,62,2935,0,2935,1.0,7116.16,5565.7,7113.19,5565.41,227
229,8688,8909,5537,5740,221,203,24094,1487,22607,0.9382833900556155,8786.48,5630.11,8783.71,5630.59,228
230,7111,7229,5543,5650,118,107,7631,0,7631,1.0,7175.06,5593.47,7172.22,5593.41,229
231,6996,7083,5556,5628,87,72,3991,0,3991,1.0,7042.19,5588.41,7039.16,5588.54,230
232,6893,6955,5561,5640,62,79,3466,0,3466,1.0,6924.15,5601.85,6921.16,5602.19,231
233,8496,8622,5561,5680,126,119,10667,0,10667,1.0,8565.75,5623.11,8562.66,5623.24,232
234,7191,7265,5570,5660,74,90,3651,0,3651,1.0,7233.54,5617.8,7230.63,5617.94,233
235,6740,6853,5575,5698,113,123,7666,0,7666,1.0,6792.66,5639.48,6789.64,5639.63,235
236,8858,8897,5575,5645,39,70,2033,0,2033,1.0,8881.81,5612.5,8878.38,5612.58,234
237,6948,7132,5580,5667,184,87,7523,0,7523,1.0,7034.64,5626.14,7032.12,5626.15,236
238,7260,7318,5584,5628,58,44,2042,0,2042,1.0,7289.06,5605.22,7285.75,5605.49,237
239,6817,6904,5587,5632,87,45,2722,0,2722,1.0,6866.15,5608.78,6863.25,5608.89,238
240,7803,8138,5589,5810,335,221,41250,0,41250,1.0,7988.3,5712.6,7984.92,5712.69,239
241,6560,6747,5591,5710,187,119,12702,0,12702,1.0,6646.72,5647.85,6643.74,5647.88,240
242,8969,9091,5595,5732,122,137,8408,2553,5855,0.696360608943863,9035.33,5657.44,9032.09,5657.83,242
243,8325,8542,5596,5792,217,196,29649,0,29649,1.0,8436.05,5682.84,8432.96,5683.27,241
244,8113,8382,5604,5925,269,321,47182,1795,45387,0.9619558306133695,8254.63,5757.95,8251.44,5758.45,243
245,7018,7404,5615,5813,386,198,46672,0,46672,1.0,7205.6,5710.89,7202.02,5711.06,244
246,4818,5607,5621,6100,789,479,213958,8523,205435,0.9601650791276792,5205.33,5855.1,5202.45,5855.02,245
247,6833,6942,5629,5713,109,84,6857,0,6857,1.0,6893.41,5670.23,6890.07,5670.3,246
248,6928,7027,5634,5755,99,121,7929,2,7927,0.9997477613822676,6979.53,5695.59,6976.14,5696.01,247
249,7622,7787,5639,5795,165,156,21822,0,21822,1.0,7704.66,5717.87,7701.82,5718.03,248
250,7160,7217,5645,5700,57,55,2162,10,2152,0.9953746530989824,7187.82,5671.87,7184.86,5671.63,250
251,7450,7627,5645,5857,177,212,27581,0,27581,1.0,7535.07,5746.79,7531.75,5746.81,249
252,8936,9008,5650,5720,72,70,3423,0,3423,1.0,8975.14,5684.59,8971.66,5684.86,251
253,9070,9152,5659,5723,82,64,3387,157,3230,0.9536462946560378,9109.5,5689.64,9106.51,5690.18,252
254,6676,6812,5661,5765,136,104,7547,0,7547,1.0,6748.73,5707.97,6745.19,5708.13,253
255,8890,8943,5670,5740,53,70,2549,0,2549,1.0,8918.74,5705.1,8915.46,5705.1,255
256,6793,6992,5671,5845,199,174,18239,0,18239,1.0,6888.8,5760.65,6885.33,5760.65,256
257,8726,8892,5671,5942,166,271,27759,0,27759,1.0,8816.24,5805.14,8813.37,5805.03,254
258,8854,8894,5674,5723,40,49,1435,0,1435,1.0,8878.9,5696.34,8876.11,5696.46,257
259,8535,8602,5676,5750,67,74,4156,0,4156,1.0,8571.6,5710.32,8568.15,5710.38,258
260,8976,9077,5695,5841,101,146,9709,724,8985,0.9254300133896385,9027.9,5764.04,9024.79,5764.19,259
261,6618,6703,5699,5796,85,97,5470,0,5470,1.0,6663.29,5742.21,6660.12,5742.14,260
262,9068,9197,5701,5837,129,136,12279,0,12279,1.0,9132.31,5772.05,9129.15,5772.18,261
263,8922,8979,5714,5770,57,56,2312,233,2079,0.8992214532871973,8955.91,5740.67,8952.95,5740.45,262
264,8863,8904,5724,5811,41,87,2174,0,2174,1.0,8886.47,5767.57,8883.38,5767.74,263
265,6690,6768,5729,5820,78,91,4801,0,4801,1.0,6729.03,5770.5,6726.08,5770.83,264
266,7758,8067,5735,5966,309,231,35446,0,35446,1.0,7933.66,5849.4,7930.34,5849.51,266
267,6988,7037,5736,5790,49,54,1941,999,942,0.4853168469860896,7015.95,5764.12,7012.66,5764.58,267
268,8895,8940,5736,5808,45,72,2307,0,2307,1.0,8917.82,5770.94,8914.69,5771.19,265
269,8493,8628,5742,5878,135,136,12639,199,12440,0.9842550834717937,8564.94,5811.13,8561.75,5811.05,269
270,7248,7438,5744,5862,190,118,15224,3444,11780,0.7737782448765108,7333.74,5807.98,7330.85,5808.17,268
271,1723,2532,5746,7165,809,1419,515116,5135,509981,0.990031371574558,2059.18,6408.46,2056.34,6408.67,270
272,6585,6663,5748,5862,78,114,5799,0,5799,1.0,6626.31,5806.59,6623.06,5806.9,271
273,8286,8528,5749,6025,242,276,41424,0,41424,1.0,8416.57,5882.03,8413.3,5882.16,272
274,6748,6817,5761,5813,69,52,2507,0,2507,1.0,6787.89,5786.66,6784.52,5786.57,274
275,6851,7263,5761,6042,412,281,69874,4615,65259,0.9339525431490969,7075.43,5892.75,7072.17,5892.81,273
276,8928,8994,5764,5835,66,71,3350,0,3350,1.0,8966.7,5798.34,8963.38,5798.55,275
277,3608,3727,5781,5886,119,105,6452,0,6452,1.0,3679.65,5822.91,3676.4,5822.75,277
278,8058,8227,5781,5923,169,142,14527,0,14527,1.0,8125.53,5859.94,8122.91,5860.05,276
279,7733,7987,5782,6140,254,358,50844,0,50844,1.0,7854.17,5978.62,7851.1,5978.66,279
280,7508,7744,5784,6055,236,271,50720,0,50720,1.0,7632.05,5915.89,7628.95,5915.96,278
281,10543,10718,5786,6356,175,570,44086,872,43214,0.9802204781563308,10662.05,6004.51,10658.6,6005.92,280
282,6655,6712,5789,5865,57,76,2818,0,2818,1.0,6684.25,5824.65,6680.92,5824.85,281
283,9153,9249,5796,5958,96,162,7160,0,7160,1.0,9206.97,5881.29,9203.64,5881.05,282
284,8613,8902,5799,6190,289,391,52619,500,52119,0.9904977289572208,8759.16,5989.77,8755.82,5990.22,285
285,6625,6837,5800,5986,212,186,15726,0,15726,1.0,6738.61,5900.45,6735.78,5899.77,284
286,6498,6553,5804,5872,55,68,2388,0,2388,1.0,6525.84,5831.72,6522.17,5832.45,286
287,6550,6623,5806,5895,73,89,3378,0,3378,1.0,6588.33,5854.01,6584.5,5854.05,283
288,8900,8955,5806,5865,55,59,2081,0,2081,1.0,8929.72,5832.46,8926.71,5833.14,287
289,7360,7522,5810,6058,162,248,25828,0,25828,1.0,7448.68,5943.76,7445.41,5943.49,288
290,8841,9067,5811,6065,226,254,24526,323,24203,0.9868303025360842,8935.24,5948.99,8932.49,5948.88,289
291,9016,9103,5811,5910,87,99,5789,0,5789,1.0,9063.56,5857.65,9060.21,5858.05,290
292,6423,6502,5816,5890,79,74,3594,0,3594,1.0,6470.33,5854.06,6467.08,5854.5,291
293,6333,6444,5819,5942,111,123,6360,207,6153,0.9674528301886792,6389.44,5876.13,6386.43,5875.88,292
294,6686,6747,5821,5880,61,59,2388,0,2388,1.0,6722.58,5849.05,6718.91,5849.4,293
295,6825,6867,5825,5890,42,65,2101,0,2101,1.0,6848.25,5855.48,6845.23,5855.4,295
296,8940,9049,5825,5923,109,98,5681,0,5681,1.0,8998.68,5873.58,8995.52,5873.86,294
297,9091,9167,5831,5915,76,84,4052,0,4052,1.0,9129.03,5868.32,9125.93,5868.53,296
298,6500,6568,5840,5913,68,73,3504,0,3504,1.0,6539.74,5878.55,6536.29,5879.16,297
299,6775,6837,5844,5950,62,106,3784,0,3784,1.0,6806.77,5895.38,6803.58,5895.81,298
300,6612,6673,5845,5905,61,60,1791,0,1791,1.0,6642.83,5872.84,6639.49,5873.44,299
301,7213,7402,5845,6035,189,190,23577,0,23577,1.0,7301.09,5927.71,7297.86,5928.02,300
302,9245,9382,5851,6026,137,175,14814,0,14814,1.0,9310.67,5939.39,9307.34,5939.43,301
303,8495,8672,5856,6025,177,169,20495,501,19994,0.9755550134179068,8586.08,5939.76,8582.72,5939.85,302
304,6556,6922,5864,6236,366,372,66890,5930,60960,0.9113469875915683,6757.35,6064.38,6754.12,6064.09,303
305,6641,6707,5865,5914,66,49,2387,0,2387,1.0,6678.33,5890.35,6675.39,5890.61,304
306,6350,6442,5872,6030,92,158,7900,0,7900,1.0,6402.48,5957.8,6399.4,5957.62,305
307,6435,6508,5876,5965,73,89,3768,0,3768,1.0,6469.47,5914.47,6466.1,5914.58,306
308,9103,9212,5879,6003,109,124,8331,0,8331,1.0,9156.76,5941.19,9153.51,5941.21,307
309,6551,6617,5889,5950,66,61,3104,0,3104,1.0,6588.69,5917.21,6584.89,5917.34,308
310,8955,8993,5895,5925,38,30,807,213,594,0.7360594795539034,8977.1,5909.58,8974.0,5909.72,309
311,6608,6655,5900,5961,47,61,1721,0,1721,1.0,6633.66,5927.37,6630.49,5927.67,310
312,9073,9112,5900,5940,39,40,943,0,943,1.0,9096.15,5918.76,9093.22,5919.06,311
313,7965,8293,5901,6225,328,324,79617,0,79617,1.0,8138.51,6045.49,8135.21,6045.84,312
314,9039,9095,5905,5950,56,45,1575,0,1575,1.0,9066.83,5927.97,9063.63,5928.24,313
315,6426,6554,5910,6020,128,110,9032,3308,5724,0.6337466784765279,6498.75,5968.69,6495.67,5969.0,314
316,6538,6572,5931,5965,34,34,718,0,718,1.0,6555.58,5948.08,6552.85,5947.75,315
317,8285,8448,5934,6148,163,214,25117,0,25117,1.0,8363.74,6049.13,8360.7,6049.33,316
318,9048,9143,5941,6033,95,92,4434,0,4434,1.0,9097.2,5987.36,9094.19,5987.33,317
319,6543,6627,5946,6010,84,64,3312,0,3312,1.0,6586.03,5974.44,6582.84,5974.82,318
320,9171,9264,5946,6047,93,101,4801,129,4672,0.9731305977921266,9213.32,5990.97,9210.57,5990.88,319
321,6657,6713,5964,6015,56,51,1606,0,1606,1.0,6690.57,5986.04,6687.46,5986.03,320
322,8993,9113,5966,6123,120,157,7002,467,6535,0.9333047700656956,9058.89,6030.54,9056.47,6031.92,321
323,7469,7882,5971,6660,413,689,179647,0,179647,1.0,7681.51,6352.73,7678.49,6352.7,322
324,9278,9477,5976,6140,199,164,19244,2751,16493,0.8570463521097484,9385.58,6053.41,9382.19,6053.66,323
325,6848,6958,5981,6132,110,151,11641,0,11641,1.0,6910.15,6062.35,6907.13,6062.34,327
326,6648,6692,5983,6040,44,57,1528,905,623,0.40772251308900526,6668.34,6011.31,6665.66,6011.42,326
327,6948,7123,5984,6160,175,176,21429,493,20936,0.9769937934574642,7032.43,6068.35,7029.19,6068.44,325
328,9206,9293,5984,6090,87,106,5273,195,5078,0.9630191541816803,9253.59,6041.06,9250.18,6041.14,324
329,6369,6448,5985,6070,79,85,3113,46,3067,0.9852232573080629,6414.04,6032.5,6411.06,6032.17,329
330,8563,8734,5985,6150,171,165,18899,0,18899,1.0,8655.53,6062.89,8652.3,6063.18,328
331,7238,7425,5990,6208,187,218,25945,2922,23023,0.8873771439583735,7337.47,6096.0,7334.51,6096.18,330
332,7108,7272,5991,6135,164,144,16365,1498,14867,0.9084631836235869,7190.83,6064.96,7187.66,6065.26,331
333,8443,8579,5993,6138,136,145,14631,0,14631,1.0,8512.57,6066.51,8509.41,6066.65,332
334,3623,4304,5994,6925,681,931,355309,3221,352088,0.9909346512472242,3983.4,6474.44,3979.52,6474.45,333
335,6508,6564,5996,6060,56,64,2550,0,2550,1.0,6539.45,6029.57,6536.0,6029.74,334
336,9135,9208,6000,6085,73,85,3942,0,3942,1.0,9167.57,6043.05,9164.64,6042.99,335
337,6313,6387,6009,6098,74,89,3811,0,3811,1.0,6351.19,6055.48,6348.03,6055.52,337
338,7413,7604,6009,6245,191,236,28128,0,28128,1.0,7517.77,6116.66,7514.8,6117.07,336
339,8965,9017,6011,6083,52,72,2621,90,2531,0.9656619610835558,8992.88,6046.95,8989.88,6046.86,338
340,9093,9137,6016,6077,44,61,1875,0,1875,1.0,9119.49,6047.21,9116.18,6047.16,339
341,6400,6516,6019,6106,116,87,6420,787,5633,0.8774143302180686,6466.34,6058.65,6462.64,6059.17,340
342,8928,9137,6024,6369,209,345,37693,1668,36025,0.9557477515719099,9038.64,6201.97,9035.38,6201.7,343
343,9008,9054,6024,6083,46,59,1972,1054,918,0.46551724137931033,9033.36,6052.12,9030.36,6052.39,342
344,6273,6342,6026,6102,69,76,2192,0,2192,1.0,6306.16,6064.92,6302.97,6064.89,341
345,2455,3079,6036,6853,624,817,343061,172,342889,0.9994986314387238,2773.23,6452.46,2769.78,6452.08,344
346,6502,6668,6050,6256,166,206,16732,102,16630,0.9939038967248386,6589.03,6145.99,6585.76,6146.2,346
347,9163,9247,6055,6156,84,101,5204,0,5204,1.0,9205.12,6105.02,9201.74,6105.42,345
348,8838,9022,6064,6512,184,448,42858,484,42374,0.988706892528816,8939.63,6302.48,8936.25,6302.11,347
349,6353,6421,6069,6127,68,58,2565,0,2565,1.0,6391.78,6095.96,6388.4,6095.86,348
350,9108,9167,6069,6137,59,68,3184,0,3184,1.0,9140.52,6102.87,9137.21,6102.59,349
351,9451,9557,6072,6225,106,153,8262,0,8262,1.0,9507.53,6152.01,9504.14,6151.87,350
352,9224,9347,6076,6200,123,124,9289,782,8507,0.9158144041339218,9283.55,6130.09,9280.34,6130.35,351
353,6446,6504,6081,6140,58,59,2276,0,2276,1.0,6477.02,6110.29,6473.77,6109.93,352
354,6295,6404,6091,6240,109,149,10775,0,10775,1.0,6348.84,6157.6,6345.71,6158.03,353
355,6378,6494,6104,6232,116,128,8058,0,8058,1.0,6436.31,6168.85,6433.45,6169.22,354
356,6485,6547,6105,6165,62,60,2500,0,2500,1.0,6518.75,6137.79,6515.74,6137.74,355
357,8405,8577,6105,6333,172,228,24904,57,24847,0.9977112110504337,8489.06,6221.59,8486.0,6221.94,356
358,8529,8698,6105,6260,169,155,17545,0,17545,1.0,8611.78,6182.15,8608.36,6182.22,357
359,7793,8102,6106,6450,309,344,65093,0,65093,1.0,7955.88,6253.46,7952.69,6253.61,358
360,9335,9395,6107,6176,60,69,2651,0,2651,1.0,9364.97,6140.74,9361.89,6140.73,359
361,8175,8429,6110,6415,254,305,51964,0,51964,1.0,8308.04,6257.69,8304.81,6258.17,360
362,7130,7279,6111,6293,149,182,18797,1919,16878,0.8979092408363036,7205.91,6197.17,7202.81,6197.06,362
363,9365,9490,6111,6233,125,122,9532,0,9532,1.0,9430.4,6179.21,9427.09,6179.58,361
364,6925,7149,6116,6337,224,221,32211,0,32211,1.0,7052.66,6232.39,7049.43,6232.61,363
365,9070,9148,6119,6201,78,82,4047,0,4047,1.0,9111.47,6156.21,9108.78,6156.09,364
366,6851,7000,6121,6235,149,114,11367,0,11367,1.0,6925.8,6174.5,6922.72,6174.71,365
367,9140,9189,6131,6173,49,42,1349,0,1349,1.0,9166.08,6152.14,9163.1,6152.17,367
368,9291,9339,6131,6203,48,72,1910,0,1910,1.0,9318.74,6166.12,9315.48,6166.89,366
369,7218,7522,6139,6415,304,276,52783,4073,48710,0.9228350036943713,7365.53,6289.46,7362.61,6289.42,368
370,8800,8902,6144,6255,102,111,8313,5,8308,0.9993985324191026,8853.93,6198.97,8850.65,6199.22,369
371,9183,9243,6144,6227,60,83,3207,0,3207,1.0,9212.39,6183.5,9209.76,6183.28,370
372,8710,8809,6159,6262,99,103,6408,26,6382,0.9959425717852685,8772.38,6203.38,8769.3,6203.88,371
373,6418,6643,6160,6345,225,185,20573,1235,19338,0.9399698634132115,6541.02,6252.84,6537.56,6253.33,372
374,9319,9378,6161,6246,59,85,3081,0,3081,1.0,9348.71,6203.09,9345.43,6202.77,373
375,9125,9196,6166,6243,71,77,3868,0,3868,1.0,9162.39,6207.72,9159.88,6208.03,374
376,6741,6937,6184,6312,196,128,18179,0,18179,1.0,6838.38,6251.61,6835.5,6251.63,375
377,8636,8782,6190,6345,146,155,14352,0,14352,1.0,8711.26,6272.75,8708.04,6272.53,377
378,9189,9282,6190,6265,93,75,4389,0,4389,1.0,9244.36,6229.21,9240.84,6229.6,376
379,9278,9344,6190,6290,66,100,4353,156,4197,0.9641626464507237,9312.37,6242.36,9309.26,6242.43,378
380,9453,9587,6196,6350,134,154,13133,2115,11018,0.8389553034340973,9521.19,6274.79,9517.8,6274.85,379
381,7741,8237,6204,6960,496,756,202381,0,202381,1.0,8026.16,6638.18,8023.13,6637.75,380
382,6348,6424,6207,6258,76,51,2378,0,2378,1.0,6389.42,6236.07,6386.16,6236.18,381
383,6421,6474,6214,6263,53,49,1720,386,1334,0.7755813953488372,6448.46,6238.72,6445.83,6238.75,382
384,9343,9464,6220,6318,121,98,9293,96,9197,0.9896696438179274,9405.94,6270.32,9402.48,6270.32,383
385,6175,6293,6229,6312,118,83,5347,0,5347,1.0,6233.8,6266.38,6231.1,6266.6,384
386,6625,6769,6229,6403,144,174,16907,64,16843,0.9962145856745727,6695.53,6307.24,6692.45,6307.41,385
387,2218,2559,6231,6766,341,535,102983,0,102983,1.0,2362.81,6455.23,2359.9,6455.41,386
388,6301,6353,6234,6273,52,39,1216,0,1216,1.0,6331.61,6251.94,6329.03,6252.01,387
389,9128,9267,6239,6335,139,96,9644,0,9644,1.0,9192.55,6287.21,9190.07,6287.47,389
390,6350,6423,6244,6335,73,91,4023,0,4023,1.0,6389.0,6288.33,6385.74,6288.7,388
391,8741,8909,6244,6435,168,191,23470,0,23470,1.0,8832.64,6340.84,8829.46,6340.93,390
392,6280,6367,6245,6350,87,105,5561,0,5561,1.0,6329.42,6300.53,6325.63,6300.13,391
393,9260,9298,6247,6300,38,53,1180,0,1180,1.0,9280.37,6271.54,9277.44,6271.65,392
394,2991,3862,6249,6825,871,576,259155,65,259090,0.999749184850765,3375.04,6549.17,3372.31,6549.25,393
395,8553,8677,6256,6383,124,127,10117,39,10078,0.9961451023030543,8617.2,6316.79,8614.28,6316.92,395
396,6221,6302,6266,6340,81,74,3593,0,3593,1.0,6268.71,6305.22,6265.27,6306.59,394
397,6366,6585,6274,6506,219,232,23335,1443,21892,0.9381615598885794,6464.93,6376.9,6461.47,6377.23,397
398,7076,7257,6275,6492,181,217,28200,60,28140,0.997872340425532,7166.64,6387.08,7163.5,6387.13,398
399,6103,6227,6276,6395,124,119,9085,0,9085,1.0,6167.28,6334.76,6164.49,6334.89,396
400,7420,7492,6276,6353,72,77,3469,0,3469,1.0,7457.81,6305.83,7454.5,6306.25,399
401,8360,8590,6280,6550,230,270,37181,0,37181,1.0,8475.94,6420.12,8472.65,6420.24,400
402,9243,9338,6280,6407,95,127,5791,0,5791,1.0,9291.08,6343.08,9288.04,6342.75,401
403,9303,9382,6287,6384,79,97,5116,0,5116,1.0,9345.33,6333.69,9342.3,6333.7,402
404,6713,6907,6300,6452,194,152,17557,392,17165,0.9776727231303753,6807.44,6364.98,6804.46,6365.1,403
405,6845,7008,6306,6603,163,297,27532,0,27532,1.0,6923.07,6480.59,6920.01,6480.09,404
406,6928,7084,6306,6486,156,180,21300,10,21290,0.9995305164319249,7012.42,6386.11,7009.2,6386.33,405
407,9446,9524,6306,6380,78,74,3298,0,3298,1.0,9487.58,6343.84,9484.13,6343.81,406
408,9373,9464,6314,6371,91,57,3985,100,3885,0.9749058971141782,9422.0,6340.46,9418.65,6340.85,407
409,9104,9169,6315,6388,65,73,3196,0,3196,1.0,9139.33,6351.32,9136.02,6351.28,408
410,10588,10718,6319,6598,130,279,25155,0,25155,1.0,10667.17,6458.51,10663.8,6458.37,409
411,6020,6145,6326,6432,125,106,7916,295,7621,0.962733703890854,6080.84,6382.89,6077.7,6382.68,411
412,9058,9377,6326,6878,319,552,110131,1027,109104,0.9906747418982847,9225.93,6594.89,9222.46,6595.0,410
413,8545,8642,6329,6460,97,131,7604,547,7057,0.9280641767490795,8595.3,6398.81,8591.83,6398.33,414
414,9160,9227,6329,6375,67,46,2406,0,2406,1.0,9196.12,6349.59,9192.49,6349.84,412
415,6195,6295,6331,6410,100,79,4265,0,4265,1.0,6245.93,6365.3,6242.43,6365.77,413
416,6566,6678,6334,6457,112,123,9243,0,9243,1.0,6621.54,6396.81,6618.3,6396.5,415
417,6352,6394,6336,6368,42,32,1050,0,1050,1.0,6377.93,6350.7,6374.87,6351.16,416
418,7838,7974,6336,6502,136,166,14990,0,14990,1.0,7909.45,6420.69,7906.25,6420.85,417
419,6253,6404,6339,6576,151,237,22560,0,22560,1.0,6332.26,6450.31,6329.12,6450.5,418
420,9506,9654,6339,6560,148,221,15990,2292,13698,0.8566604127579738,9582.18,6443.05,9578.78,6442.84,419
421,8638,8782,6341,6495,144,154,15737,514,15223,0.9673381203533075,8710.04,6414.91,8707.02,6415.05,420
422,9008,9064,6351,6477,56,126,4776,0,4776,1.0,9039.44,6410.46,9036.13,6410.83,422
423,8220,8258,6352,6390,38,38,950,0,950,1.0,8239.5,6372.07,8236.04,6371.97,421
424,9360,9434,6362,6446,74,84,3707,0,3707,1.0,9398.56,6405.3,9394.88,6405.15,423
425,9403,9457,6364,6411,54,47,1527,138,1389,0.9096267190569745,9431.98,6381.96,9429.09,6382.5,424
426,6473,6578,6366,6505,105,139,10495,195,10300,0.9814197236779418,6525.74,6432.3,6522.46,6432.48,425
427,9435,9532,6373,6470,97,97,6365,0,6365,1.0,9484.94,6422.56,9481.69,6422.91,426
428,8168,8414,6380,6718,246,338,57609,0,57609,1.0,8298.91,6559.16,8295.83,6559.22,427
429,9296,9362,6380,6450,66,70,2861,0,2861,1.0,9333.48,6410.78,9329.75,6411.19,430
430,6145,6237,6381,6482,92,101,5040,0,5040,1.0,6192.24,6423.11,6188.99,6423.83,429
431,5935,6037,6384,6515,102,131,6930,1189,5741,0.8284271284271284,5995.78,6448.69,5992.53,6448.82,428
432,8321,8367,6391,6433,46,42,1330,0,1330,1.0,8350.38,6413.7,8347.55,6413.79,431
433,6646,6761,6396,6537,115,141,9364,64,9300,0.9931653139683896,6703.11,6460.38,6700.02,6460.74,433
434,7203,7489,6397,6650,286,253,50934,1476,49458,0.9710213217104489,7338.48,6517.34,7335.45,6517.5,434
435,6078,6179,6398,6512,101,114,5578,0,5578,1.0,6132.38,6450.44,6128.99,6450.37,432
436,6138,6294,6406,6587,156,181,15666,0,15666,1.0,6229.74,6501.82,6226.51,6502.0,435
437,6696,6878,6414,6652,182,238,26734,0,26734,1.0,6795.3,6534.58,6792.1,6534.65,437
438,9332,9393,6414,6502,61,88,3563,260,3303,0.9270277855739545,9363.05,6456.65,9360.25,6456.76,436
439,6006,6142,6419,6605,136,186,14855,0,14855,1.0,6078.27,6516.45,6074.78,6516.11,438
440,8761,8889,6426,6515,128,89,7417,1478,5939,0.8007280571659701,8831.02,6465.38,8827.72,6465.36,439
441,9386,9467,6434,6520,81,86,4170,0,4170,1.0,9427.33,6471.1,9424.59,6471.45,440
442,6522,6677,6445,6615,155,170,16036,0,16036,1.0,6597.49,6519.88,6594.27,6520.03,442
443,8559,8742,6446,6673,183,227,30728,139,30589,0.9954764384274929,8646.82,6568.1,8643.7,6568.24,441
444,6983,7147,6451,6620,164,169,18438,0,18438,1.0,7072.03,6537.67,7068.86,6537.8,444
445,9026,9107,6451,6528,81,77,4292,1203,3089,0.7197110904007455,9077.03,6486.28,9073.8,6486.77,443
446,6358,6413,6456,6525,55,69,2011,0,2011,1.0,6385.8,6489.74,6382.94,6490.36,445
447,9430,9556,6460,6570,126,110,8696,0,8696,1.0,9500.34,6511.54,9496.76,6511.91,446
448,8908,9082,6466,6635,174,169,18279,0,18279,1.0,8996.69,6545.48,8993.62,6545.62,447
449,8713,8822,6470,6615,109,145,9981,113,9868,0.9886784891293458,8761.9,6537.0,8758.98,6537.43,448
450,5928,5982,6471,6518,54,47,1714,166,1548,0.9031505250875146,5956.5,6496.2,5953.34,6496.18,449
451,7097,7224,6476,6735,127,259,20534,470,20064,0.97711113275543,7169.44,6605.22,7166.36,6604.97,450
452,9351,9417,6480,6550,66,70,2814,0,2814,1.0,9386.33,6512.99,9383.23,6513.59,451
453,6366,6567,6481,6715,201,234,33175,117,33058,0.9964732479276563,6464.51,6603.32,6461.32,6603.45,453
454,7403,7587,6485,6690,184,205,21713,0,21713,1.0,7498.41,6598.03,7495.22,6598.27,452
455,9523,9685,6489,6680,162,191,11252,1429,9823,0.8730003554923569,9598.77,6584.68,9595.53,6584.74,454
456,8783,8924,6495,6622,141,127,10492,2430,8062,0.7683949675943577,8857.97,6554.4,8854.94,6554.54,455
457,8390,8607,6501,6850,217,349,48698,0,48698,1.0,8488.49,6675.75,8485.35,6675.86,456
458,5855,6063,6505,6666,208,161,19959,2695,17264,0.8649731950498522,5967.94,6574.08,5964.94,6574.15,457
459,9393,9462,6518,6613,69,95,5073,0,5073,1.0,9431.03,6563.84,9427.89,6564.6,458
460,5773,5877,6524,6603,104,79,5143,1836,3307,0.6430099163912113,5827.17,6562.9,5824.22,6563.13,459
461,6509,6768,6531,6862,259,331,55303,0,55303,1.0,6647.41,6705.48,6644.26,6705.48,460
462,8520,8559,6534,6568,39,34,1042,0,1042,1.0,8546.69,6550.38,8542.44,6550.3,461
463,9363,9417,6542,6660,54,118,3620,0,3620,1.0,9388.08,6606.1,9384.91,6606.09,462
464,6112,6252,6546,6697,140,151,14861,0,14861,1.0,6183.7,6614.89,6180.34,6615.18,463
465,9613,9717,6551,6648,104,97,5263,0,5263,1.0,9668.98,6597.97,9665.99,6598.34,465
466,3892,4498,6554,7228,606,674,180662,0,180662,1.0,4199.71,6902.6,4197.11,6902.22,464
467,3163,3752,6559,7245,589,686,254003,5110,248893,0.9798821273764483,3483.73,6934.54,3480.68,6934.59,466
468,6243,6382,6559,6731,139,172,16886,0,16886,1.0,6317.37,6638.92,6314.17,6638.89,467
469,9446,9542,6561,6655,96,94,6713,0,6713,1.0,9496.12,6606.58,9492.76,6607.0,468
470,1715,1732,6566,6582,17,16,176,0,176,1.0,2059.18,6408.46,1723.75,6573.61,2002
471,6958,7102,6569,6680,144,111,7170,0,7170,1.0,7020.91,6623.55,7018.1,6623.48,469
472,5758,5927,6576,6755,169,179,20686,3772,16914,0.8176544522865706,5844.08,6668.56,5841.0,6668.26,470
473,8851,8967,6579,6690,116,111,7296,1786,5510,0.7552083333333334,8908.39,6632.7,8905.75,6632.77,472
474,8858,8897,6581,6618,39,37,935,0,935,1.0,8879.12,6598.05,8876.26,6598.1,471
475,6723,6997,6585,6910,274,325,58660,0,58660,1.0,6869.77,6741.32,6866.66,6741.48,473
476,8965,9126,6590,6726,161,136,12483,255,12228,0.9795722182167748,9060.53,6651.66,9057.35,6651.94,475
477,1939,2752,6591,7350,813,759,341807,0,341807,1.0,2357.73,6989.33,2354.48,6989.53,474
478,8711,8872,6594,6805,161,211,22013,199,21814,0.9909598873392995,8797.28,6693.8,8794.18,6693.78,476
479,6060,6122,6596,6655,62,59,3218,0,3218,1.0,6094.06,6626.13,6090.59,6626.19,477
480,9508,9598,6599,6701,90,102,6532,881,5651,0.8651255358236375,9556.92,6651.57,9553.56,6651.84,478
481,9405,9463,6610,6663,58,53,1783,0,1783,1.0,9437.78,6632.93,9434.3,6633.14,479
482,5910,6085,6611,6825,175,214,17911,10,17901,0.9994416838814136,6000.75,6710.34,5997.74,6710.58,480
483,7160,7472,6614,6903,312,289,61357,0,61357,1.0,7311.84,6754.7,7308.68,6754.69,481
484,6970,7193,6629,6950,223,321,44651,0,44651,1.0,7075.62,6797.76,7072.57,6797.98,482
485,9593,9652,6641,6701,59,60,1883,0,1883,1.0,9623.35,6672.51,9620.69,6672.83,484
486,8848,9084,6643,6930,236,287,43414,22,43392,0.999493251025015,8973.1,6774.8,8970.08,6774.88,486
487,7329,7867,6644,7161,538,517,178001,0,178001,1.0,7628.61,6899.28,7625.14,6899.48,485
488,9415,9459,6646,6685,44,39,1083,0,1083,1.0,9437.06,6665.85,9434.51,6665.84,487
489,9646,9737,6646,6785,91,139,8228,0,8228,1.0,9698.61,6712.01,9695.28,6712.33,483
490,6040,6173,6651,6778,133,127,11650,0,11650,1.0,6102.96,6710.71,6099.72,6710.66,489
491,9325,9425,6651,6761,100,110,6884,0,6884,1.0,9377.3,6701.2,9374.61,6701.48,488
492,9456,9512,6654,6728,56,74,3067,0,3067,1.0,9487.63,6687.21,9484.34,6687.67,490
493,6143,6329,6656,6838,186,182,22545,0,22545,1.0,6239.68,6754.4,6236.41,6754.49,491
494,7463,7522,6661,6740,59,79,3169,0,3169,1.0,7491.3,6698.22,7488.16,6698.57,492
495,8200,8282,6665,6760,82,95,3821,0,3821,1.0,8233.92,6709.65,8230.57,6709.73,493
496,8541,8807,6671,6940,266,269,45768,0,45768,1.0,8675.11,6804.03,8671.99,6804.49,494
497,9550,9657,6676,6758,107,82,5628,0,5628,1.0,9608.78,6719.55,9605.17,6719.67,496
498,8350,8394,6679,6728,44,49,1364,0,1364,1.0,8379.08,6706.06,8376.07,6706.31,495
499,9416,9467,6680,6737,51,57,2135,0,2135,1.0,9445.45,6706.58,9442.34,6706.68,497
500,9085,9182,6684,6810,97,126,10001,612,9389,0.9388061193880612,9134.85,6750.32,9131.47,6750.59,498
501,6311,6542,6686,6940,231,254,39994,0,39994,1.0,6422.35,6809.78,6419.33,6809.96,499
502,9498,9549,6691,6745,51,54,1658,0,1658,1.0,9526.67,6715.09,9523.13,6715.47,500
503,5900,5962,6692,6813,62,121,4169,1012,3157,0.7572559366754618,5931.45,6747.39,5928.24,6746.71,501
504,9381,9454,6714,6820,73,106,4382,0,4382,1.0,9422.25,6762.55,9419.02,6763.34,502
505,8163,8412,6716,7043,249,327,55981,0,55981,1.0,8287.25,6866.55,8283.98,6866.79,503
506,9506,9624,6720,6861,118,141,9062,424,8638,0.9532112116530567,9562.35,6791.23,9559.19,6791.46,504
507,9446,9524,6725,6817,78,92,5359,0,5359,1.0,9488.63,6767.07,9485.33,6767.38,505
508,2245,3662,6740,8300,1417,1560,1031238,0,1031238,1.0,2930.83,7530.96,2927.66,7531.12,506
509,5938,6088,6746,6921,150,175,11756,2748,9008,0.7662470227968697,6010.33,6832.51,6006.65,6832.61,507
510,9588,9737,6746,6845,149,99,8704,0,8704,1.0,9671.51,6793.44,9668.25,6793.53,508
511,6074,6182,6757,6869,108,112,8104,0,8104,1.0,6127.44,6814.68,6124.25,6815.12,509
512,9336,9412,6759,6820,76,61,2056,252,1804,0.877431906614786,9380.94,6784.3,9377.49,6784.19,510
513,9326,9412,6776,6835,86,59,2505,0,2505,1.0,9366.4,6808.65,9363.6,6808.57,511
514,8400,8432,6786,6813,32,27,615,0,615,1.0,8418.09,6801.22,8414.91,6801.42,512
515,8777,8995,6791,6990,218,199,28177,0,28177,1.0,8876.34,6904.89,8873.64,6905.23,513
516,9407,9488,6794,6897,81,103,5402,1247,4155,0.7691595705294335,9450.76,6843.03,9447.75,6843.46,514
517,9253,9392,6805,6968,139,163,11753,1609,10144,0.863098783289373,9325.2,6908.06,9322.24,6907.75,515
518,8363,8623,6810,7027,260,217,39195,392,38803,0.9899987243270826,8492.59,6913.05,8489.54,6913.06,517
519,6446,6672,6811,7175,226,364,57455,130,57325,0.9977373596727874,6574.06,6988.69,6570.89,6988.91,516
520,9480,9544,6811,6908,64,97,3543,0,3543,1.0,9514.11,6856.01,9510.85,6856.74,518
521,6110,6387,6814,7057,277,243,39668,216,39452,0.9945548048805082,6261.9,6930.82,6258.9,6930.98,519
522,9328,9414,6814,6890,86,76,4306,0,4306,1.0,9369.67,6854.21,9366.24,6854.05,520
523,9543,9660,6815,6910,117,95,7155,804,6351,0.8876310272536687,9610.11,6862.04,9606.92,6862.15,521
524,6660,6817,6826,7073,157,247,28572,0,28572,1.0,6735.44,6949.26,6732.23,6949.42,523
525,6948,6977,6826,6860,29,34,622,0,622,1.0,6967.88,6842.98,6964.48,6843.1,522
526,8966,9288,6827,7100,322,273,55924,0,55924,1.0,9141.18,6959.82,9138.01,6959.84,525
527,9648,9750,6829,6958,102,129,8164,2813,5351,0.6554385105340519,9705.59,6885.89,9702.28,6886.33,524
528,3535,4070,6832,7614,535,782,234134,0,234134,1.0,3817.8,7247.51,3814.33,7247.52,526
529,5915,6023,6834,7045,108,211,12605,61,12544,0.9951606505355017,5975.89,6930.22,5972.79,6930.44,527
530,6768,7062,6846,7140,294,294,57885,0,57885,1.0,6931.99,7001.72,6928.69,7002.08,528
531,6050,6160,6855,6990,110,135,6920,2082,4838,0.6991329479768786,6100.67,6919.71,6097.77,6920.31,529
532,9440,9513,6865,6957,73,92,4109,103,4006,0.9749330737405695,9478.42,6912.37,9475.19,6913.07,530
533,7038,7508,6870,7298,470,428,132406,0,132406,1.0,7289.87,7075.95,7286.64,7076.14,531
534,9383,9447,6871,6926,64,55,2385,0,2385,1.0,9418.94,6898.71,9415.44,6898.71,532
535,9528,9587,6875,6940,59,65,2158,0,2158,1.0,9559.67,6908.26,9556.31,6908.3,533
536,1569,1874,6881,7300,305,419,66616,0,66616,1.0,1704.59,7039.46,1701.42,7040.22,535
537,9713,9769,6881,7013,56,132,4115,1929,2186,0.5312272174969623,9750.16,6952.73,9746.94,6951.73,534
538,7746,8200,6889,7345,454,456,120738,2658,118080,0.9779853898524077,7970.44,7103.23,7967.19,7103.26,536
539,8621,8842,6896,7128,221,232,33598,0,33598,1.0,8729.64,7013.01,8726.41,7013.0,537
540,9548,9654,6896,6985,106,89,5128,969,4159,0.8110374414976599,9605.95,6938.79,9602.56,6938.91,538
541,6013,6077,6904,7012,64,108,4428,265,4163,0.9401535682023487,6046.08,6957.75,6042.76,6957.53,539
542,9638,9698,6905,6980,60,75,2591,301,2290,0.8838286375916634,9671.54,6942.06,9668.22,6941.97,540
543,9496,9555,6906,6965,59,59,2332,0,2332,1.0,9526.57,6935.99,9523.38,6936.57,541
544,9385,9442,6911,6960,57,49,1718,0,1718,1.0,9413.76,6935.86,9411.2,6936.13,542
545,6354,6497,6934,7113,143,179,18386,0,18386,1.0,6427.09,7030.18,6423.79,7030.08,543
546,9368,9472,6944,7056,104,112,6847,0,6847,1.0,9429.95,6992.11,9427.03,6992.59,544
547,6110,6212,6946,7061,102,115,6021,6,6015,0.9990034877927254,6161.17,7002.58,6158.27,7002.69,545
548,6151,6189,6946,6985,38,39,943,0,943,1.0,6173.61,6965.02,6170.47,6964.83,546
549,9466,9538,6946,7058,72,112,4964,1602,3362,0.6772763900080581,9498.24,7003.75,9495.31,7004.57,547
550,9616,9682,6946,7011,66,65,2334,0,2334,1.0,9651.48,6979.64,9648.31,6979.32,548
551,8090,8512,6954,7380,422,426,115952,0,115952,1.0,8326.8,7167.12,8323.49,7167.28,549
552,9266,9617,6956,7238,351,282,49448,0,49448,1.0,9432.21,7107.64,9429.16,7107.99,551
553,9515,9572,6956,7041,57,85,3524,333,3191,0.9055051078320091,9544.13,6996.61,9541.01,6996.7,550
554,9658,9767,6957,7098,109,141,8626,1706,6920,0.8022258288894041,9719.73,7027.87,9716.65,7028.18,552
555,6051,6312,6966,7248,261,282,34510,0,34510,1.0,6153.57,7127.48,6150.89,7127.53,553
556,9597,9659,6975,7045,62,70,3057,702,2355,0.7703631010794897,9627.13,7014.25,9624.35,7014.17,554
557,8505,8721,6979,7275,216,296,43833,0,43833,1.0,8608.04,7136.75,8604.98,7136.87,555
558,9563,9597,6981,7040,34,59,1683,0,1683,1.0,9583.61,7008.63,9580.64,7008.78,556
559,8798,8997,6989,7175,199,186,25684,0,25684,1.0,8893.32,7067.83,8890.08,7067.74,558
560,5973,6074,6990,7176,101,186,11952,1,11951,0.9999163319946452,6027.71,7088.46,6024.3,7088.01,557
561,8471,8527,7014,7065,56,51,1628,0,1628,1.0,8502.51,7034.23,8499.3,7034.66,559
562,6196,6247,7021,7095,51,74,2514,0,2514,1.0,6226.12,7054.67,6222.85,7054.98,560
563,9410,9453,7021,7083,43,62,1933,0,1933,1.0,9433.26,7053.09,9430.0,7053.22,561
564,9585,9617,7031,7085,32,54,1254,0,1254,1.0,9601.51,7058.66,9598.5,7058.44,563
565,9534,9587,7033,7087,53,54,2178,0,2178,1.0,9563.89,7059.22,9560.33,7059.35,562
566,6242,6303,7039,7128,61,89,3827,0,3827,1.0,6273.73,7078.56,6270.48,7078.79,564
567,8993,9170,7039,7170,177,131,19065,0,19065,1.0,9082.28,7099.26,9079.17,7099.53,565
568,9611,9687,7041,7101,76,60,3456,807,2649,0.7664930555555556,9650.23,7070.27,9647.1,7070.36,566
569,6284,6397,7044,7175,113,131,9934,0,9934,1.0,6338.57,7109.15,6335.28,7109.36,567
570,6628,6839,7046,7185,211,139,22113,0,22113,1.0,6738.47,7122.73,6734.95,7123.36,568
571,9618,9729,7054,7160,111,106,5790,154,5636,0.9734024179620034,9680.17,7109.54,9676.95,7109.61,569
572,7043,7078,7075,7110,35,35,902,0,902,1.0,7061.44,7093.85,7058.27,7094.09,570
573,9053,9359,7076,7321,306,245,42955,728,42227,0.983052031195437,9224.66,7190.89,9221.45,7190.97,571
574,6200,6287,7080,7160,87,80,3608,0,3608,1.0,6240.78,7122.56,6237.75,7122.24,573
575,9565,9617,7080,7140,52,60,1822,478,1344,0.7376509330406147,9590.45,7109.3,9587.18,7109.23,572
576,9598,9628,7080,7125,30,45,846,0,846,1.0,9615.37,7101.67,9612.41,7101.58,574
577,9713,9802,7090,7250,89,160,10001,0,10001,1.0,9760.9,7163.54,9757.84,7163.72,575
578,7468,7820,7096,7460,352,364,91504,0,91504,1.0,7649.82,7288.59,7646.6,7288.69,576
579,6950,7179,7100,7330,229,230,30214,0,30214,1.0,7061.24,7210.44,7058.05,7210.74,577
580,8855,9091,7107,7356,236,249,41308,0,41308,1.0,8965.0,7230.14,8961.7,7230.19,580
581,3945,4487,7110,7735,542,625,208966,0,208966,1.0,4254.68,7421.35,4251.31,7421.44,578
582,6358,6637,7111,7240,279,129,23623,0,23623,1.0,6486.34,7177.87,6483.79,7178.41,579
583,6635,6967,7116,7335,332,219,29886,180,29706,0.9939771130295122,6863.15,7208.23,6858.92,7208.7,581
584,1700,2091,7121,7527,391,406,91895,950,90945,0.989662114369661,1893.06,7311.49,1889.79,7311.39,582
585,8710,8867,7124,7352,157,228,26765,0,26765,1.0,8784.96,7232.28,8781.8,7232.66,583
586,9605,9654,7132,7180,49,48,1436,0,1436,1.0,9629.39,7159.63,9626.25,7159.54,584
587,6953,7007,7134,7185,54,51,1482,0,1482,1.0,6977.52,7152.59,6974.55,7152.87,585
588,9653,9722,7136,7200,69,64,3119,1050,2069,0.6633536389868547,9690.08,7164.9,9686.97,7165.23,586
589,5923,6009,7146,7321,86,175,8102,0,8102,1.0,5970.05,7230.39,5966.6,7230.84,587
590,6005,6062,7151,7245,57,94,3511,44,3467,0.9874679578467673,6033.26,7193.88,6030.21,7193.96,588
591,6292,6412,7167,7288,120,121,9679,0,9679,1.0,6350.89,7228.49,6347.64,7228.78,589
592,9596,9695,7176,7257,99,81,5011,1386,3625,0.7234085012971463,9648.67,7214.96,9645.62,7215.17,590
593,1894,2684,7179,7840,790,661,321017,0,321017,1.0,2323.57,7501.19,2319.34,7501.59,591
594,9687,9727,7184,7237,40,53,1329,15,1314,0.9887133182844243,9708.22,7208.36,9705.62,7207.91,592
595,9298,9487,7186,7400,189,214,20754,405,20349,0.9804856895056374,9405.59,7294.68,9402.16,7294.77,593
596,9393,9654,7186,7485,261,299,40762,3274,37488,0.9196800942053873,9533.01,7339.09,9529.5,7339.28,594
597,7763,8222,7201,7688,459,487,139313,586,138727,0.9957936445270721,8007.08,7449.07,8003.7,7449.21,595
598,6125,6183,7204,7246,58,42,1349,0,1349,1.0,6157.93,7223.56,6154.4,7223.48,598
599,6165,6315,7204,7472,150,268,23535,0,23535,1.0,6252.96,7343.13,6249.77,7343.69,597
600,7058,7302,7205,7486,244,281,43129,3372,39757,0.9218159475063182,7182.66,7344.99,7179.56,7344.94,599
601,4765,5222,7206,7751,457,545,133598,0,133598,1.0,4987.25,7470.74,4984.42,7471.03,596
602,6043,6124,7206,7248,81,42,2463,0,2463,1.0,6083.11,7224.11,6080.38,7224.4,600
603,9556,9602,7206,7250,46,44,1379,0,1379,1.0,9581.59,7229.25,9578.4,7229.17,601
604,9695,9817,7211,7333,122,122,7536,1906,5630,0.7470806794055201,9759.49,7274.24,9755.85,7274.32,602
605,6627,6869,7219,7376,242,157,31316,153,31163,0.995114318559203,6752.02,7292.42,6748.85,7292.61,603
606,6121,6177,7226,7286,56,60,2059,0,2059,1.0,6153.16,7256.31,6150.17,7256.71,604
607,8471,8782,7226,7530,311,304,50731,0,50731,1.0,8635.74,7358.41,8632.51,7358.72,606
608,6389,6637,7229,7390,248,161,25481,309,25172,0.9878733173737294,6497.28,7290.72,6493.36,7291.52,607
609,6020,6132,7230,7297,112,67,4206,522,3684,0.8758915834522111,6072.0,7259.76,6068.65,7260.06,605
610,6168,6224,7234,7315,56,81,3064,0,3064,1.0,6200.27,7275.74,6197.14,7275.92,608
611,5990,6022,7236,7288,32,52,1198,85,1113,0.9290484140233722,6009.17,7261.45,6006.05,7261.66,609
612,9084,9298,7239,7393,214,154,20328,0,20328,1.0,9204.33,7314.18,9201.02,7314.4,610
613,9645,9712,7239,7307,67,68,3215,0,3215,1.0,9683.14,7272.41,9679.89,7272.58,611
614,7234,7502,7266,7683,268,417,77294,0,77294,1.0,7382.37,7473.46,7379.29,7473.85,612
615,6098,6148,7267,7320,50,53,1728,0,1728,1.0,6125.66,7290.81,6122.53,7290.88,613
616,6296,6392,7269,7380,96,111,6545,0,6545,1.0,6345.1,7318.04,6341.88,7318.42,614
617,5933,6048,7273,7470,115,197,15855,4203,11652,0.7349101229895932,5990.07,7369.03,5987.06,7369.23,615
618,7293,7327,7274,7300,34,26,579,0,579,1.0,7309.59,7284.74,7307.21,7285.17,616
619,6031,6102,7279,7331,71,52,2679,0,2679,1.0,6069.62,7301.51,6066.51,7301.68,617
620,6705,7129,7285,7638,424,353,76383,237,76146,0.9968972153489651,6970.63,7455.26,6967.07,7455.53,620
621,6138,6192,7286,7337,54,51,1588,246,1342,0.845088161209068,6168.65,7309.01,6165.83,7309.24,619
622,9635,9692,7286,7335,57,49,1686,621,1065,0.6316725978647687,9662.07,7310.53,9659.28,7310.77,618
623,9681,9780,7294,7369,99,75,4609,0,4609,1.0,9727.75,7331.22,9724.8,7331.46,621
624,6486,6704,7300,7445,218,145,19049,0,19049,1.0,6582.15,7364.11,6578.92,7364.23,622
625,8768,8954,7305,7498,186,193,24689,0,24689,1.0,8861.69,7401.06,8858.59,7401.2,623
626,6048,6142,7307,7385,94,78,5270,0,5270,1.0,6096.5,7348.88,6093.9,7348.97,624
627,8924,9182,7309,7586,258,277,44957,0,44957,1.0,9037.12,7436.4,9033.98,7436.38,625
628,6132,6179,7312,7373,47,61,1734,0,1734,1.0,6158.08,7342.26,6154.66,7342.02,626
629,8180,8521,7319,7672,341,353,85438,0,85438,1.0,8358.56,7487.3,8355.03,7486.85,627
630,9763,9877,7319,7470,114,151,9222,4214,5008,0.5430492301019302,9818.75,7395.47,9815.78,7395.93,628
631,9651,9716,7329,7435,65,106,4123,0,4123,1.0,9680.38,7384.6,9677.3,7384.18,629
632,9168,9400,7331,7526,232,195,30396,1374,29022,0.9547966837741808,9304.45,7429.08,9301.24,7429.25,630
633,6278,6332,7340,7405,54,65,1984,0,1984,1.0,6308.8,7370.72,6306.06,7370.72,631
634,6328,6518,7345,7485,190,140,15646,0,15646,1.0,6413.2,7417.17,6410.68,7417.47,632
635,9700,9774,7354,7408,74,54,3142,0,3142,1.0,9739.63,7379.61,9736.79,7379.71,633
636,6120,6164,7362,7420,44,58,1641,0,1641,1.0,6141.37,7391.56,6139.0,7391.44,634
637,6029,6125,7377,7459,96,82,5647,0,5647,1.0,6080.05,7414.91,6076.9,7415.08,636
638,6146,6176,7379,7435,30,56,1030,0,1030,1.0,6165.33,7407.51,6162.05,7408.3,635
639,8518,8617,7381,7480,99,99,7216,0,7216,1.0,8575.96,7429.9,8572.57,7430.01,637
640,6555,6744,7389,7545,189,156,24539,0,24539,1.0,6654.1,7470.86,6650.66,7470.65,638
641,9455,9675,7394,7527,220,133,18472,389,18083,0.9789411000433088,9571.15,7462.22,9567.97,7462.18,639
642,9638,9807,7401,7564,169,163,15129,2388,12741,0.8421574459647035,9728.68,7473.9,9725.28,7474.29,640
643,7420,8242,7404,8541,822,1137,541282,0,541282,1.0,7831.51,7955.17,7828.48,7955.82,641
644,6310,6344,7406,7448,34,42,1140,0,1140,1.0,6328.08,7428.11,6324.91,7428.34,642
645,5925,6107,7419,7601,182,182,18836,2050,16786,0.8911658526226375,6019.03,7516.56,6015.61,7516.68,644
646,6111,6177,7420,7485,66,65,2875,688,2187,0.760695652173913,6146.37,7451.87,6142.86,7452.09,643
647,6167,6207,7424,7465,40,41,1271,0,1271,1.0,6189.64,7443.52,6186.17,7443.81,645
648,6207,6247,7424,7453,40,29,922,0,922,1.0,6228.45,7437.89,6225.43,7437.87,646
649,6728,6869,7424,7545,141,121,14796,0,14796,1.0,6802.07,7481.91,6798.59,7481.95,647
650,9816,9974,7430,7571,158,141,8714,0,8714,1.0,9910.76,7498.39,9907.25,7498.58,648
651,8720,8797,7436,7531,77,95,3219,0,3219,1.0,8750.98,7478.31,8748.06,7478.24,650
652,9043,9274,7436,7650,231,214,34095,707,33388,0.9792638216747324,9170.43,7550.9,9167.34,7550.91,651
653,8406,8773,7439,7790,367,351,70532,0,70532,1.0,8605.2,7621.52,8601.63,7621.71,649
654,6479,6577,7444,7613,98,169,10909,0,10909,1.0,6527.84,7521.78,6524.61,7522.38,653
655,6060,6119,7445,7498,59,53,2049,0,2049,1.0,6093.88,7469.87,6090.43,7470.27,652
656,6196,6257,7445,7486,61,41,1608,0,1608,1.0,6229.56,7466.39,6226.09,7466.2,654
657,7743,7779,7446,7485,36,39,966,0,966,1.0,7767.56,7466.92,7763.58,7466.48,656
658,6301,6408,7447,7600,107,153,8670,0,8670,1.0,6357.61,7519.57,6354.39,7519.95,655
659,7066,7298,7449,7763,232,314,43573,189,43384,0.9956624515181419,7199.02,7604.53,7195.78,7604.87,657
660,6385,6493,7451,7533,108,82,5275,0,5275,1.0,6442.5,7492.44,6438.94,7492.39,658
661,8730,8968,7461,7703,238,242,38848,0,38848,1.0,8846.88,7581.35,8843.64,7581.38,660
662,6162,6208,7465,7522,46,57,1766,0,1766,1.0,6188.37,7491.15,6185.04,7491.04,663
663,3515,4279,7466,8063,764,597,242294,0,242294,1.0,3971.72,7765.86,3967.92,7765.62,659
664,6218,6287,7466,7557,69,91,4075,0,4075,1.0,6259.91,7510.37,6256.52,7510.62,664
665,6253,6334,7466,7585,81,119,4843,0,4843,1.0,6301.86,7532.79,6298.47,7532.46,662
666,9803,9918,7470,7643,115,173,11164,0,11164,1.0,9868.41,7557.62,9864.96,7557.77,665
667,6096,6167,7475,7540,71,65,3018,0,3018,1.0,6132.57,7504.54,6129.15,7504.83,666
668,9265,9486,7476,7635,221,159,23556,516,23040,0.97809475292919,9387.29,7557.89,9384.09,7558.1,667
669,6186,6232,7486,7550,46,64,1825,16,1809,0.9912328767123287,6214.37,7516.87,6210.78,7517.59,668
670,9780,9839,7499,7638,59,139,6344,0,6344,1.0,9813.56,7566.75,9809.87,7566.87,669
671,9428,9679,7501,7691,251,190,19177,64,19113,0.9966626688220264,9552.4,7583.41,9548.92,7583.58,670
672,6133,6187,7509,7560,54,51,1697,0,1697,1.0,6166.15,7535.33,6162.59,7535.12,672
673,6375,6497,7509,7615,122,106,8010,0,8010,1.0,6441.82,7566.94,6438.69,7567.0,671
674,9458,9792,7511,7782,334,271,43093,3838,39255,0.9109368110830065,9654.91,7657.15,9651.83,7656.89,673
675,9483,9527,7523,7580,44,57,1898,4,1894,0.9978925184404637,9504.96,7551.48,9502.12,7551.0,677
676,6080,6162,7531,7610,82,79,3565,506,3059,0.8580645161290322,6124.38,7567.48,6121.45,7567.88,678
677,8065,8287,7531,7752,222,221,26048,0,26048,1.0,8176.49,7640.58,8173.75,7640.63,679
678,6595,6791,7538,7838,196,300,34778,0,34778,1.0,6699.65,7705.94,6696.28,7705.92,680
679,6755,6968,7540,7702,213,162,21173,0,21173,1.0,6866.04,7612.22,6862.85,7612.34,684
680,6158,6207,7541,7592,49,51,1384,0,1384,1.0,6186.78,7565.17,6183.53,7565.42,682
681,6186,6285,7541,7671,99,130,7918,0,7918,1.0,6236.27,7604.95,6233.28,7605.07,683
682,6533,6724,7541,7705,191,164,19970,0,19970,1.0,6618.02,7609.13,6615.05,7609.17,681
683,9753,9787,7554,7605,34,51,1345,0,1345,1.0,9774.07,7578.73,9770.89,7579.49,685
684,5958,6084,7561,7743,126,182,14797,0,14797,1.0,6021.6,7661.23,6018.79,7661.72,687
685,9881,10012,7561,7705,131,144,11572,3236,8336,0.7203594884203249,9956.98,7637.63,9953.73,7637.81,686
686,6268,6352,7566,7651,84,85,4488,0,4488,1.0,6313.34,7609.32,6309.89,7609.33,688
687,8909,9232,7567,7847,323,280,53197,0,53197,1.0,9044.86,7705.55,9041.63,7705.3,689
688,6133,6194,7576,7640,61,64,2305,0,2305,1.0,6169.98,7608.51,6166.77,7608.7,690
689,6045,6122,7579,7640,77,61,3045,0,3045,1.0,6083.86,7606.92,6080.72,7606.96,691
690,6318,6388,7590,7715,70,125,5336,0,5336,1.0,6361.14,7658.17,6357.99,7658.31,693
691,6433,6740,7590,8013,307,423,48137,0,48137,1.0,6565.18,7807.72,6562.27,7808.54,692
692,6363,6439,7606,7755,76,149,7325,0,7325,1.0,6407.34,7680.48,6404.09,7680.85,694
693,6070,6167,7609,7723,97,114,7747,1862,5885,0.759648896346973,6120.8,7665.54,6117.74,7665.44,696
694,4465,5362,7610,8325,897,715,336326,3413,332913,0.9898521077763837,4858.54,7940.32,4855.71,7940.58,695
695,6850,7140,7614,7905,290,291,48616,0,48616,1.0,7003.52,7756.24,6999.96,7756.81,697
696,9202,9468,7616,7825,266,209,37529,0,37529,1.0,9346.55,7706.16,9343.49,7706.54,698
697,7263,7514,7620,7975,251,355,56352,556,55796,0.9901334469051675,7397.39,7789.18,7394.38,7789.19,699
698,9710,9839,7624,7805,129,181,12745,1843,10902,0.8553942722636328,9790.47,7704.26,9787.06,7704.65,700
699,6266,6331,7631,7683,65,52,2350,409,1941,0.8259574468085107,6303.72,7657.86,6300.96,7657.82,701
700,6163,6219,7634,7713,56,79,3226,0,3226,1.0,6194.38,7672.75,6191.1,7672.74,702
701,9825,9922,7639,7735,97,96,6903,0,6903,1.0,9876.05,7684.2,9872.83,7684.46,703
702,6741,6914,7644,7845,173,201,22024,0,22024,1.0,6828.31,7751.5,6824.99,7751.29,705
703,3648,5502,7645,9160,1854,1515,1321559,0,1321559,1.0,4555.37,8482.28,4552.58,8482.47,706
704,8128,8497,7649,8110,369,461,100079,0,100079,1.0,8318.08,7847.3,8314.88,7847.61,707
705,1893,2632,7651,8675,739,1024,306831,0,306831,1.0,2227.52,8138.38,2224.92,8139.34,704
706,2828,3904,7656,8438,1076,782,541696,0,541696,1.0,3355.58,8055.69,3352.27,8055.96,708
707,6215,6268,7656,7722,53,66,2446,0,2446,1.0,6241.2,7686.7,6238.29,7687.03,709
708,8708,8922,7660,7916,214,256,35457,0,35457,1.0,8814.13,7788.09,8810.83,7788.12,710
709,6261,6332,7675,7735,71,60,2587,0,2587,1.0,6300.87,7703.0,6297.28,7702.79,711
710,6076,6190,7686,7763,114,77,3746,0,3746,1.0,6138.5,7724.44,6135.0,7724.45,712
711,9895,10079,7689,7840,184,151,17855,6567,11288,0.6322038644637357,9988.49,7764.42,9984.62,7764.66,713
712,8488,8742,7694,7955,254,261,40295,0,40295,1.0,8605.57,7823.89,8602.55,7824.03,714
713,7066,7312,7696,7957,246,261,36861,0,36861,1.0,7199.01,7840.61,7196.02,7840.94,715
714,6233,6310,7700,7787,77,87,4071,0,4071,1.0,6270.68,7744.89,6267.81,7744.93,716
715,9445,9567,7704,7855,122,151,11958,0,11958,1.0,9516.8,7773.68,9513.25,7773.59,717
716,6166,6239,7710,7803,73,93,4644,0,4644,1.0,6208.08,7753.78,6204.9,7753.72,718
717,6308,6362,7712,7780,54,68,1984,0,1984,1.0,6339.72,7747.89,6335.83,7747.4,719
718,6343,6369,7714,7750,26,36,698,0,698,1.0,6359.44,7728.87,6356.64,7729.22,720
719,9825,9907,7715,7787,82,72,3938,1630,2308,0.5860843067546978,9867.85,7753.86,9862.33,7751.46,721
720,6316,6497,7717,7882,181,165,16501,26,16475,0.998424337918914,6417.41,7805.79,6413.69,7805.77,722
721,9563,9667,7729,7850,104,121,9079,0,9079,1.0,9613.19,7789.31,9610.01,7789.34,723
722,5960,6123,7731,7845,163,114,13953,0,13953,1.0,6037.9,7791.74,6035.13,7792.17,724
723,6099,6179,7739,7816,80,77,4333,634,3699,0.8536810523886453,6140.03,7774.93,6137.39,7775.04,725
724,9051,9215,7741,7990,164,249,26970,0,26970,1.0,9146.22,7850.69,9142.77,7850.94,726
725,6296,6332,7748,7786,36,38,806,0,806,1.0,6317.66,7767.47,6313.94,7767.59,727
726,9731,9828,7749,7890,97,141,6889,0,6889,1.0,9778.08,7820.32,9774.81,7820.43,728
727,9183,9382,7759,7995,199,236,34718,0,34718,1.0,9286.02,7876.85,9282.79,7877.03,729
728,6263,6314,7770,7870,51,100,3342,0,3342,1.0,6292.56,7821.66,6289.27,7822.02,730
729,9635,9744,7771,7875,109,104,7539,87,7452,0.9884600079586152,9696.48,7822.2,9693.08,7822.58,731
730,6203,6279,7775,7836,76,61,3209,0,3209,1.0,6245.1,7807.22,6242.17,7807.25,733
731,6305,6362,7776,7871,57,95,2583,0,2583,1.0,6332.92,7813.92,6329.47,7813.96,732
732,9800,9909,7781,7893,109,112,7799,3029,4770,0.6116168739581997,9854.87,7830.04,9852.36,7829.86,734
733,6106,6239,7785,7945,133,160,11837,1298,10539,0.8903438371208922,6174.71,7862.65,6172.18,7863.34,735
734,9371,9532,7788,7981,161,193,22232,721,21511,0.9675692695214105,9452.2,7887.21,9448.97,7887.21,736
735,9886,9963,7801,7868,77,67,3119,0,3119,1.0,9925.22,7833.01,9922.18,7832.33,737
736,8825,8983,7806,8159,158,353,37488,0,37488,1.0,8897.87,7978.44,8894.66,7978.38,738
737,9976,10122,7809,7971,146,162,15214,817,14397,0.9462994610227422,10054.69,7884.42,10051.31,7884.56,740
738,6625,6809,7810,7930,184,120,13321,0,13321,1.0,6715.14,7869.6,6712.24,7869.66,739
739,6728,6877,7821,7960,149,139,10323,0,10323,1.0,6811.43,7901.29,6808.18,7901.58,741
740,8955,9135,7824,8060,180,236,27620,0,27620,1.0,9030.86,7952.51,9027.7,7952.53,743
741,9866,9989,7825,7940,123,115,8453,4011,4442,0.5254939074884656,9937.91,7885.07,9934.66,7884.97,742
742,6359,6582,7826,7987,223,161,16090,2131,13959,0.8675574891236792,6483.74,7899.28,6479.88,7899.38,744
743,6220,6262,7829,7889,42,60,1786,0,1786,1.0,6244.06,7855.07,6240.98,7853.78,745
744,9523,9652,7830,7965,129,135,13322,0,13322,1.0,9589.8,7898.74,9586.68,7898.78,746
745,5955,6137,7839,7977,182,138,17568,0,17568,1.0,6042.57,7897.19,6039.36,7897.42,747
746,9698,9894,7841,8060,196,219,19681,1692,17989,0.9140287587012855,9780.15,7956.02,9776.8,7956.13,748
747,6975,7161,7844,8095,186,251,29164,521,28643,0.9821355095323001,7066.98,7957.03,7064.09,7957.47,749
748,8478,8522,7854,7903,44,49,1402,0,1402,1.0,8501.64,7880.83,8498.65,7880.79,750
749,6206,6363,7859,8020,157,161,16177,1231,14946,0.9239043085862645,6292.86,7936.26,6289.57,7936.52,751
750,6813,6979,7864,8020,166,156,16785,0,16785,1.0,6907.4,7946.99,6904.42,7947.08,752
751,9648,9732,7864,7950,84,86,5568,83,5485,0.9850933908045977,9693.78,7906.29,9690.72,7906.41,753
752,7270,7422,7879,8116,152,237,23599,0,23599,1.0,7347.61,8003.49,7344.38,8003.48,754
753,9818,9904,7885,7953,86,68,3714,0,3714,1.0,9862.01,7919.4,9858.98,7919.61,755
754,6355,6442,7890,7958,87,68,3712,0,3712,1.0,6395.59,7925.16,6392.48,7925.42,756
755,8610,8829,7891,8110,219,219,38048,0,38048,1.0,8734.9,8009.7,8731.59,8009.71,757
756,8338,8634,7894,8140,296,246,49078,0,49078,1.0,8495.66,8015.44,8492.65,8015.56,758
757,6180,6224,7899,7960,44,61,1879,0,1879,1.0,6201.58,7925.45,6198.54,7926.09,759
758,9882,10058,7915,8105,176,190,21554,5605,15949,0.7399554607033497,9973.18,8003.74,9969.92,8003.82,760
759,6010,6232,7926,8090,222,164,23435,1123,22312,0.9520802218903349,6127.54,8002.73,6124.39,8002.76,761
760,9603,9729,7927,8030,126,103,7741,0,7741,1.0,9669.58,7978.59,9666.4,7978.41,762
761,9400,9792,7931,8285,392,354,63133,4341,58792,0.9312403972565853,9570.85,8109.27,9567.61,8109.54,763
762,9328,9467,7935,8152,139,217,18147,2642,15505,0.8544111974431036,9400.9,8038.07,9397.87,8038.44,764
763,7098,7289,7936,8248,191,312,39187,0,39187,1.0,7208.51,8087.16,7205.27,8087.67,765
764,6326,6394,7945,8027,68,82,3124,0,3124,1.0,6362.43,7990.84,6359.55,7990.84,766
765,6663,6937,7946,8180,274,234,39919,0,39919,1.0,6804.92,8063.3,6801.58,8063.22,767
766,7268,7302,7946,7982,34,36,811,0,811,1.0,7289.66,7962.92,7286.56,7963.26,768
767,6370,6442,7949,7998,72,49,2442,0,2442,1.0,6410.63,7970.88,6407.11,7971.16,769
768,6378,6573,7949,8075,195,126,14014,0,14014,1.0,6493.58,8003.78,6490.11,8004.03,770
769,9124,9232,7956,8098,108,142,11401,0,11401,1.0,9181.55,8029.5,9178.63,8029.47,771
770,1720,1902,7974,8160,182,186,17842,0,17842,1.0,1816.58,8064.16,1813.56,8064.28,773
771,6920,7047,7974,8158,127,184,16229,0,16229,1.0,6983.49,8066.18,6980.3,8066.32,772
772,9208,9374,7976,8155,166,179,19826,0,19826,1.0,9292.84,8067.76,9290.09,8068.1,774
773,6220,6288,7981,8058,68,77,2859,0,2859,1.0,6254.44,8024.14,6251.67,8025.06,775
774,9748,9887,7984,8105,139,121,7078,2,7076,0.9997174343034756,9814.85,8037.2,9811.97,8037.28,776
775,6532,6864,8001,8438,332,437,56142,2056,54086,0.9633785757543372,6694.62,8220.75,6691.2,8220.96,777
776,6277,6322,8009,8055,45,46,1478,0,1478,1.0,6300.97,8027.41,6298.13,8028.6,778
777,8925,9148,8009,8147,223,138,17619,0,17619,1.0,9052.52,8085.08,9049.26,8085.13,779
778,6311,6362,8010,8070,51,60,1751,0,1751,1.0,6336.05,8040.34,6333.01,8040.18,780
779,9808,9919,8016,8116,111,100,7813,0,7813,1.0,9870.46,8069.3,9867.36,8069.53,782
780,9464,9477,8017,8030,13,13,125,0,125,1.0,9494.05,8088.15,9470.1,8023.3,2003
781,6337,6419,8021,8127,82,106,5469,0,5469,1.0,6381.21,8074.76,6377.88,8074.94,783
782,9448,9545,8030,8145,97,115,5304,0,5304,1.0,9494.05,8088.15,9491.55,8089.64,781
783,7388,7444,8031,8093,56,62,2003,0,2003,1.0,7419.63,8063.89,7416.23,8064.42,784
784,6400,6534,8034,8135,134,101,8125,0,8125,1.0,6471.97,8078.46,6468.89,8078.74,785
785,6186,6254,8035,8104,68,69,2695,0,2695,1.0,6220.3,8068.66,6216.9,8069.43,786
786,6262,6344,8054,8140,82,86,4644,0,4644,1.0,6307.14,8092.0,6304.16,8092.16,787
787,6083,6132,8059,8115,49,56,1841,0,1841,1.0,6109.79,8084.57,6106.59,8084.41,789
788,6200,6279,8059,8150,79,91,3504,0,3504,1.0,6247.15,8105.62,6244.22,8105.84,788
789,8193,8427,8061,8235,234,174,21810,0,21810,1.0,8313.78,8152.42,8310.57,8152.58,790
790,7260,7514,8073,8377,254,304,45074,0,45074,1.0,7400.75,8216.58,7397.55,8216.78,792
791,6126,6194,8074,8135,68,61,2442,0,2442,1.0,6163.44,8100.53,6159.82,8101.36,791
792,8508,8668,8076,8210,160,134,13902,0,13902,1.0,8592.23,8142.6,8589.06,8142.88,793
793,7004,7167,8079,8233,163,154,17009,0,17009,1.0,7091.98,8159.2,7088.69,8159.55,794
794,9806,10004,8081,8268,198,187,21960,8847,13113,0.5971311475409836,9924.28,8174.93,9920.98,8175.02,795
795,8233,8270,8087,8125,37,38,923,0,923,1.0,8251.96,8108.34,8249.01,8107.92,796
796,7273,7323,8089,8139,50,50,1526,0,1526,1.0,7301.21,8114.23,7297.27,8113.85,797
797,9091,9387,8092,8298,296,206,27664,802,26862,0.9710092539039907,9252.76,8179.72,9249.44,8180.04,798
798,6395,6492,8097,8182,97,85,4473,0,4473,1.0,6435.82,8136.37,6432.63,8136.58,800
799,9700,9828,8097,8200,128,103,8958,0,8958,1.0,9769.44,8153.12,9766.31,8152.88,801
800,6464,6554,8100,8253,90,153,8541,837,7704,0.9020021074815595,6509.67,8182.14,6506.86,8182.0,802
801,6135,6232,8101,8217,97,116,6657,0,6657,1.0,6187.97,8160.29,6184.62,8160.22,799
802,8635,8849,8101,8220,214,119,15065,0,15065,1.0,8727.43,8152.64,8724.65,8153.01,803
803,6318,6397,8105,8193,79,88,4830,0,4830,1.0,6362.98,8149.22,6359.69,8149.34,804
804,6103,6150,8110,8195,47,85,2523,0,2523,1.0,6127.89,8149.46,6124.44,8149.88,805
805,9820,9887,8114,8163,67,49,2436,0,2436,1.0,9854.69,8134.73,9850.93,8135.27,806
806,8855,9012,8119,8288,157,169,18671,0,18671,1.0,8932.8,8204.27,8929.57,8204.47,807
807,6198,6340,8125,8270,142,145,13701,3183,10518,0.7676811911539304,6274.33,8197.29,6271.06,8197.37,808
808,6738,6877,8129,8245,139,116,10280,0,10280,1.0,6804.82,8187.79,6801.77,8187.76,809
809,8366,8552,8131,8288,186,157,21230,240,20990,0.988695242581253,8460.18,8208.79,8456.93,8208.95,810
810,8980,9118,8131,8265,138,134,13908,0,13908,1.0,9050.16,8193.94,9046.77,8193.87,811
811,6581,6667,8134,8250,86,116,6360,0,6360,1.0,6630.68,8189.52,6627.24,8189.54,812
812,7475,7823,8137,8387,348,250,53218,0,53218,1.0,7631.56,8278.01,7628.27,8277.87,813
813,6856,7063,8141,8315,207,174,24578,0,24578,1.0,6955.2,8227.24,6951.78,8227.35,814
814,9378,9427,8146,8200,49,54,1845,0,1845,1.0,9403.71,8173.2,9400.44,8173.47,815
815,6515,6574,8150,8195,59,45,1846,722,1124,0.6088840736728061,6547.88,8173.06,6544.96,8173.32,816
816,6416,6493,8154,8375,77,221,9961,0,9961,1.0,6456.56,8269.14,6453.17,8269.01,817
817,8683,8865,8158,8362,182,204,25742,0,25742,1.0,8782.46,8254.85,8779.22,8255.85,818
818,9630,9718,8164,8245,88,81,5106,0,5106,1.0,9680.15,8201.41,9677.03,8201.59,819
819,6376,6422,8173,8226,46,53,1508,0,1508,1.0,6404.76,8197.77,6401.64,8197.92,820
820,6083,6122,8181,8275,39,94,2547,1570,977,0.38358853553199845,6105.31,8227.28,6102.14,8227.68,821
821,3006,3783,8186,8890,777,704,202137,0,202137,1.0,3388.27,8541.25,3385.22,8540.77,822
822,6333,6408,8186,8265,75,79,3725,0,3725,1.0,6372.56,8226.02,6369.41,8225.5,824
823,9103,9340,8186,8388,237,202,25954,0,25954,1.0,9226.12,8288.28,9222.79,8288.32,823
824,6116,6247,8189,8330,131,141,10864,76,10788,0.9930044182621502,6170.53,8258.66,6168.07,8259.14,826
825,9716,9833,8189,8280,117,91,6456,0,6456,1.0,9773.87,8227.81,9770.91,8227.76,825
826,6543,6589,8191,8235,46,44,1609,0,1609,1.0,6566.86,8213.21,6564.12,8213.22,827
827,9553,9631,8194,8265,78,71,3499,1353,2146,0.6133180908831095,9596.39,8224.97,9593.14,8225.55,828
828,8153,8237,8196,8300,84,104,6061,0,6061,1.0,8196.07,8250.36,8192.89,8250.57,829
829,9334,9422,8201,8310,88,109,6038,403,5635,0.9332560450480292,9379.4,8258.3,9376.01,8258.65,830
830,8501,8707,8203,8337,206,134,19408,92,19316,0.9952596867271228,8606.96,8267.36,8603.7,8267.65,831
831,8225,8407,8206,8390,182,184,23170,0,23170,1.0,8308.05,8292.49,8304.98,8292.86,832
832,6273,6372,8224,8293,99,69,3665,114,3551,0.9688949522510232,6329.47,8261.6,6326.26,8262.15,833
833,6396,6447,8225,8291,51,66,2043,0,2043,1.0,6424.47,8260.25,6421.18,8259.83,835
834,6578,6653,8225,8290,75,65,2812,0,2812,1.0,6615.53,8259.9,6612.56,8260.17,834
835,9768,9917,8229,8320,149,91,8204,1963,6241,0.7607264748902974,9851.05,8270.73,9848.04,8270.79,837
836,7143,7375,8230,8411,232,181,25845,0,25845,1.0,7273.06,8315.5,7269.82,8315.65,839
837,6545,6587,8231,8265,42,34,1037,0,1037,1.0,6571.32,8247.45,6567.19,8247.2,836
838,7007,7214,8231,8435,207,204,29551,0,29551,1.0,7113.64,8334.3,7110.68,8334.68,838
839,6480,6607,8239,8350,127,111,8054,0,8054,1.0,6550.07,8291.3,6546.48,8291.45,840
840,9507,9594,8240,8320,87,80,4333,0,4333,1.0,9552.72,8277.62,9549.31,8277.92,841
841,8933,9198,8241,8583,265,342,54086,0,54086,1.0,9063.93,8391.67,9060.83,8391.84,842
842,9387,9512,8251,8333,125,82,6337,2461,3876,0.6116458892220293,9448.63,8292.52,9445.49,8292.6,843
843,8816,8937,8254,8423,121,169,13991,0,13991,1.0,8884.88,8339.72,8881.69,8339.85,844
844,6359,6422,8264,8337,63,73,2978,0,2978,1.0,6395.24,8298.56,6392.01,8298.23,846
845,9533,9614,8265,8365,81,100,4202,0,4202,1.0,9585.06,8317.38,9582.05,8317.37,845
846,6241,6283,8266,8310,42,44,1054,0,1054,1.0,6264.79,8284.71,6262.21,8285.31,847
847,8095,8133,8270,8303,38,33,750,0,750,1.0,8115.99,8288.25,8113.25,8288.25,848
848,6810,6937,8273,8425,127,152,13312,0,13312,1.0,6871.41,8347.51,6868.15,8347.57,849
849,6593,6692,8276,8380,99,104,6313,0,6313,1.0,6648.29,8326.44,6645.42,8326.68,851
850,2455,3212,8279,8840,757,561,230768,0,230768,1.0,2824.85,8525.02,2821.73,8525.2,853
851,6205,6322,8279,8445,117,166,10283,1623,8660,0.8421666828746475,6261.52,8361.04,6258.55,8361.63,850
852,6273,6402,8281,8397,129,116,10214,0,10214,1.0,6337.92,8337.41,6335.1,8337.76,852
853,8317,8535,8284,8462,218,178,25580,271,25309,0.9894057857701329,8431.47,8369.26,8428.18,8369.35,854
854,8036,8232,8286,8435,196,149,19209,0,19209,1.0,8141.71,8354.98,8138.22,8355.32,855
855,6915,7067,8294,8461,152,167,16237,0,16237,1.0,6986.98,8385.65,6984.09,8385.61,857
856,6433,6657,8295,8425,224,130,13695,0,13695,1.0,6544.61,8371.15,6541.51,8371.43,856
857,9480,9574,8300,8435,94,135,6134,0,6134,1.0,9536.27,8367.06,9532.82,8367.2,859
858,8626,8757,8301,8445,131,144,11530,0,11530,1.0,8695.75,8370.68,8692.45,8370.79,858
859,9328,9395,8309,8382,67,73,3217,1257,1960,0.6092632887783649,9360.49,8338.99,9357.22,8339.39,860
860,7762,7837,8310,8427,75,117,4776,0,4776,1.0,7802.13,8365.38,7798.83,8365.76,861
861,8010,8059,8319,8382,49,63,2165,0,2165,1.0,8039.58,8348.33,8036.38,8348.47,863
862,9351,9485,8319,8422,134,103,6474,14,6460,0.9978375038616002,9411.45,8366.03,9408.6,8366.32,864
863,9568,9677,8320,8455,109,135,7698,11,7687,0.9985710574175111,9620.38,8378.8,9616.97,8379.47,862
864,6150,6219,8321,8380,69,59,2483,0,2483,1.0,6191.23,8346.01,6187.42,8345.85,865
865,6398,6442,8327,8378,44,51,1588,0,1588,1.0,6421.84,8352.92,6418.76,8352.63,866
866,8486,8702,8329,8557,216,228,32613,1291,31322,0.9604145586115966,8597.35,8443.56,8594.11,8443.69,867
867,9415,9527,8338,8460,112,122,8650,0,8650,1.0,9480.8,8397.82,9477.45,8397.9,869
868,8741,8854,8340,8475,113,135,9585,0,9585,1.0,8798.62,8408.57,8795.71,8408.6,868
869,7336,7602,8344,8605,266,261,40837,0,40837,1.0,7463.77,8472.16,7460.69,8472.3,870
870,7531,7796,8364,8575,265,211,36432,0,36432,1.0,7676.1,8455.72,7672.59,8455.79,871
871,9176,9225,8365,8415,49,50,1441,0,1441,1.0,9206.4,8386.38,9203.81,8386.51,873
872,2983,3169,8366,8463,186,97,11258,0,11258,1.0,3076.33,8415.58,3073.23,8415.73,872
873,9300,9352,8366,8437,52,71,2248,801,1447,0.6436832740213523,9325.77,8398.56,9322.5,8399.07,874
874,8128,8332,8369,8556,204,187,23562,651,22911,0.9723707664884136,8229.09,8455.6,8226.07,8455.74,875
875,6350,6455,8371,8452,105,81,5404,0,5404,1.0,6402.84,8410.88,6399.6,8410.73,877
876,9196,9319,8371,8505,123,134,10437,0,10437,1.0,9262.73,8438.42,9259.65,8438.67,876
877,7508,7547,8376,8427,39,51,1283,0,1283,1.0,7531.62,8398.2,7528.54,8398.23,878
878,8903,9025,8379,8715,122,336,16065,0,16065,1.0,8969.71,8542.68,8966.31,8542.14,880
879,6605,6862,8380,8508,257,128,18051,0,18051,1.0,6756.47,8452.18,6752.62,8452.42,879
880,9145,9217,8385,8462,72,77,3772,832,2940,0.7794273594909862,9181.43,8423.34,9178.21,8422.8,881
881,8033,8058,8390,8428,25,38,682,0,682,1.0,8045.74,8409.27,8042.48,8409.63,882
882,6315,6357,8391,8428,42,37,1070,0,1070,1.0,6338.6,8407.95,6335.43,8408.15,883
883,7183,7367,8394,8559,184,165,20789,0,20789,1.0,7283.54,8468.78,7280.06,8468.71,884
884,6593,6652,8396,8434,59,38,1639,0,1639,1.0,6623.04,8412.33,6620.49,8412.6,885
885,6411,6484,8398,8475,73,77,3660,0,3660,1.0,6454.38,8440.89,6450.98,8440.96,886
886,9313,9365,8400,8473,52,73,2349,0,2349,1.0,9340.85,8437.46,9337.89,8437.67,887
887,9391,9477,8404,8510,86,106,5397,1332,4065,0.7531962201222901,9439.03,8458.83,9435.74,8458.91,888
888,6481,6542,8409,8492,61,83,3618,0,3618,1.0,6513.8,8449.19,6510.62,8449.35,890
889,6850,6963,8409,8537,113,128,9659,1482,8177,0.8465679676985195,6906.87,8470.0,6903.65,8470.04,889
890,8773,8959,8411,8665,186,254,30677,2652,28025,0.9135508687290153,8866.65,8536.82,8863.55,8536.76,891
891,6248,6382,8419,8535,134,116,9964,0,9964,1.0,6312.09,8472.64,6309.2,8472.6,893
892,6533,6644,8419,8532,111,113,7894,550,7344,0.9303268305041804,6591.24,8472.96,6587.91,8473.26,892
893,9348,9422,8419,8513,74,94,4576,0,4576,1.0,9385.75,8469.1,9382.54,8469.36,894
894,7042,7208,8421,8568,166,147,18109,0,18109,1.0,7123.94,8487.71,7120.74,8488.24,895
895,9463,9602,8421,8535,139,114,6211,760,5451,0.8776364514570922,9523.02,8474.94,9519.8,8474.84,896
896,8670,8797,8430,8635,127,205,16648,119,16529,0.9928519942335415,8739.42,8529.58,8736.32,8529.62,897
897,8418,8563,8435,8560,145,125,11201,1029,10172,0.9081332023926435,8487.77,8503.64,8484.74,8503.72,899
898,8283,8443,8436,8578,160,142,15311,1365,13946,0.910848409640128,8367.63,8506.97,8364.54,8507.06,898
899,3638,3717,8445,8542,79,97,4064,0,4064,1.0,3670.24,8493.32,3667.33,8493.25,900
900,6375,6422,8446,8530,47,84,2473,0,2473,1.0,6397.56,8480.92,6394.55,8481.61,901
901,7538,7602,8446,8500,64,54,1947,0,1947,1.0,7576.15,8468.33,7572.19,8468.15,902
902,6946,7062,8454,8586,116,132,9544,0,9544,1.0,7009.3,8510.8,7006.03,8511.15,903
903,9151,9209,8456,8535,58,79,2898,0,2898,1.0,9181.76,8490.92,9178.43,8491.23,904
904,6438,6519,8464,8525,81,61,3201,0,3201,1.0,6477.94,8496.09,6474.89,8496.28,905
905,9296,9367,8467,8550,71,83,3896,450,3446,0.8844969199178645,9331.0,8508.59,9328.08,8508.86,906
906,6618,6739,8471,8596,121,125,8855,0,8855,1.0,6676.82,8540.56,6673.57,8540.67,907
907,6388,6447,8474,8575,59,101,3176,0,3176,1.0,6419.72,8523.18,6416.47,8523.29,908
908,6516,6573,8476,8546,57,70,2531,0,2531,1.0,6549.02,8510.73,6545.87,8510.87,909
909,9242,9297,8481,8525,55,44,1806,0,1806,1.0,9274.27,8503.98,9271.39,8504.4,910
910,6780,6949,8485,8775,169,290,27083,0,27083,1.0,6849.71,8641.75,6846.56,8641.75,911
911,7722,7993,8489,8770,271,281,54772,0,54772,1.0,7870.09,8612.37,7866.65,8612.76,912
912,6710,6809,8494,8610,99,116,6793,0,6793,1.0,6764.57,8547.42,6761.18,8547.95,913
913,9176,9257,8494,8558,81,64,3262,0,3262,1.0,9218.31,8525.44,9215.23,8525.44,914
914,7983,8183,8496,8714,200,218,31533,0,31533,1.0,8077.53,8603.18,8074.26,8603.18,915
915,6303,6402,8499,8643,99,144,9694,0,9694,1.0,6358.85,8565.65,6355.67,8566.08,916
916,8143,8343,8501,8703,200,202,25561,0,25561,1.0,8246.12,8610.62,8242.64,8610.74,917
917,9084,9163,8504,8623,79,119,6003,0,6003,1.0,9125.43,8566.9,9122.46,8566.84,918
918,7140,7309,8505,8646,169,141,14835,0,14835,1.0,7226.94,8576.12,7223.87,8576.33,919
919,9340,9482,8506,8612,142,106,10214,0,10214,1.0,9407.57,8551.91,9404.58,8552.17,920
920,3398,4167,8511,9230,769,719,240231,5687,234544,0.9763269519753903,3847.42,8856.55,3843.62,8856.46,921
921,6460,6563,8513,8645,103,132,9923,1496,8427,0.8492391413886929,6510.83,8581.34,6507.76,8581.34,922
922,6885,7018,8515,8648,133,133,12684,0,12684,1.0,6953.5,8588.36,6950.15,8588.39,923
923,6385,6467,8519,8695,82,176,8640,0,8640,1.0,6430.68,8611.17,6427.61,8610.96,924
924,6563,6652,8521,8660,89,139,7058,1528,5530,0.7835080759421933,6612.03,8592.54,6608.68,8592.5,925
925,9247,9307,8524,8570,60,46,1855,0,1855,1.0,9280.83,8543.11,9277.31,8543.7,926
926,7296,7502,8528,8723,206,195,25499,0,25499,1.0,7400.46,8622.43,7397.28,8622.53,927
927,9148,9198,8535,8598,50,63,2299,0,2299,1.0,9172.53,8564.71,9169.08,8564.78,928
928,6543,6589,8540,8591,46,51,1553,0,1553,1.0,6569.25,8562.8,6565.55,8562.54,929
929,7006,7188,8542,8705,182,163,19240,0,19240,1.0,7093.0,8627.73,7089.86,8627.85,930
930,8403,8616,8545,8770,213,225,32772,0,32772,1.0,8512.25,8651.08,8509.24,8651.34,932
931,7483,7799,8546,8880,316,334,67188,0,67188,1.0,7649.15,8698.63,7645.99,8699.07,934
932,8578,8704,8546,8658,126,112,10343,0,10343,1.0,8643.08,8597.2,8640.08,8597.34,933
933,9178,9292,8546,8646,114,100,5439,8,5431,0.9985291413862842,9241.1,8587.36,9237.48,8587.74,931
934,9278,9352,8547,8622,74,75,3887,0,3887,1.0,9317.14,8583.2,9313.65,8583.44,935
935,8985,9089,8559,8700,104,141,8654,0,8654,1.0,9040.89,8621.44,9037.41,8622.01,936
936,8271,8452,8574,8808,181,234,28288,0,28288,1.0,8368.38,8698.2,8365.21,8698.01,937
937,6691,6748,8579,8625,57,46,1863,0,1863,1.0,6723.9,8598.92,6720.57,8599.29,938
938,8900,8954,8579,8647,54,68,2502,1283,1219,0.48721023181454837,8929.7,8608.18,8926.39,8608.65,939
939,2428,2817,8583,9018,389,435,90159,286,89873,0.99682782639559,2643.44,8791.12,2640.04,8791.22,940
940,6650,6712,8589,8661,62,72,3308,0,3308,1.0,6681.63,8623.78,6678.54,8624.28,941
941,9137,9207,8592,8668,70,76,3610,0,3610,1.0,9173.17,8630.29,9170.2,8630.82,942
942,9203,9262,8599,8643,59,44,2174,0,2174,1.0,9238.11,8621.97,9234.72,8622.69,943
943,9270,9372,8601,8717,102,116,6932,0,6932,1.0,9317.93,8656.14,9314.54,8656.22,945
944,6741,6797,8604,8687,56,83,2661,0,2661,1.0,6773.9,8639.05,6771.02,8639.87,946
945,3071,3192,8606,8705,121,99,6977,0,6977,1.0,3141.73,8659.28,3138.52,8659.48,944
946,6541,6587,8607,8648,46,41,1194,0,1194,1.0,6566.91,8630.22,6563.64,8630.2,947
947,9328,9392,8611,8698,64,87,2948,517,2431,0.8246268656716418,9369.61,8659.67,9366.02,8660.32,948
948,9063,9101,8613,8675,38,62,1390,0,1390,1.0,9082.6,8645.34,9079.6,8644.94,949
949,7166,7362,8615,8763,196,148,19574,0,19574,1.0,7270.63,8691.55,7267.44,8691.57,951
950,8573,8729,8615,8760,156,145,9477,1851,7626,0.8046850269072491,8657.76,8684.37,8654.42,8684.8,950
951,6708,6772,8619,8693,64,74,2902,0,2902,1.0,6740.96,8655.93,6737.96,8656.25,952
952,8666,8840,8621,8815,174,194,20036,488,19548,0.9756438410860451,8765.51,8716.54,8762.47,8716.78,954
953,9090,9147,8621,8682,57,61,2520,0,2520,1.0,9119.82,8649.28,9116.51,8649.33,953
954,6858,6914,8625,8685,56,60,1561,0,1561,1.0,6886.63,8652.71,6883.83,8652.89,955
955,6438,6552,8626,8768,114,142,10644,0,10644,1.0,6502.51,8689.52,6499.59,8690.02,956
956,8833,8929,8631,8730,96,99,6302,0,6302,1.0,8878.59,8677.86,8875.62,8677.83,957
957,6545,6644,8636,8870,99,234,16590,1427,15163,0.9139843279083786,6598.1,8744.16,6595.12,8744.56,958
958,6883,7023,8640,8750,140,110,8855,0,8855,1.0,6958.54,8686.09,6955.08,8686.7,961
959,6628,6673,8641,8691,45,50,1421,0,1421,1.0,6652.32,8665.17,6649.44,8665.3,960
960,9181,9269,8641,8700,88,59,3897,0,3897,1.0,9234.5,8668.58,9230.53,8668.86,959
961,8908,9027,8644,8783,119,139,7264,0,7264,1.0,8979.98,8718.28,8976.28,8718.43,962
962,6688,6728,8654,8701,40,47,1320,0,1320,1.0,6709.22,8677.48,6705.78,8677.64,963
963,6635,6744,8661,8820,109,159,10103,21,10082,0.997921409482332,6688.43,8748.68,6685.31,8748.61,964
964,9116,9222,8661,8755,106,94,5988,90,5898,0.9849699398797596,9169.48,8704.28,9166.31,8704.73,965
965,9053,9154,8670,8750,101,80,4103,57,4046,0.9861077260541068,9100.6,8708.73,9097.59,8709.06,968
966,8868,8949,8671,8760,81,89,3856,997,2859,0.741441908713693,8913.8,8718.55,8910.42,8718.58,967
967,4563,4619,8678,8750,56,72,2367,0,2367,1.0,4595.54,8715.02,4592.81,8715.92,966
968,6771,6807,8680,8712,36,32,766,0,766,1.0,6792.92,8695.27,6789.8,8695.18,971
969,6988,7089,8680,8820,101,140,9752,0,9752,1.0,7047.06,8746.6,7043.88,8746.45,969
970,7088,7235,8681,8862,147,181,18481,0,18481,1.0,7156.47,8767.73,7153.53,8768.04,970
971,7330,7599,8681,8961,269,280,49067,0,49067,1.0,7460.31,8820.33,7456.92,8820.78,972
972,8060,8180,8681,8850,120,169,15232,0,15232,1.0,8117.34,8770.94,8114.05,8770.73,973
973,6710,6797,8685,8761,87,76,4749,700,4049,0.8526005474836807,6752.17,8723.63,6749.28,8723.92,974
974,8158,8307,8691,8818,149,127,14747,183,14564,0.9875906964128297,8229.36,8753.26,8226.67,8753.89,975
975,7928,8080,8693,8912,152,219,24955,0,24955,1.0,8004.74,8803.25,8001.22,8803.56,976
976,9170,9332,8695,8800,162,105,9206,0,9206,1.0,9250.49,8742.9,9247.31,8743.15,977
977,9015,9076,8701,8765,61,64,2846,0,2846,1.0,9045.45,8731.2,9041.8,8731.68,978
978,3042,3777,8702,9382,735,680,312900,5136,307764,0.9835858101629914,3427.56,9028.04,3424.54,9028.14,979
979,8350,8703,8719,9147,353,428,77512,636,76876,0.9917948188667561,8537.63,8941.4,8534.19,8941.84,980
980,2933,3119,8721,8945,186,224,22433,0,22433,1.0,3039.52,8819.47,3036.0,8818.85,981
981,8810,8912,8723,8818,102,95,5218,0,5218,1.0,8859.7,8774.34,8856.56,8774.6,982
982,9053,9169,8734,8815,116,81,5838,0,5838,1.0,9108.78,8770.47,9106.13,8770.84,983
983,2728,3074,8736,9135,346,399,73339,0,73339,1.0,2895.4,8957.73,2891.91,8957.75,984
984,7795,7932,8739,8911,137,172,18856,0,18856,1.0,7870.35,8821.08,7867.29,8821.39,985
985,6945,7042,8741,8865,97,124,8110,0,8110,1.0,6990.66,8806.19,6987.57,8806.3,986
986,6813,6954,8746,8925,141,179,15510,1928,13582,0.8756931012250161,6885.15,8830.45,6881.74,8830.61,987
987,8946,9022,8751,8797,76,46,2450,0,2450,1.0,8987.0,8770.89,8984.02,8771.34,988
988,6731,6803,8756,8835,72,79,3263,145,3118,0.9555623659209317,6765.77,8794.75,6763.02,8794.72,990
989,7210,7359,8756,8913,149,157,17045,0,17045,1.0,7294.74,8828.28,7291.56,8828.26,991
990,8395,8522,8756,8843,127,87,6323,0,6323,1.0,8458.09,8793.84,8454.62,8794.13,993
991,10138,10718,8756,9820,580,1064,322165,101,322064,0.9996864960501606,10530.52,9383.23,10526.74,9383.0,989
992,9122,9242,8759,8853,120,94,6266,0,6266,1.0,9183.16,8814.05,9179.92,8814.39,992
993,6783,6825,8761,8803,42,42,1230,0,1230,1.0,6805.86,8778.34,6803.02,8778.93,994
994,8640,8774,8761,8903,134,142,9863,677,9186,0.9313596268883707,8700.19,8833.93,8697.53,8834.19,996
995,9001,9062,8761,8837,61,76,2755,0,2755,1.0,9033.54,8796.72,9030.75,8796.25,995
996,8891,8969,8772,8877,78,105,5779,0,5779,1.0,8928.84,8821.52,8925.77,8822.07,998
997,7711,7848,8776,8983,137,207,17987,0,17987,1.0,7774.9,8894.65,7772.19,8894.88,997
998,6617,6679,8779,8888,62,109,4025,0,4025,1.0,6652.06,8836.76,6648.91,8836.63,999
999,8773,8822,8779,8840,49,61,1618,0,1618,1.0,8798.84,8803.39,8795.87,8804.15,1000
1000,4913,5462,8784,9230,549,446,83170,0,83170,1.0,5170.29,9046.34,5167.22,9046.3,1001
1001,8965,9030,8786,8876,65,90,3406,0,3406,1.0,8996.27,8833.74,8993.13,8833.33,1002
1002,8260,8475,8791,8987,215,196,25108,0,25108,1.0,8350.09,8882.84,8347.14,8882.84,1003
1003,9030,9137,8796,8870,107,74,4978,134,4844,0.9730815588589795,9087.43,8832.13,9084.22,8832.36,1004
1004,8718,8748,8798,8858,30,60,1172,0,1172,1.0,8736.04,8829.11,8732.98,8829.26,1006
1005,8048,8335,8801,9145,287,344,58940,4541,54399,0.9229555480149304,8192.08,8972.07,8188.86,8972.22,1005
1006,6768,6837,8804,8857,69,53,2402,0,2402,1.0,6804.44,8830.62,6800.99,8830.72,1007
1007,6956,7153,8805,9055,197,250,28039,795,27244,0.9716466350440458,7056.91,8916.37,7053.83,8916.6,1008
1008,8743,8782,8806,8863,39,57,1626,644,982,0.6039360393603936,8763.45,8836.52,8760.25,8836.46,1009
1009,8778,8894,8806,8913,116,107,6788,0,6788,1.0,8836.88,8848.64,8833.82,8849.14,1010
1010,6674,6789,8812,8922,115,110,8272,2325,5947,0.718931334622824,6735.1,8864.61,6731.84,8864.88,1011
1011,6903,6968,8835,8903,65,68,3044,0,3044,1.0,6938.97,8869.28,6936.15,8869.59,1012
1012,7143,7329,8835,9011,186,176,19539,0,19539,1.0,7226.77,8922.92,7223.74,8923.08,1013
1013,8928,8983,8835,8926,55,91,2920,16,2904,0.9945205479452055,8962.93,8879.97,8959.54,8880.19,1014
1014,9023,9085,8839,8906,62,67,2222,0,2222,1.0,9054.16,8871.58,9051.23,8871.42,1015
1015,7613,7741,8846,9031,128,185,17105,0,17105,1.0,7672.71,8944.4,7669.57,8944.16,1017
1016,6783,6842,8847,8905,59,58,2413,275,2138,0.886033982594281,6815.18,8873.58,6811.63,8873.79,1016
1017,8830,8913,8855,8935,83,80,4301,0,4301,1.0,8870.04,8893.09,8867.0,8893.35,1018
1018,8768,8799,8856,8909,31,53,978,0,978,1.0,8787.2,8883.9,8783.85,8884.44,1019
1019,7750,8122,8866,9150,372,284,60086,2813,57273,0.9531837699297674,7932.61,9023.13,7929.6,9023.31,1020
1020,8978,9059,8867,8942,81,75,3913,346,3567,0.9115767952977255,9020.21,8904.23,9016.86,8903.86,1021
1021,8878,8953,8876,9000,75,124,6498,0,6498,1.0,8917.34,8938.59,8914.07,8938.88,1022
1022,7416,7618,8878,9240,202,362,38393,0,38393,1.0,7541.13,9079.55,7538.07,9079.18,1023
1023,10673,10718,8886,9110,45,224,7006,0,7006,1.0,10703.6,9008.58,10700.11,9007.99,1025
1024,8725,8789,8887,8941,64,54,2186,0,2186,1.0,8761.4,8912.02,8758.16,8912.63,1024
1025,8455,8499,8891,8930,44,39,1234,0,1234,1.0,8480.06,8910.08,8477.06,8910.13,1026
1026,8681,8737,8896,8951,56,55,1815,0,1815,1.0,8711.58,8924.98,8708.44,8925.09,1027
1027,6881,6975,8897,8975,94,78,4505,1180,3325,0.7380688124306326,6934.24,8936.46,6930.98,8936.38,1029
1028,6733,6935,8899,9028,202,129,13521,3032,10489,0.7757562310479994,6845.42,8960.78,6842.21,8960.83,1028
1029,3938,4843,8901,10004,905,1103,660922,3692,657230,0.9944138642684008,4428.76,9419.2,4425.51,9419.64,1030
1030,8766,8882,8905,9007,116,102,7583,0,7583,1.0,8823.19,8957.08,8819.9,8957.41,1032
1031,8013,8097,8906,8981,84,75,3462,0,3462,1.0,8055.66,8942.07,8052.64,8942.21,1031
1032,8918,9072,8916,9035,154,119,11829,4498,7331,0.6197480767605038,8993.7,8982.61,8990.79,8982.61,1033
1033,7365,7534,8918,9072,169,154,20242,0,20242,1.0,7456.19,8986.33,7452.61,8987.07,1034
1034,8716,8774,8931,8991,58,60,2266,0,2266,1.0,8745.99,8955.57,8742.62,8956.26,1035
1035,8663,8719,8940,8988,56,48,2072,0,2072,1.0,8694.27,8965.15,8690.77,8965.16,1036
1036,3068,3082,8941,8961,14,20,206,0,206,1.0,3039.52,8819.47,3074.89,8950.41,2004
1037,7216,7409,8945,9155,193,210,26042,712,25330,0.9726595499577605,7314.96,9056.24,7311.86,9056.39,1037
1038,7063,7234,8949,9105,171,156,18311,0,18311,1.0,7146.79,9028.43,7143.68,9028.63,1038
1039,8323,8409,8954,9035,86,81,4438,0,4438,1.0,8368.06,8994.59,8364.84,8994.55,1039
1040,6916,7117,8968,9187,201,219,20717,5432,15285,0.7377998744992036,7014.17,9077.67,7010.94,9077.78,1040
1041,8713,8793,8971,9050,80,79,3729,0,3729,1.0,8753.34,9010.41,8750.17,9010.83,1041
1042,8590,8633,8974,9006,43,32,968,0,968,1.0,8613.56,8987.3,8609.64,8987.89,1042
1043,8598,8678,8974,9041,80,67,3324,0,3324,1.0,8642.14,9009.58,8638.66,9009.02,1043
1044,7655,7867,8979,9198,212,219,20408,0,20408,1.0,7757.55,9097.2,7754.32,9097.15,1044
1045,8823,8892,8982,9060,69,78,3350,0,3350,1.0,8858.46,9015.37,8855.55,9015.46,1045
1046,8665,8723,8986,9042,58,56,2258,0,2258,1.0,8694.61,9010.36,8691.39,9010.83,1046
1047,8878,8924,8996,9040,46,44,1426,0,1426,1.0,8902.41,9017.22,8899.67,9017.06,1047
1048,8748,8854,9004,9120,106,116,7248,0,7248,1.0,8811.63,9062.85,8808.23,9062.77,1049
1049,7595,7678,9005,9135,83,130,6746,0,6746,1.0,7636.68,9075.24,7633.5,9075.74,1048
1050,6848,6887,9009,9050,39,41,961,0,961,1.0,6869.47,9025.05,6866.43,9025.44,1050
1051,4653,5198,9014,9770,545,756,254455,0,254455,1.0,4958.02,9414.89,4954.78,9414.67,1051
1052,8348,8417,9019,9075,69,56,2701,0,2701,1.0,8387.78,9042.57,8384.22,9042.64,1052
1053,2770,3562,9021,9820,792,799,241666,2162,239504,0.9910537684241888,3197.87,9409.49,3194.4,9409.55,1053
1054,6868,6972,9022,9161,104,139,7555,705,6850,0.9066843150231635,6923.47,9085.98,6920.18,9086.29,1054
1055,8660,8757,9029,9117,97,88,5745,2446,3299,0.5742384682332463,8708.26,9071.64,8705.06,9071.82,1055
1056,8308,8374,9031,9084,66,53,1945,0,1945,1.0,8343.49,9059.5,8339.99,9059.22,1057
1057,8600,8672,9031,9110,72,79,3730,0,3730,1.0,8638.5,9066.89,8635.4,9066.93,1056
1058,8250,8357,9064,9155,107,91,6021,0,6021,1.0,8303.93,9108.01,8300.84,9108.77,1058
1059,7333,7504,9070,9293,171,223,18427,0,18427,1.0,7418.35,9189.92,7415.33,9190.12,1059
1060,8120,8158,9074,9142,38,68,1899,926,973,0.5123749341758821,8143.26,9105.04,8140.22,9105.22,1060
1061,8730,8799,9076,9140,69,64,2816,0,2816,1.0,8765.92,9104.18,8762.83,9104.34,1061
1062,8551,8632,9079,9148,81,69,3236,0,3236,1.0,8597.14,9115.55,8594.02,9115.76,1063
1063,7086,7273,9080,9250,187,170,21270,0,21270,1.0,7180.39,9163.92,7177.27,9164.2,1062
1064,7588,7753,9096,9297,165,201,18719,0,18719,1.0,7666.42,9191.74,7663.59,9191.69,1064
1065,7990,8079,9099,9175,89,76,4784,0,4784,1.0,8040.76,9137.07,8037.33,9137.04,1065
1066,8418,8489,9099,9155,71,56,2861,0,2861,1.0,8458.84,9124.62,8455.02,9124.9,1067
1067,8608,8709,9100,9215,101,115,7969,0,7969,1.0,8660.52,9158.63,8657.1,9158.5,1068
1068,8075,8182,9101,9210,107,109,6677,30,6647,0.9955069642054815,8123.18,9159.91,8120.29,9160.0,1066
1069,8691,8735,9104,9170,44,66,1925,0,1925,1.0,8717.05,9133.87,8714.09,9134.18,1069
1070,3638,3778,9111,9261,140,150,9689,0,9689,1.0,3702.89,9186.04,3699.92,9186.29,1070
1071,7958,8009,9123,9185,51,62,2368,699,1669,0.7048141891891891,7985.5,9151.81,7982.46,9152.19,1071
1072,8146,8265,9124,9177,119,53,3824,0,3824,1.0,8202.19,9151.28,8199.23,9151.33,1072
1073,8518,8609,9125,9232,91,107,5331,322,5009,0.9395985743762896,8563.56,9174.91,8560.1,9175.01,1073
1074,8301,8369,9126,9161,68,35,1514,0,1514,1.0,8334.09,9141.99,8330.84,9142.39,1074
1075,8373,8447,9129,9200,74,71,3879,0,3879,1.0,8413.77,9165.42,8410.5,9165.76,1075
1076,8729,8779,9131,9200,50,69,2454,1015,1439,0.5863895680521597,8757.73,9167.06,8754.04,9166.57,1076
1077,6923,7014,9135,9292,91,157,8601,3055,5546,0.644808743169399,6970.34,9212.02,6967.44,9212.4,1078
1078,7846,7967,9136,9227,121,91,6826,0,6826,1.0,7905.32,9177.88,7902.45,9177.75,1077
1079,8435,8534,9136,9210,99,74,4756,0,4756,1.0,8488.44,9173.88,8484.86,9174.3,1079
1080,8296,8379,9146,9220,83,74,3653,0,3653,1.0,8346.36,9181.77,8343.1,9181.81,1082
1081,6998,7130,9149,9337,132,188,14888,922,13966,0.9380709296077377,7059.33,9235.63,7056.08,9236.01,1080
1082,7230,7357,9149,9269,127,120,10515,35,10480,0.9966714217784118,7296.79,9211.32,7293.7,9211.46,1083
1083,8231,8314,9150,9210,83,60,2946,0,2946,1.0,8276.03,9177.1,8272.98,9177.47,1081
1084,7988,8093,9166,9241,105,75,5412,0,5412,1.0,8045.03,9201.69,8041.57,9201.79,1084
1085,8566,8642,9167,9265,76,98,4359,0,4359,1.0,8607.14,9219.91,8604.25,9220.03,1085
1086,7805,7854,9169,9210,49,41,1499,402,1097,0.7318212141427618,7832.51,9189.33,7829.47,9189.1,1087
1087,8183,8238,9169,9221,55,52,2050,0,2050,1.0,8212.03,9192.57,8209.29,9192.52,1086
1088,5150,5592,9176,9567,442,391,97875,0,97875,1.0,5326.71,9355.24,5323.9,9355.61,1088
1089,7915,8002,9181,9240,87,59,3465,430,3035,0.8759018759018758,7957.58,9210.18,7954.75,9210.09,1089
1090,7732,7812,9189,9268,80,79,4720,0,4720,1.0,7772.72,9229.63,7769.43,9229.93,1090
1091,3435,4066,9190,10150,631,960,390853,825,390028,0.9978892320130586,3759.54,9616.34,3756.27,9616.52,1091
1092,8248,8342,9194,9262,94,68,4245,0,4245,1.0,8295.95,9228.07,8292.96,9228.42,1092
1093,8335,8472,9195,9347,137,152,12217,0,12217,1.0,8401.38,9258.19,8398.5,9258.4,1093
1094,7802,7869,9196,9250,67,54,1875,0,1875,1.0,7841.21,9226.79,7837.58,9225.94,1095
1095,8083,8148,9196,9252,65,56,2615,0,2615,1.0,8119.45,9223.5,8116.27,9223.4,1096
1096,8466,8573,9196,9308,107,112,7982,0,7982,1.0,8518.17,9250.54,8515.34,9250.91,1094
1097,8143,8208,9197,9243,65,46,2066,0,2066,1.0,8174.84,9220.99,8171.92,9221.09,1097
1098,8618,8707,9200,9300,89,100,5460,0,5460,1.0,8667.64,9249.85,8664.56,9249.92,1098
1099,8193,8262,9204,9262,69,58,2270,0,2270,1.0,8232.24,9232.43,8228.63,9232.44,1099
1100,2753,3200,9216,9915,447,699,143485,1463,142022,0.9898038122451824,2984.77,9585.4,2981.36,9585.1,1100
1101,7463,7622,9216,9380,159,164,15635,0,15635,1.0,7548.85,9292.26,7545.72,9292.2,1101
1102,7903,8018,9219,9305,115,86,4898,566,4332,0.884442629644753,7957.98,9259.88,7955.05,9259.9,1103
1103,7868,7923,9221,9270,55,49,1993,0,1993,1.0,7898.46,9241.74,7895.34,9241.57,1102
1104,7170,7265,9226,9307,95,81,5112,0,5112,1.0,7218.64,9269.0,7215.6,9269.19,1105
1105,7315,7414,9226,9303,99,77,5014,0,5014,1.0,7368.62,9265.13,7365.39,9265.29,1106
1106,7798,7913,9226,9321,115,95,4759,377,4382,0.9207816768228619,7863.03,9275.68,7859.21,9275.37,1104
1107,8440,8482,9229,9305,42,76,2450,0,2450,1.0,8463.69,9269.14,8460.22,9269.37,1107
1108,7693,7740,9231,9288,47,57,1790,77,1713,0.9569832402234637,7718.73,9255.64,7715.55,9255.91,1108
1109,8011,8107,9231,9315,96,84,6063,1523,4540,0.7488042223321788,8063.07,9269.83,8059.82,9270.04,1109
1110,8120,8222,9239,9318,102,79,5518,652,4866,0.881841246828561,8172.92,9277.62,8169.72,9277.96,1110
1111,7061,7182,9241,9371,121,130,8539,59,8480,0.9930905258226959,7128.86,9302.58,7125.53,9303.03,1111
1112,8276,8362,9246,9328,86,82,4419,0,4419,1.0,8317.18,9286.17,8314.25,9286.17,1112
1113,8100,8137,9249,9308,37,59,1315,0,1315,1.0,8118.87,9274.67,8115.5,9274.62,1114
1114,8199,8284,9250,9350,85,100,5758,607,5151,0.8945814518930184,8248.24,9300.16,8245.13,9300.05,1115
1115,8531,8657,9250,9388,126,138,10989,0,10989,1.0,8594.51,9321.07,8591.34,9321.27,1113
1116,7965,8019,9256,9322,54,66,2482,102,2380,0.958904109589041,7995.18,9284.81,7992.08,9285.38,1116
1117,7590,7781,9259,9365,191,106,12595,359,12236,0.9714966256450973,7675.22,9323.4,7672.1,9323.49,1117
1118,7730,7867,9260,9348,137,88,7043,1480,5563,0.7898622745988925,7806.1,9301.15,7802.88,9301.52,1118
1119,7674,7725,9266,9310,51,44,1332,0,1332,1.0,7700.49,9289.99,7697.31,9289.84,1119
1120,7246,7342,9269,9355,96,86,4844,34,4810,0.9929810074318745,7296.82,9305.2,7293.56,9305.55,1120
1121,6961,7027,9275,9348,66,73,2997,877,2120,0.7073740407073741,7005.28,9306.4,7001.24,9306.94,1121
1122,7305,7562,9284,9458,257,174,24313,0,24313,1.0,7433.38,9363.39,7430.06,9363.75,1122
1123,7947,7998,9294,9355,51,61,2049,0,2049,1.0,7974.12,9324.51,7970.97,9324.84,1123
1124,7178,7252,9299,9355,74,56,3194,0,3194,1.0,7215.28,9323.82,7212.54,9324.1,1124
1125,7896,7952,9300,9368,56,68,2703,571,2132,0.7887532371439142,7926.62,9330.94,7923.63,9331.16,1126
1126,7973,8137,9300,9478,164,178,21509,1697,19812,0.9211027941791808,8058.01,9396.53,8054.87,9396.53,1127
1127,8078,8148,9301,9350,70,49,2073,0,2073,1.0,8117.8,9322.71,8114.1,9322.71,1128
1128,8288,8417,9301,9460,129,159,12998,396,12602,0.9695337744268349,8360.4,9386.3,8357.12,9386.12,1129
1129,8406,8549,9301,9440,143,139,15706,0,15706,1.0,8480.32,9369.39,8477.25,9369.46,1125
1130,8123,8255,9308,9458,132,150,13983,0,13983,1.0,8187.86,9385.92,8184.79,9385.93,1130
1131,7851,7902,9317,9372,51,55,1805,357,1448,0.8022160664819945,7882.6,9343.12,7879.01,9342.94,1131
1132,7196,7307,9324,9413,111,89,6355,0,6355,1.0,7259.49,9370.78,7256.44,9371.03,1132
1133,7098,7202,9329,9404,104,75,5561,2,5559,0.9996403524545945,7151.12,9366.21,7148.28,9366.47,1134
1134,7776,7883,9329,9400,107,71,3594,1704,1890,0.5258764607679466,7835.91,9364.55,7832.33,9364.39,1135
1135,8243,8332,9329,9413,89,84,5343,2257,3086,0.5775781396219353,8286.78,9369.97,8283.66,9369.94,1133
1136,7021,7089,9331,9405,68,74,2450,1428,1022,0.41714285714285715,7060.64,9362.95,7057.51,9363.19,1136
1137,7934,7992,9341,9395,58,54,2058,0,2058,1.0,7966.68,9368.61,7963.26,9368.75,1137
1138,7883,7942,9357,9390,59,33,1267,0,1267,1.0,7914.56,9376.1,7910.26,9375.99,1138
1139,7550,7617,9360,9412,67,52,1592,0,1592,1.0,7585.14,9382.68,7581.79,9382.78,1139
1140,7075,7192,9371,9590,117,219,14947,5951,8996,0.6018599049976584,7131.43,9482.53,7128.02,9482.36,1140
1141,7280,7422,9377,9520,142,143,12446,0,12446,1.0,7349.06,9439.53,7345.77,9439.67,1141
1142,7148,7287,9380,9504,139,124,10850,0,10850,1.0,7218.21,9446.4,7214.61,9446.76,1143
1143,7571,7617,9380,9428,46,48,1245,0,1245,1.0,7598.3,9405.92,7594.88,9406.09,1142
1144,7003,7082,9382,9460,79,78,4123,0,4123,1.0,7048.37,9423.58,7044.85,9423.47,1144
1145,7868,7952,9382,9430,84,48,2655,1636,1019,0.383804143126177,7915.69,9406.64,7912.26,9405.95,1145
1146,7943,7987,9391,9435,44,44,1371,0,1371,1.0,7968.86,9410.54,7965.43,9411.36,1146
1147,8251,8308,9404,9460,57,56,2143,0,2143,1.0,8280.67,9426.84,8277.08,9427.83,1147
1148,4758,5702,9426,10485,944,1059,485102,0,485102,1.0,5236.7,9930.3,5233.48,9930.59,1148
1149,8173,8262,9430,9475,89,45,2199,0,2199,1.0,8225.7,9454.76,8222.91,9454.79,1149
1150,8218,8309,9456,9540,91,84,5387,20,5367,0.9962873584555412,8264.12,9494.38,8261.52,9494.19,1150
1151,7168,7312,9464,9623,144,159,13798,1356,12442,0.901724887664879,7246.5,9546.54,7243.31,9546.8,1151
1152,10225,10294,9475,9592,69,117,4788,0,4788,1.0,10262.96,9541.73,10259.47,9541.39,1152
1153,3870,5128,9604,10979,1258,1375,959396,0,959396,1.0,4417.58,10343.5,4414.55,10343.45,1153
1154,9248,9887,9649,10668,639,1019,294549,1864,292685,0.9936716811124804,9550.54,10173.94,9547.18,10173.24,1154
1155,3158,3744,9676,10402,586,726,232796,0,232796,1.0,3405.56,10044.81,3402.85,10045.52,1155
1156,10221,10718,9729,10185,497,456,155379,653,154726,0.9957973728753564,10494.56,9944.84,10490.8,9945.02,1156
1157,5596,6094,9766,10175,498,409,122466,0,122466,1.0,5889.84,9970.33,5886.27,9970.49,1157
1158,9593,10718,9851,10907,1125,1056,650792,0,650792,1.0,10193.76,10359.43,10190.06,10359.56,1158
1159,9900,10027,9889,10010,127,121,7014,0,7014,1.0,9951.46,9949.38,9948.94,9948.9,1159
1160,3478,3997,9959,11120,519,1161,305723,2269,303454,0.9925782489377639,3763.68,10566.91,3760.48,10566.76,1160
1161,5265,5862,10011,10540,597,529,222176,0,222176,1.0,5578.78,10291.6,5575.57,10291.74,1161
1162,5830,6512,10076,10588,682,512,188788,5029,183759,0.973361654342437,6161.67,10315.29,6158.4,10315.54,1162
1163,3094,3644,10136,11033,550,897,238386,6591,231795,0.9723515642697138,3398.39,10520.46,3395.06,10521.44,1163
1164,6183,7068,10229,11050,885,821,395749,0,395749,1.0,6596.7,10594.15,6593.43,10594.47,1164
1165,3173,3187,10256,10270,14,14,127,0,127,1.0,3405.56,10044.81,3179.09,10262.87,2005
1166,6678,7379,10266,11038,701,772,218314,0,218314,1.0,6999.26,10692.26,6996.49,10691.9,1165
1167,5578,6232,10374,11080,654,706,309443,0,309443,1.0,5948.19,10712.23,5945.08,10712.35,1166
1168,4978,5672,10376,10865,694,489,179385,0,179385,1.0,5328.17,10629.55,5325.02,10629.38,1167
1169,10031,10661,10581,11300,630,719,240874,38,240836,0.9998422411717329,10403.16,10911.22,10399.83,10911.34,1168
1170,9421,10302,10609,11557,881,948,440967,0,440967,1.0,9884.3,11098.72,9881.0,11098.59,1169
1171,4390,5337,10614,11275,947,661,382322,0,382322,1.0,4895.96,10950.62,4892.48,10950.5,1170
1172,10565,10718,10618,10860,153,242,26177,0,26177,1.0,10662.58,10736.41,10658.98,10736.65,1171
1173,3798,4194,10656,11130,396,474,88103,0,88103,1.0,3984.8,10911.12,3981.83,10911.19,1172
1174,4468,5973,10741,12140,1505,1399,1116867,0,1116867,1.0,5284.54,11436.32,5280.74,11436.65,1173
1175,6568,7272,10834,11531,704,697,288683,0,288683,1.0,6909.32,11205.94,6905.93,11205.68,1174
1176,10383,10718,10854,11566,335,712,114811,2459,112352,0.97858219160185,10616.38,11258.12,10612.62,11257.76,1175
1177,3993,4632,10881,11545,639,664,250116,0,250116,1.0,4294.33,11235.89,4291.27,11235.95,1176
1178,5923,7169,10894,12135,1246,1241,753320,0,753320,1.0,6575.26,11546.54,6571.92,11546.2,1177
1179,8548,8872,10989,11143,324,154,33157,0,33157,1.0,8724.93,11066.8,8721.39,11066.99,1178
1180,3685,4102,11006,11371,417,365,69889,0,69889,1.0,3911.34,11163.24,3908.17,11163.75,1179
1181,8838,9382,11046,11670,544,624,196189,0,196189,1.0,9121.87,11407.97,9118.1,11408.08,1180
1182,5908,6045,11056,11236,137,180,12463,0,12463,1.0,5972.37,11133.16,5969.44,11132.94,1181
1183,8391,10195,11094,13335,1804,2241,1968442,5106,1963336,0.9974060703845986,9248.57,12299.57,9245.21,12299.45,1182
1184,7560,8527,11171,13370,967,2199,1221527,25797,1195730,0.978881350964817,8028.46,12264.63,8025.26,12265.18,1183
1185,3653,4032,11219,11708,379,489,116133,2789,113344,0.97598443164303,3852.72,11443.42,3849.62,11443.54,1184
1186,6923,7837,11221,13006,914,1785,744236,0,744236,1.0,7335.64,12134.05,7332.76,12134.93,1185
1187,8155,8582,11241,11875,427,634,136142,2452,133690,0.9819893934274507,8352.01,11517.18,8348.93,11517.52,1186
1188,9948,10602,11241,11916,654,675,185437,1816,183621,0.99020691663476,10249.56,11572.85,10246.61,11572.39,1187
1189,9329,9985,11346,12020,656,674,256551,0,256551,1.0,9659.32,11647.19,9656.02,11647.49,1188
1190,3993,4092,11380,11511,99,131,7445,0,7445,1.0,4041.14,11455.98,4038.02,11456.22,1189
1191,5558,6359,11407,12207,801,800,365374,0,365374,1.0,6010.15,11821.52,6006.78,11821.92,1190
1192,10290,10637,11496,12180,347,684,176249,3039,173210,0.9827573489778666,10469.2,11844.78,10465.93,11845.07,1191
1193,3594,3927,11526,12045,333,519,92158,393,91765,0.9957355845395951,3752.88,11790.35,3749.96,11790.37,1192
1194,10301,10718,11536,12440,417,904,160852,3630,157222,0.9774326710267823,10590.71,12110.15,10587.34,12109.36,1193
1195,7555,7629,11696,11813,74,117,3508,0,3508,1.0,7596.86,11764.82,7593.72,11764.64,1194
1196,9658,10329,11739,12390,671,651,292875,0,292875,1.0,10005.54,12080.94,10002.53,12080.98,1195
1197,7333,7932,11798,12495,599,697,261661,0,261661,1.0,7654.72,12119.35,7651.68,12119.86,1196
1198,4903,5677,11816,12290,774,474,210985,3421,207564,0.9837855771737327,5286.89,12036.53,5283.64,12036.66,1197
1199,6216,7034,11876,12785,818,909,395617,6399,389218,0.983825265345018,6628.14,12295.28,6625.01,12295.25,1198
1200,5760,6422,12074,12730,662,656,215596,65,215531,0.9996985101764411,6125.93,12382.7,6122.5,12382.56,1199
1201,5293,5887,12086,12487,594,401,120083,0,120083,1.0,5618.46,12277.75,5614.98,12277.87,1200
1202,8368,8754,12094,12718,386,624,162384,0,162384,1.0,8575.73,12455.18,8572.55,12454.7,1201
1203,10528,10539,12104,12115,11,11,99,0,99,1.0,10590.71,12110.15,10533.6,12108.29,2006
1204,9999,10432,12220,12770,433,550,120563,1282,119281,0.9893665552449756,10248.0,12484.25,10244.58,12484.58,1202
1205,5713,6750,12328,13160,1037,832,371068,11886,359182,0.9679681352204986,6235.56,12733.49,6232.0,12733.63,1203
1206,10378,10718,12381,12830,340,449,108512,5,108507,0.9999539221468593,10573.71,12583.38,10570.06,12583.39,1204
1207,8203,8975,12576,13415,772,839,379815,4081,375734,0.989255295341153,8622.25,12953.98,8618.86,12953.89,1205
1208,6618,7173,12601,13027,555,426,136301,7042,129259,0.9483349351802262,6945.16,12841.75,6941.82,12841.6,1206
1209,9958,10629,12641,13263,671,622,221289,2240,219049,0.9898774905214448,10278.97,12950.8,10276.05,12950.92,1207
1210,7290,7767,12721,13233,477,512,120226,2118,118108,0.9823831783474456,7521.26,12974.95,7518.41,12975.17,1208
1211,10568,10718,12791,13078,150,287,27675,0,27675,1.0,10661.61,12925.07,10657.73,12924.88,1209
1212,6218,6484,12876,13163,266,287,46323,0,46323,1.0,6362.46,13039.69,6359.03,13039.99,1210
1213,6413,6739,12911,13260,326,349,70568,313,70255,0.9955645618410611,6578.03,13074.49,6574.61,13074.48,1211
1214,8803,9217,12926,13373,414,447,87174,0,87174,1.0,9024.32,13136.12,9021.22,13136.32,1212
1215,6596,6982,12986,13293,386,307,71465,0,71465,1.0,6804.99,13151.21,6801.59,13151.16,1213
1216,10358,10469,13081,13215,111,134,10105,0,10105,1.0,10419.69,13144.89,10416.16,13144.38,1214
1217,9338,9739,13106,13520,401,414,112877,0,112877,1.0,9546.26,13338.35,9542.98,13338.44,1215
