ndimage_cellID,x0,x1,y0,y1,length,height,total_area,nuclei_area,cyto_area,c2t_area_ratio,orig_comX,orig_comY,ndimage_comX,ndimage_comY,orig_cellID
1,0,10723,0,15008,10723,15008,73974145,299169,73674976,0.9959557626519374,3497.39,7809.51,3500.94,7806.77,1
2,8361,8710,566,970,349,404,88895,0,88895,1.0,8538.53,763.14,8538.38,763.2,2
3,8423,10260,746,2195,1837,1449,1300751,4809,1295942,0.9963029050141033,9386.26,1371.12,9386.01,1371.22,3
4,6831,7097,821,1195,266,374,52947,234,52713,0.9955804861465238,6978.26,979.0,6978.15,979.75,4
5,7729,8517,851,2358,788,1507,654845,689,654156,0.9989478426192457,8162.58,1460.2,8162.4,1460.85,5
6,7273,7617,930,1533,344,603,136431,0,136431,1.0,7420.0,1222.8,7420.0,1222.72,6
7,5833,6137,986,1508,304,522,90543,0,90543,1.0,5960.66,1260.38,5960.59,1260.22,7
8,6866,7706,996,1960,840,964,389361,0,389361,1.0,7243.51,1529.4,7243.22,1529.0,8
9,7531,7922,1209,1791,391,582,143692,0,143692,1.0,7717.42,1462.93,7717.37,1463.46,9
10,6103,6500,1281,1955,397,674,121127,0,121127,1.0,6288.04,1651.49,6287.42,1650.88,10
11,8482,8573,1286,1455,91,169,10045,0,10045,1.0,8530.06,1376.85,8530.11,1376.66,11
12,8173,9730,1401,3583,1557,2182,1566524,8111,1558413,0.9948222944557504,8965.79,2415.03,8965.57,2415.58,12
13,7428,7555,1407,1565,127,158,8643,0,8643,1.0,7506.38,1478.21,7506.12,1478.93,13
14,5741,6175,1431,1766,434,335,100261,755,99506,0.9924696542025314,5943.55,1596.08,5943.6,1596.33,14
15,5411,5796,1474,1915,385,441,85228,907,84321,0.9893579574787629,5629.66,1673.18,5629.72,1673.56,15
16,6173,6275,1546,1628,102,82,4730,0,4730,1.0,6225.46,1582.89,6225.36,1582.97,16
17,7536,8085,1651,2405,549,754,258703,0,258703,1.0,7840.57,2033.76,7840.38,2033.9,17
18,5451,6270,1680,2490,819,810,393053,321,392732,0.999183316244883,5889.34,2075.39,5889.18,2075.58,18
19,9311,10205,1759,3220,894,1461,581878,0,581878,1.0,9763.24,2412.55,9763.3,2412.53,19
20,6158,6725,1834,2705,567,871,254877,4030,250847,0.9841884516845381,6450.2,2297.29,6449.83,2296.99,20
21,6986,7570,1856,2922,584,1066,356430,0,356430,1.0,7300.71,2332.3,7300.46,2333.01,21
22,8364,8520,1885,2005,156,120,7403,415,6988,0.943941645278941,8446.85,1948.6,8446.63,1948.78,22
23,6201,6385,1929,2088,184,159,18958,0,18958,1.0,6282.18,2003.26,6282.2,2003.57,23
24,9208,9547,1972,2351,339,379,72853,4871,67982,0.9331393353739722,9372.1,2158.63,9371.78,2158.59,24
25,10066,10505,1974,2525,439,551,164311,0,164311,1.0,10292.5,2262.8,10292.26,2262.88,25
26,7376,7987,2081,3142,611,1061,318059,3990,314069,0.9874551576908687,7667.96,2615.18,7667.51,2615.56,26
27,10429,10721,2199,2796,292,597,102846,0,102846,1.0,10608.58,2430.66,10608.07,2431.16,28
28,7950,8402,2239,2623,452,384,97391,0,97391,1.0,8178.41,2429.56,8178.2,2429.79,29
29,5748,6375,2244,3235,627,991,371001,72,370929,0.999805930442236,6075.79,2715.27,6075.7,2716.04,30
30,4981,5235,2274,2520,254,246,41437,402,41035,0.9902985254724039,5107.32,2414.19,5107.18,2414.39,31
31,6516,7015,2279,2860,499,581,162446,0,162446,1.0,6799.78,2578.93,6799.32,2578.95,32
32,8318,8852,2353,2880,534,527,193612,0,193612,1.0,8574.54,2600.4,8574.55,2600.82,33
33,7921,7995,2371,2460,74,89,3257,0,3257,1.0,7962.13,2412.17,7962.12,2412.5,34
34,4876,4957,2382,2453,81,71,3443,547,2896,0.8411269241940168,4911.76,2421.26,4911.52,2421.54,35
35,9781,10245,2386,2976,464,590,181629,230,181399,0.9987336823965336,9999.53,2641.25,9999.5,2641.53,36
36,5408,5862,2409,3063,454,654,175911,0,175911,1.0,5618.98,2721.09,5618.9,2721.05,37
37,5168,5505,2471,2993,337,522,89725,0,89725,1.0,5365.87,2690.52,5365.59,2690.98,38
38,9923,10721,2486,3619,798,1133,510335,0,510335,1.0,10296.33,3026.76,10296.15,3027.15,39
39,4901,5190,2491,2628,289,137,22036,0,22036,1.0,5047.66,2559.82,5047.37,2560.03,40
40,7689,8415,2536,3630,726,1094,431280,949,430331,0.9977995733630124,8039.64,3015.25,8039.45,3015.86,41
41,6841,7412,2594,3350,571,756,287993,0,287993,1.0,7156.8,2944.49,7156.68,2944.64,42
42,6216,7330,2606,4000,1114,1394,818597,4178,814419,0.994896145478178,6728.27,3334.25,6727.82,3334.26,43
43,7761,7870,2746,2823,109,77,5599,0,5599,1.0,7818.75,2783.81,7818.64,2784.11,44
44,3779,4305,2789,3185,526,396,127231,355,126876,0.9972097994985499,4057.73,2981.15,4057.39,2981.21,46
45,10683,10721,2789,2949,38,160,4820,0,4820,1.0,10704.74,2866.36,10704.31,2865.77,45
46,8191,8726,2806,3295,535,489,178481,0,178481,1.0,8476.28,3065.69,8476.31,3065.85,47
47,5436,6072,2916,3535,636,619,262437,0,262437,1.0,5768.33,3209.42,5768.12,3209.75,48
48,3486,3911,2991,3555,425,564,121210,5264,115946,0.9565712399966999,3735.7,3219.74,3735.51,3220.44,49
49,7261,7895,3016,3780,634,764,315033,174,314859,0.999447676910038,7564.14,3417.95,7564.03,3418.05,50
50,10381,10721,3019,3581,340,562,153424,0,153424,1.0,10565.41,3301.77,10564.77,3301.94,51
51,3456,5320,3091,4760,1864,1669,1530751,332,1530419,0.9997831129948633,4394.7,3901.8,4394.59,3901.77,52
52,9388,10157,3096,3830,769,734,307120,0,307120,1.0,9764.4,3462.3,9764.3,3462.44,53
53,5826,6522,3131,3930,696,799,298847,0,298847,1.0,6163.78,3534.97,6163.57,3535.2,54
54,9466,9535,3174,3270,69,96,3596,0,3596,1.0,9495.15,3213.09,9495.07,3213.08,55
55,8031,8600,3186,3770,569,584,195999,0,195999,1.0,8325.3,3495.26,8325.0,3495.35,56
56,4294,10721,3196,11435,6427,8239,20092308,268185,19824123,0.986652354722016,7883.6,7422.69,7882.4,7422.35,57
57,9881,9955,3240,3368,74,128,6051,0,6051,1.0,9923.91,3308.96,9923.72,3309.3,58
58,6326,6425,3271,3380,99,109,5575,33,5542,0.9940807174887892,6369.41,3329.9,6369.38,3329.85,59
59,3203,3805,3326,3743,602,417,112835,5740,107095,0.9491292595382639,3518.56,3542.18,3518.08,3542.32,60
60,5189,5892,3351,3870,703,519,230128,0,230128,1.0,5519.55,3621.18,5519.29,3621.4,61
61,10118,10525,3369,4118,407,749,132502,0,132502,1.0,10332.59,3759.3,10332.11,3760.0,62
62,4631,4870,3429,3793,239,364,42516,0,42516,1.0,4756.07,3598.3,4755.79,3598.6,63
63,4631,4705,3466,3508,74,42,1829,0,1829,1.0,4667.24,3483.26,4667.45,3483.14,64
64,9146,9593,3477,4070,447,593,165833,0,165833,1.0,9353.16,3773.54,9353.02,3773.75,65
65,10168,10721,3529,4405,553,876,237309,4077,233232,0.9828198677673413,10516.26,3982.18,10515.71,3982.62,66
66,7546,8265,3539,3979,719,440,151987,919,151068,0.9939534302275852,7901.73,3763.52,7901.89,3763.61,67
67,10686,10721,3574,3655,35,81,2113,0,2113,1.0,10706.86,3610.49,10706.35,3610.22,68
68,10103,10250,3593,3758,147,165,13885,0,13885,1.0,10185.33,3665.52,10184.89,3665.92,69
69,8449,8535,3645,3745,86,100,4864,0,4864,1.0,8495.46,3700.32,8495.32,3700.07,70
70,9404,10275,3646,4155,871,509,222012,0,222012,1.0,9788.48,3904.54,9788.92,3904.81,71
71,3001,3926,3716,4970,925,1254,604659,5594,599065,0.990748504528999,3379.84,4269.45,3379.86,4270.27,72
72,5073,6395,3746,4710,1322,964,765706,955,764751,0.9987527850114796,5637.94,4259.31,5638.73,4259.63,73
73,6313,6423,3751,3850,110,99,5970,0,5970,1.0,6371.65,3804.76,6371.72,3804.69,74
74,5796,6500,3791,4160,704,369,102084,0,102084,1.0,6229.61,3945.46,6228.21,3946.38,75
75,9871,10420,3966,4550,549,584,170405,0,170405,1.0,10129.35,4251.58,10129.09,4251.62,76
76,9156,9660,3979,4490,504,511,134019,0,134019,1.0,9404.77,4220.89,9404.32,4221.1,77
77,9501,10225,4064,4678,724,614,204923,0,204923,1.0,9838.15,4392.03,9838.08,4392.08,78
78,10353,10721,4082,4696,368,614,122521,0,122521,1.0,10590.44,4433.77,10589.63,4434.03,79
79,4621,5120,4121,4900,499,779,160258,174,160084,0.9989142507706323,4868.92,4493.27,4868.82,4493.65,80
80,3446,4245,4130,4853,799,723,321983,3663,318320,0.9886236229863067,3826.52,4536.21,3826.33,4536.42,81
81,2601,2871,4316,4674,270,358,50495,456,50039,0.9909694029111793,2742.53,4492.4,2742.1,4491.86,82
82,9271,9560,4341,4740,289,399,50541,0,50541,1.0,9423.82,4562.88,9423.39,4563.09,83
83,4986,5085,4404,4475,99,71,4186,1034,3152,0.7529861442904922,5031.75,4435.69,5031.75,4435.78,84
84,5806,5927,4416,4650,121,234,11300,0,11300,1.0,5866.03,4522.26,5865.43,4522.87,85
85,4756,5242,4426,5103,486,677,165167,7536,157631,0.9543734523240115,5024.62,4768.69,5024.55,4768.86,86
86,9449,10087,4501,4890,638,389,142739,0,142739,1.0,9742.95,4679.68,9742.88,4680.01,87
87,10076,10672,4511,4853,596,342,97700,0,97700,1.0,10326.71,4667.47,10326.81,4667.75,88
88,2631,3127,4539,5075,496,536,167683,1219,166464,0.9927303304449467,2882.22,4822.59,2882.13,4822.99,89
89,5461,5825,4615,4872,364,257,50524,0,50524,1.0,5658.0,4756.18,5657.92,4756.02,90
90,4299,4942,4636,5328,643,692,254573,0,254573,1.0,4615.68,4991.99,4615.56,4992.36,91
91,10659,10721,4659,4780,62,121,4964,0,4964,1.0,10698.04,4717.34,10697.67,4717.69,92
92,3748,4526,4706,5563,778,857,373306,0,373306,1.0,4125.23,5150.31,4124.87,5150.2,94
93,9901,10312,4706,5258,411,552,79881,957,78924,0.9880196792729184,10141.67,4995.69,10141.49,4995.56,93
94,3344,3997,4716,5237,653,521,197318,270,197048,0.9986316504322971,3672.53,4972.88,3672.43,4972.59,95
95,5781,5805,4716,4747,24,31,439,0,439,1.0,0.0,0.0,5791.9,4731.39,0
96,10246,10721,4729,5290,475,561,173506,664,172842,0.9961730430071583,10503.91,4958.08,10503.38,4958.45,97
97,5721,5937,4746,5220,216,474,52703,0,52703,1.0,5827.71,4976.42,5827.92,4978.74,96
98,9691,10230,4759,4989,539,230,68002,0,68002,1.0,9986.84,4867.96,9986.48,4867.97,98
99,2991,3467,4809,5428,476,619,175652,0,175652,1.0,3209.22,5106.77,3209.45,5106.86,99
100,2336,2705,4826,5250,369,424,87943,0,87943,1.0,2502.66,5056.4,2502.69,5056.13,100
101,8471,8597,4849,4963,126,114,7459,1731,5728,0.7679313580908969,8537.5,4902.58,8536.8,4902.7,101
102,8336,8432,4863,4973,96,110,7403,438,6965,0.9408347967040389,8383.74,4918.19,8383.55,4918.38,102
103,8428,8472,4864,4898,44,34,1179,608,571,0.48430873621713316,8447.96,4880.35,8447.49,4880.7,103
104,8421,8527,4885,4955,106,70,4263,2884,1379,0.32348111658456485,8467.54,4921.47,8467.09,4921.58,104
105,8261,8350,4894,4975,89,81,4520,0,4520,1.0,8306.63,4932.55,8306.42,4932.3,105
106,8184,8293,4926,5041,109,115,5657,396,5261,0.9299982322785929,8240.61,4980.81,8239.93,4981.38,107
107,8553,8665,4926,5061,112,135,6863,0,6863,1.0,8608.79,4997.57,8608.2,4997.16,106
108,8426,8535,4934,5065,109,131,7647,0,7647,1.0,8487.81,4989.15,8487.84,4989.3,108
109,8346,8495,4951,5091,149,140,11180,66,11114,0.9940966010733453,8426.97,5028.72,8426.58,5028.71,109
110,8523,8576,4955,5025,53,70,2291,0,2291,1.0,8544.69,4989.5,8544.13,4989.82,110
111,8219,8402,4964,5080,183,116,13169,0,13169,1.0,8310.85,5027.25,8310.73,5027.28,111
112,4558,5847,4986,5930,1289,944,553717,658,553059,0.9988116673318681,5179.38,5461.7,5178.75,5462.2,112
113,8506,8591,5000,5090,85,90,3837,0,3837,1.0,8552.25,5046.57,8552.38,5046.31,113
114,2391,3125,5009,5488,734,479,193441,0,193441,1.0,2778.52,5254.93,2778.19,5255.2,114
115,8136,8186,5014,5065,50,51,1647,540,1107,0.6721311475409836,8158.97,5038.28,8158.61,5038.59,115
116,8629,8705,5024,5120,76,96,5373,0,5373,1.0,8669.08,5069.38,8668.89,5068.99,116
117,8071,8202,5035,5178,131,143,11874,1107,10767,0.9067710965133906,8136.06,5110.64,8136.26,5110.63,117
118,8171,8350,5039,5250,179,211,18606,100,18506,0.9946253896592497,8255.25,5132.66,8254.8,5132.86,118
119,8473,8700,5045,5216,227,171,18480,0,18480,1.0,8599.65,5124.72,8599.53,5124.58,119
120,10098,10427,5063,5360,329,297,55947,816,55131,0.9854147675478578,10278.02,5200.0,10277.7,5200.11,121
121,8346,8416,5064,5131,70,67,3231,0,3231,1.0,8378.34,5095.07,8377.99,5095.31,120
122,10258,10721,5071,5505,463,434,99338,315,99023,0.9968290080331796,10561.4,5313.5,10560.21,5313.66,122
123,7894,8016,5076,5144,122,68,4061,3027,1034,0.2546170893868505,7952.52,5109.55,7952.03,5110.02,123
124,7548,7705,5081,5230,157,149,16114,2411,13703,0.8503785528112201,7627.96,5156.24,7627.6,5156.38,124
125,7961,8072,5081,5150,111,69,4479,3047,1432,0.31971422192453675,8017.33,5119.92,8017.05,5120.09,125
126,8389,8510,5091,5205,121,114,9579,51,9528,0.9946758534293768,8449.57,5143.01,8449.03,5143.13,126
127,7686,7790,5101,5192,104,91,6195,909,5286,0.853268765133172,7735.69,5143.6,7735.85,5144.02,127
128,3201,3930,5109,5810,729,701,302060,2029,300031,0.9932827914983778,3581.63,5474.62,3581.51,5474.61,128
129,8293,8412,5121,5250,119,129,11122,0,11122,1.0,8347.88,5183.61,8347.28,5184.14,130
130,7921,8109,5122,5250,188,128,13794,3997,9797,0.7102363346382485,8014.76,5190.06,8015.06,5189.98,129
131,7449,7550,5129,5205,101,76,4557,211,4346,0.9536976080754883,7491.43,5163.06,7491.2,5162.82,131
132,7781,7842,5131,5201,61,70,2827,96,2731,0.9660417403608065,7817.54,5163.4,7817.23,5163.87,133
133,7841,7925,5131,5211,84,80,4857,341,4516,0.9297920527074326,7881.72,5170.1,7881.46,5170.13,132
134,7339,7485,5134,5305,146,171,17953,0,17953,1.0,7403.99,5215.78,7403.72,5216.32,134
135,7913,7972,5139,5185,59,46,1583,192,1391,0.8787113076437144,7939.54,5157.76,7939.5,5157.97,135
136,8474,8570,5141,5251,96,110,7443,0,7443,1.0,8527.13,5194.3,8526.73,5194.48,136
137,7458,7562,5156,5305,104,149,7119,0,7119,1.0,7508.83,5230.84,7508.77,5230.68,138
138,8561,8677,5156,5288,116,132,9410,3422,5988,0.6363443145589798,8618.09,5229.68,8617.76,5229.63,137
139,8051,8275,5166,5342,224,176,24017,0,24017,1.0,8163.32,5249.15,8163.16,5249.26,139
140,7763,7827,5169,5265,64,96,4500,2092,2408,0.5351111111111111,7791.01,5218.5,7791.12,5218.91,140
141,7171,7350,5171,5352,179,181,18480,1892,16588,0.8976190476190476,7271.01,5267.81,7270.62,5267.97,141
142,7664,7730,5172,5240,66,68,2977,0,2977,1.0,7696.81,5206.75,7696.49,5206.55,142
143,8668,8845,5176,5327,177,151,17302,2257,15045,0.8695526528725003,8752.5,5246.59,8752.39,5247.06,143
144,7723,7767,5179,5265,44,86,2736,0,2736,1.0,7746.54,5219.77,7746.66,5220.85,144
145,1993,3799,5190,6440,1806,1250,1162095,492,1161603,0.9995766266957521,2927.49,5847.65,2926.53,5847.66,145
146,7823,7862,5194,5260,39,66,1891,0,1891,1.0,7839.87,5228.16,7839.8,5228.21,148
147,7751,7995,5194,5378,244,184,24509,628,23881,0.9743767595577135,7877.56,5301.76,7877.16,5301.41,146
148,8356,8511,5194,5315,155,121,13262,0,13262,1.0,8436.4,5255.44,8436.19,5255.6,147
149,7901,7946,5204,5253,45,49,1525,159,1366,0.8957377049180328,7920.5,5230.13,7921.01,5230.15,149
150,7526,7597,5212,5295,71,83,4021,0,4021,1.0,7562.03,5251.73,7561.87,5251.86,150
151,7589,7740,5220,5302,151,82,7570,0,7570,1.0,7656.07,5257.71,7656.59,5257.96,151
152,3708,5112,5226,6903,1404,1677,1193078,0,1193078,1.0,4492.74,6059.02,4492.63,6058.96,152
153,7971,8113,5236,5431,142,195,14415,8,14407,0.999445022545959,8046.55,5318.47,8046.63,5319.65,153
154,8496,8591,5236,5340,95,104,6798,0,6798,1.0,8544.0,5287.58,8544.16,5287.76,154
155,8226,8395,5243,5511,169,268,24229,0,24229,1.0,8307.79,5346.62,8307.76,5347.24,155
156,7039,7195,5249,5432,156,183,18227,1193,17034,0.9345476490920064,7119.31,5344.11,7119.48,5344.05,156
157,7821,7850,5259,5290,29,31,699,72,627,0.8969957081545065,7833.8,5275.74,7833.99,5275.23,157
158,7708,7762,5261,5318,54,57,1729,0,1729,1.0,7731.82,5286.94,7731.11,5287.64,158
159,7736,7787,5263,5325,51,62,1966,151,1815,0.9231943031536114,7765.27,5297.78,7764.7,5297.5,159
160,7458,7566,5269,5375,108,106,6653,2837,3816,0.5735758304524274,7514.92,5324.94,7514.99,5325.2,160
161,8536,8777,5271,5580,241,309,42283,3384,38899,0.9199678357732421,8665.23,5405.46,8665.29,5406.01,161
162,7439,7490,5276,5340,51,64,1451,0,1451,1.0,7465.69,5306.96,7465.3,5306.86,162
163,7656,7707,5279,5313,51,34,1405,0,1405,1.0,7680.13,5295.37,7679.95,5295.62,163
164,8803,8900,5279,5385,97,106,6524,392,6132,0.9399141630901288,8850.3,5323.09,8850.1,5323.46,164
165,7611,7658,5284,5328,47,44,1566,0,1566,1.0,7633.3,5306.64,7633.62,5307.08,165
166,7288,7380,5285,5370,92,85,4428,0,4428,1.0,7335.76,5326.57,7335.64,5326.77,166
167,7566,7610,5285,5338,44,53,1789,0,1789,1.0,7585.7,5311.51,7586.12,5311.48,167
168,7376,7460,5286,5361,84,75,4147,0,4147,1.0,7416.54,5321.14,7416.64,5321.49,168
169,7646,7775,5306,5405,129,99,7963,507,7456,0.9363305286952154,7706.18,5351.73,7706.13,5351.81,169
170,8751,8822,5306,5358,71,52,2477,0,2477,1.0,8786.7,5332.36,8786.59,5332.44,170
171,8336,8552,5307,5478,216,171,29775,833,28942,0.9720235096557515,8442.27,5396.79,8442.12,5396.98,171
172,8083,8277,5319,5433,194,114,15075,545,14530,0.9638474295190713,8182.34,5375.31,8182.56,5375.61,172
173,7581,7655,5324,5360,74,36,2096,73,2023,0.9651717557251909,7620.03,5344.01,7619.4,5344.41,173
174,7509,7585,5330,5423,76,93,4504,0,4504,1.0,7550.88,5378.06,7550.84,5377.94,174
175,7189,7281,5334,5452,92,118,7884,489,7395,0.9379756468797564,7235.02,5388.7,7234.6,5388.75,175
176,7734,8047,5334,5525,313,191,33753,0,33753,1.0,7896.4,5418.4,7896.13,5418.56,176
177,7413,7475,5339,5400,62,61,2636,0,2636,1.0,7440.77,5370.96,7440.7,5371.13,177
178,7330,7423,5341,5430,93,89,5108,0,5108,1.0,7377.74,5383.0,7377.77,5383.0,178
179,7269,7361,5343,5450,92,107,5431,0,5431,1.0,7311.24,5396.72,7310.83,5396.67,179
180,8738,8843,5351,5545,105,194,14568,2423,12145,0.8336765513454146,8789.96,5447.15,8789.77,5447.53,180
181,6936,7086,5354,5490,150,136,14906,0,14906,1.0,7001.49,5420.69,7001.4,5420.94,181
182,7576,7661,5361,5405,85,44,2879,1283,1596,0.5543591524835012,7615.35,5379.74,7615.54,5380.15,182
183,7104,7197,5370,5460,93,90,2811,155,2656,0.9448594806118819,7154.65,5419.0,7154.4,5419.08,183
184,7456,7515,5371,5418,59,47,1637,0,1637,1.0,7485.4,5391.98,7484.79,5392.56,184
185,8854,8955,5371,5460,101,89,3279,2522,757,0.2308630680085392,8907.78,5416.37,8907.05,5416.03,185
186,7568,7715,5385,5470,147,85,6870,1503,5367,0.7812227074235808,7639.38,5421.83,7639.28,5422.03,186
187,8838,8985,5385,5540,147,155,12347,4470,7877,0.6379687373451041,8896.85,5474.95,8896.68,5474.74,187
188,7414,7541,5395,5470,127,75,5779,627,5152,0.8915037203668454,7477.91,5430.32,7478.13,5430.56,188
189,7686,7760,5401,5455,74,54,2930,0,2930,1.0,7724.39,5429.9,7724.01,5429.97,190
190,8094,8295,5401,5508,201,107,15845,0,15845,1.0,8191.15,5462.03,8190.97,5462.57,189
191,7144,7245,5405,5499,101,94,5355,0,5355,1.0,7189.85,5455.67,7189.94,5455.6,191
192,7323,7393,5419,5480,70,61,2796,0,2796,1.0,7358.78,5450.45,7358.48,5450.32,192
193,7366,7451,5420,5512,85,92,4096,0,4096,1.0,7407.44,5464.61,7407.13,5465.06,193
194,7538,7592,5421,5458,54,37,1302,156,1146,0.880184331797235,7567.01,5439.82,7566.4,5439.64,196
195,7969,8102,5421,5590,133,169,13411,0,13411,1.0,8039.52,5490.36,8039.06,5491.12,194
196,7224,7325,5425,5520,101,95,5870,0,5870,1.0,7274.98,5472.2,7274.64,5472.25,195
197,7041,7145,5429,5505,104,76,4336,0,4336,1.0,7088.17,5468.92,7088.41,5468.68,197
198,8504,8755,5430,5808,251,378,40479,50,40429,0.9987647916203464,8637.89,5625.52,8637.57,5625.35,198
199,7521,7564,5433,5472,43,39,1009,0,1009,1.0,7539.35,5452.71,7539.47,5453.41,199
200,10506,10721,5439,5911,215,472,51466,0,51466,1.0,10637.13,5618.85,10636.77,5619.42,200
201,7626,7700,5441,5488,74,47,2139,0,2139,1.0,7664.14,5464.61,7664.11,5464.73,201
202,1951,2227,5446,5877,276,431,39652,0,39652,1.0,2083.34,5613.48,2082.74,5614.83,202
203,7508,7850,5451,5745,342,294,59951,1275,58676,0.9787326316491801,7679.35,5569.56,7679.03,5569.73,203
204,7478,7555,5456,5521,77,65,3140,698,2442,0.7777070063694268,7518.7,5488.18,7518.78,5488.5,204
205,2798,2875,5461,5515,77,54,2339,0,2339,1.0,2836.91,5486.11,2837.0,5486.25,205
206,6650,6788,5464,5635,138,171,13726,0,13726,1.0,6721.92,5551.92,6721.63,5552.1,206
207,7433,7497,5465,5520,64,55,2409,385,2024,0.8401826484018264,7464.62,5493.09,7464.29,5493.05,207
208,4114,4252,5469,5607,138,138,9880,0,9880,1.0,4192.19,5534.29,4191.7,5534.24,208
209,8303,8550,5471,5622,247,151,26197,0,26197,1.0,8430.9,5539.7,8430.86,5540.17,209
210,7090,7172,5475,5545,82,70,3913,0,3913,1.0,7130.5,5508.76,7130.51,5508.77,210
211,7301,7372,5475,5525,71,50,2581,0,2581,1.0,7338.44,5498.09,7338.0,5498.61,211
212,7828,8000,5476,5690,172,214,25855,0,25855,1.0,7906.32,5575.06,7905.75,5575.62,212
213,8801,8892,5480,5575,91,95,4571,0,4571,1.0,8843.85,5532.83,8844.02,5533.43,214
214,6921,7030,5481,5550,109,69,4898,0,4898,1.0,6972.17,5510.76,6971.86,5510.9,213
215,7158,7243,5484,5555,85,71,4115,0,4115,1.0,7202.67,5520.73,7202.53,5520.99,215
216,7003,7107,5486,5567,104,81,4769,0,4769,1.0,7057.47,5529.52,7056.76,5529.12,216
217,7384,7437,5486,5533,53,47,1647,0,1647,1.0,7409.87,5509.73,7409.72,5509.85,217
218,7228,7330,5501,5586,102,85,5384,0,5384,1.0,7277.67,5543.61,7277.3,5543.9,218
219,8011,8333,5501,5722,322,221,41319,0,41319,1.0,8167.37,5588.98,8167.32,5589.68,219
220,6869,6950,5506,5567,81,61,2757,0,2757,1.0,6906.49,5538.69,6906.92,5539.21,220
221,7299,7517,5507,5817,218,310,34719,1877,32842,0.9459373829891414,7420.96,5620.98,7420.58,5621.5,221
222,8931,9027,5509,5608,96,99,6388,0,6388,1.0,8980.7,5555.26,8980.6,5555.52,222
223,6823,6900,5529,5593,77,64,3452,0,3452,1.0,6857.98,5562.55,6857.93,5562.75,224
224,6939,7025,5531,5613,86,82,3817,0,3817,1.0,6977.27,5565.51,6977.07,5565.83,223
225,8884,8995,5531,5682,111,151,8709,0,8709,1.0,8931.89,5608.24,8931.94,5608.25,225
226,6764,6835,5536,5610,71,74,3328,0,3328,1.0,6801.9,5571.89,6801.36,5571.82,226
227,7076,7164,5536,5598,88,62,2935,0,2935,1.0,7116.16,5565.7,7116.19,5565.41,227
228,8691,8912,5537,5740,221,203,24094,1487,22607,0.9382833900556155,8786.48,5630.11,8786.71,5630.59,228
229,7114,7232,5543,5650,118,107,7631,0,7631,1.0,7175.06,5593.47,7175.22,5593.41,229
230,6999,7086,5556,5628,87,72,3991,0,3991,1.0,7042.19,5588.41,7042.16,5588.54,230
231,6896,6958,5561,5640,62,79,3466,0,3466,1.0,6924.15,5601.85,6924.16,5602.19,231
232,8499,8625,5561,5680,126,119,10667,0,10667,1.0,8565.75,5623.11,8565.66,5623.24,232
233,7194,7268,5570,5660,74,90,3651,0,3651,1.0,7233.54,5617.8,7233.63,5617.94,233
234,6743,6856,5575,5698,113,123,7666,0,7666,1.0,6792.66,5639.48,6792.64,5639.63,235
235,8861,8900,5575,5645,39,70,2033,0,2033,1.0,8881.81,5612.5,8881.38,5612.58,234
236,6951,7135,5580,5667,184,87,7523,0,7523,1.0,7034.64,5626.14,7035.12,5626.15,236
237,7263,7321,5584,5628,58,44,2042,0,2042,1.0,7289.06,5605.22,7288.75,5605.49,237
238,6820,6907,5587,5632,87,45,2722,0,2722,1.0,6866.15,5608.78,6866.25,5608.89,238
239,7806,8141,5589,5810,335,221,41250,0,41250,1.0,7988.3,5712.6,7987.92,5712.69,239
240,6563,6750,5591,5710,187,119,12702,0,12702,1.0,6646.72,5647.85,6646.74,5647.88,240
241,8972,9094,5595,5732,122,137,8408,2553,5855,0.696360608943863,9035.33,5657.44,9035.09,5657.83,242
242,8328,8545,5596,5792,217,196,29649,0,29649,1.0,8436.05,5682.84,8435.96,5683.27,241
243,8116,8385,5604,5925,269,321,47182,1795,45387,0.9619558306133695,8254.63,5757.95,8254.44,5758.45,243
244,7021,7407,5615,5813,386,198,46672,0,46672,1.0,7205.6,5710.89,7205.02,5711.06,244
245,4821,5610,5621,6100,789,479,213958,8523,205435,0.9601650791276792,5205.33,5855.1,5205.45,5855.02,245
246,6836,6945,5629,5713,109,84,6857,0,6857,1.0,6893.41,5670.23,6893.07,5670.3,246
247,6931,7030,5634,5755,99,121,7929,2,7927,0.9997477613822676,6979.53,5695.59,6979.14,5696.01,247
248,7625,7790,5639,5795,165,156,21822,0,21822,1.0,7704.66,5717.87,7704.82,5718.03,248
249,7163,7220,5645,5700,57,55,2162,10,2152,0.9953746530989824,7187.82,5671.87,7187.86,5671.63,250
250,7453,7630,5645,5857,177,212,27581,0,27581,1.0,7535.07,5746.79,7534.75,5746.81,249
251,8939,9011,5650,5720,72,70,3423,0,3423,1.0,8975.14,5684.59,8974.66,5684.86,251
252,9073,9155,5659,5723,82,64,3387,157,3230,0.9536462946560378,9109.5,5689.64,9109.51,5690.18,252
253,6679,6815,5661,5765,136,104,7547,0,7547,1.0,6748.73,5707.97,6748.19,5708.13,253
254,8893,8946,5670,5740,53,70,2549,0,2549,1.0,8918.74,5705.1,8918.46,5705.1,255
255,6796,6995,5671,5845,199,174,18239,0,18239,1.0,6888.8,5760.65,6888.33,5760.65,256
256,8729,8895,5671,5942,166,271,27759,0,27759,1.0,8816.24,5805.14,8816.37,5805.03,254
257,8857,8897,5674,5723,40,49,1435,0,1435,1.0,8878.9,5696.34,8879.11,5696.46,257
258,8538,8605,5676,5750,67,74,4156,0,4156,1.0,8571.6,5710.32,8571.15,5710.38,258
259,8979,9080,5695,5841,101,146,9709,724,8985,0.9254300133896385,9027.9,5764.04,9027.79,5764.19,259
260,6621,6706,5699,5796,85,97,5470,0,5470,1.0,6663.29,5742.21,6663.12,5742.14,260
261,9071,9200,5701,5837,129,136,12279,0,12279,1.0,9132.31,5772.05,9132.15,5772.18,261
262,8925,8982,5714,5770,57,56,2312,233,2079,0.8992214532871973,8955.91,5740.67,8955.95,5740.45,262
263,8866,8907,5724,5811,41,87,2174,0,2174,1.0,8886.47,5767.57,8886.38,5767.74,263
264,6693,6771,5729,5820,78,91,4801,0,4801,1.0,6729.03,5770.5,6729.08,5770.83,264
265,7761,8070,5735,5966,309,231,35446,0,35446,1.0,7933.66,5849.4,7933.34,5849.51,266
266,6991,7040,5736,5790,49,54,1941,999,942,0.4853168469860896,7015.95,5764.12,7015.66,5764.58,267
267,8898,8943,5736,5808,45,72,2307,0,2307,1.0,8917.82,5770.94,8917.69,5771.19,265
268,8496,8631,5742,5878,135,136,12639,199,12440,0.9842550834717937,8564.94,5811.13,8564.75,5811.05,269
269,7251,7441,5744,5862,190,118,15224,3444,11780,0.7737782448765108,7333.74,5807.98,7333.85,5808.17,268
270,1726,2535,5746,7165,809,1419,515116,5135,509981,0.990031371574558,2059.18,6408.46,2059.34,6408.67,270
271,6588,6666,5748,5862,78,114,5799,0,5799,1.0,6626.31,5806.59,6626.06,5806.9,271
272,8289,8531,5749,6025,242,276,41424,0,41424,1.0,8416.57,5882.03,8416.3,5882.16,272
273,6751,6820,5761,5813,69,52,2507,0,2507,1.0,6787.89,5786.66,6787.52,5786.57,274
274,6854,7266,5761,6042,412,281,69874,4615,65259,0.9339525431490969,7075.43,5892.75,7075.17,5892.81,273
275,8931,8997,5764,5835,66,71,3350,0,3350,1.0,8966.7,5798.34,8966.38,5798.55,275
276,3611,3730,5781,5886,119,105,6452,0,6452,1.0,3679.65,5822.91,3679.4,5822.75,277
277,8061,8230,5781,5923,169,142,14527,0,14527,1.0,8125.53,5859.94,8125.91,5860.05,276
278,7736,7990,5782,6140,254,358,50844,0,50844,1.0,7854.17,5978.62,7854.1,5978.66,279
279,7511,7747,5784,6055,236,271,50720,0,50720,1.0,7632.05,5915.89,7631.95,5915.96,278
280,10546,10721,5786,6356,175,570,44086,872,43214,0.9802204781563308,10662.05,6004.51,10661.6,6005.92,280
281,6658,6715,5789,5865,57,76,2818,0,2818,1.0,6684.25,5824.65,6683.92,5824.85,281
282,9156,9252,5796,5958,96,162,7160,0,7160,1.0,9206.97,5881.29,9206.64,5881.05,282
283,8616,8905,5799,6190,289,391,52619,500,52119,0.9904977289572208,8759.16,5989.77,8758.82,5990.22,285
284,6628,6840,5800,5986,212,186,15726,0,15726,1.0,6738.61,5900.45,6738.78,5899.77,284
285,6501,6556,5804,5872,55,68,2388,0,2388,1.0,6525.84,5831.72,6525.17,5832.45,286
286,6553,6626,5806,5895,73,89,3378,0,3378,1.0,6588.33,5854.01,6587.5,5854.05,283
287,8903,8958,5806,5865,55,59,2081,0,2081,1.0,8929.72,5832.46,8929.71,5833.14,287
288,7363,7525,5810,6058,162,248,25828,0,25828,1.0,7448.68,5943.76,7448.41,5943.49,288
289,8844,9070,5811,6065,226,254,24526,323,24203,0.9868303025360842,8935.24,5948.99,8935.49,5948.88,289
290,9019,9106,5811,5910,87,99,5789,0,5789,1.0,9063.56,5857.65,9063.21,5858.05,290
291,6426,6505,5816,5890,79,74,3594,0,3594,1.0,6470.33,5854.06,6470.08,5854.5,291
292,6336,6447,5819,5942,111,123,6360,207,6153,0.9674528301886792,6389.44,5876.13,6389.43,5875.88,292
293,6689,6750,5821,5880,61,59,2388,0,2388,1.0,6722.58,5849.05,6721.91,5849.4,293
294,6828,6870,5825,5890,42,65,2101,0,2101,1.0,6848.25,5855.48,6848.23,5855.4,295
295,8943,9052,5825,5923,109,98,5681,0,5681,1.0,8998.68,5873.58,8998.52,5873.86,294
296,9094,9170,5831,5915,76,84,4052,0,4052,1.0,9129.03,5868.32,9128.93,5868.53,296
297,6503,6571,5840,5913,68,73,3504,0,3504,1.0,6539.74,5878.55,6539.29,5879.16,297
298,6778,6840,5844,5950,62,106,3784,0,3784,1.0,6806.77,5895.38,6806.58,5895.81,298
299,6615,6676,5845,5905,61,60,1791,0,1791,1.0,6642.83,5872.84,6642.49,5873.44,299
300,7216,7405,5845,6035,189,190,23577,0,23577,1.0,7301.09,5927.71,7300.86,5928.02,300
301,9248,9385,5851,6026,137,175,14814,0,14814,1.0,9310.67,5939.39,9310.34,5939.43,301
302,8498,8675,5856,6025,177,169,20495,501,19994,0.9755550134179068,8586.08,5939.76,8585.72,5939.85,302
303,6559,6925,5864,6236,366,372,66890,5930,60960,0.9113469875915683,6757.35,6064.38,6757.12,6064.09,303
304,6644,6710,5865,5914,66,49,2387,0,2387,1.0,6678.33,5890.35,6678.39,5890.61,304
305,6353,6445,5872,6030,92,158,7900,0,7900,1.0,6402.48,5957.8,6402.4,5957.62,305
306,6438,6511,5876,5965,73,89,3768,0,3768,1.0,6469.47,5914.47,6469.1,5914.58,306
307,9106,9215,5879,6003,109,124,8331,0,8331,1.0,9156.76,5941.19,9156.51,5941.21,307
308,6554,6620,5889,5950,66,61,3104,0,3104,1.0,6588.69,5917.21,6587.89,5917.34,308
309,8958,8996,5895,5925,38,30,807,213,594,0.7360594795539034,8977.1,5909.58,8977.0,5909.72,309
310,6611,6658,5900,5961,47,61,1721,0,1721,1.0,6633.66,5927.37,6633.49,5927.67,310
311,9076,9115,5900,5940,39,40,943,0,943,1.0,9096.15,5918.76,9096.22,5919.06,311
312,7968,8296,5901,6225,328,324,79617,0,79617,1.0,8138.51,6045.49,8138.21,6045.84,312
313,9042,9098,5905,5950,56,45,1575,0,1575,1.0,9066.83,5927.97,9066.63,5928.24,313
314,6429,6557,5910,6020,128,110,9032,3308,5724,0.6337466784765279,6498.75,5968.69,6498.67,5969.0,314
315,6541,6575,5931,5965,34,34,718,0,718,1.0,6555.58,5948.08,6555.85,5947.75,315
316,8288,8451,5934,6148,163,214,25117,0,25117,1.0,8363.74,6049.13,8363.7,6049.33,316
317,9051,9146,5941,6033,95,92,4434,0,4434,1.0,9097.2,5987.36,9097.19,5987.33,317
318,6546,6630,5946,6010,84,64,3312,0,3312,1.0,6586.03,5974.44,6585.84,5974.82,318
319,9174,9267,5946,6047,93,101,4801,129,4672,0.9731305977921266,9213.32,5990.97,9213.57,5990.88,319
320,6660,6716,5964,6015,56,51,1606,0,1606,1.0,6690.57,5986.04,6690.46,5986.03,320
321,8996,9116,5966,6123,120,157,7002,467,6535,0.9333047700656956,9058.89,6030.54,9059.47,6031.92,321
322,7472,7885,5971,6660,413,689,179647,0,179647,1.0,7681.51,6352.73,7681.49,6352.7,322
323,9281,9480,5976,6140,199,164,19244,2751,16493,0.8570463521097484,9385.58,6053.41,9385.19,6053.66,323
324,6851,6961,5981,6132,110,151,11641,0,11641,1.0,6910.15,6062.35,6910.13,6062.34,327
325,6651,6695,5983,6040,44,57,1528,905,623,0.40772251308900526,6668.34,6011.31,6668.66,6011.42,326
326,6951,7126,5984,6160,175,176,21429,493,20936,0.9769937934574642,7032.43,6068.35,7032.19,6068.44,325
327,9209,9296,5984,6090,87,106,5273,195,5078,0.9630191541816803,9253.59,6041.06,9253.18,6041.14,324
328,6372,6451,5985,6070,79,85,3113,46,3067,0.9852232573080629,6414.04,6032.5,6414.06,6032.17,329
329,8566,8737,5985,6150,171,165,18899,0,18899,1.0,8655.53,6062.89,8655.3,6063.18,328
330,7241,7428,5990,6208,187,218,25945,2922,23023,0.8873771439583735,7337.47,6096.0,7337.51,6096.18,330
331,7111,7275,5991,6135,164,144,16365,1498,14867,0.9084631836235869,7190.83,6064.96,7190.66,6065.26,331
332,8446,8582,5993,6138,136,145,14631,0,14631,1.0,8512.57,6066.51,8512.41,6066.65,332
333,3626,4307,5994,6925,681,931,355309,3221,352088,0.9909346512472242,3983.4,6474.44,3982.52,6474.45,333
334,6511,6567,5996,6060,56,64,2550,0,2550,1.0,6539.45,6029.57,6539.0,6029.74,334
335,9138,9211,6000,6085,73,85,3942,0,3942,1.0,9167.57,6043.05,9167.64,6042.99,335
336,6316,6390,6009,6098,74,89,3811,0,3811,1.0,6351.19,6055.48,6351.03,6055.52,337
337,7416,7607,6009,6245,191,236,28128,0,28128,1.0,7517.77,6116.66,7517.8,6117.07,336
338,8968,9020,6011,6083,52,72,2621,90,2531,0.9656619610835558,8992.88,6046.95,8992.88,6046.86,338
339,9096,9140,6016,6077,44,61,1875,0,1875,1.0,9119.49,6047.21,9119.18,6047.16,339
340,6403,6519,6019,6106,116,87,6420,787,5633,0.8774143302180686,6466.34,6058.65,6465.64,6059.17,340
341,8931,9140,6024,6369,209,345,37693,1668,36025,0.9557477515719099,9038.64,6201.97,9038.38,6201.7,343
342,9011,9057,6024,6083,46,59,1972,1054,918,0.46551724137931033,9033.36,6052.12,9033.36,6052.39,342
343,6276,6345,6026,6102,69,76,2192,0,2192,1.0,6306.16,6064.92,6305.97,6064.89,341
344,2458,3082,6036,6853,624,817,343061,172,342889,0.9994986314387238,2773.23,6452.46,2772.78,6452.08,344
345,6505,6671,6050,6256,166,206,16732,102,16630,0.9939038967248386,6589.03,6145.99,6588.76,6146.2,346
346,9166,9250,6055,6156,84,101,5204,0,5204,1.0,9205.12,6105.02,9204.74,6105.42,345
347,8841,9025,6064,6512,184,448,42858,484,42374,0.988706892528816,8939.63,6302.48,8939.25,6302.11,347
348,6356,6424,6069,6127,68,58,2565,0,2565,1.0,6391.78,6095.96,6391.4,6095.86,348
349,9111,9170,6069,6137,59,68,3184,0,3184,1.0,9140.52,6102.87,9140.21,6102.59,349
350,9454,9560,6072,6225,106,153,8262,0,8262,1.0,9507.53,6152.01,9507.14,6151.87,350
351,9227,9350,6076,6200,123,124,9289,782,8507,0.9158144041339218,9283.55,6130.09,9283.34,6130.35,351
352,6449,6507,6081,6140,58,59,2276,0,2276,1.0,6477.02,6110.29,6476.77,6109.93,352
353,6298,6407,6091,6240,109,149,10775,0,10775,1.0,6348.84,6157.6,6348.71,6158.03,353
354,6381,6497,6104,6232,116,128,8058,0,8058,1.0,6436.31,6168.85,6436.45,6169.22,354
355,6488,6550,6105,6165,62,60,2500,0,2500,1.0,6518.75,6137.79,6518.74,6137.74,355
356,8408,8580,6105,6333,172,228,24904,57,24847,0.9977112110504337,8489.06,6221.59,8489.0,6221.94,356
357,8532,8701,6105,6260,169,155,17545,0,17545,1.0,8611.78,6182.15,8611.36,6182.22,357
358,7796,8105,6106,6450,309,344,65093,0,65093,1.0,7955.88,6253.46,7955.69,6253.61,358
359,9338,9398,6107,6176,60,69,2651,0,2651,1.0,9364.97,6140.74,9364.89,6140.73,359
360,8178,8432,6110,6415,254,305,51964,0,51964,1.0,8308.04,6257.69,8307.81,6258.17,360
361,7133,7282,6111,6293,149,182,18797,1919,16878,0.8979092408363036,7205.91,6197.17,7205.81,6197.06,362
362,9368,9493,6111,6233,125,122,9532,0,9532,1.0,9430.4,6179.21,9430.09,6179.58,361
363,6928,7152,6116,6337,224,221,32211,0,32211,1.0,7052.66,6232.39,7052.43,6232.61,363
364,9073,9151,6119,6201,78,82,4047,0,4047,1.0,9111.47,6156.21,9111.78,6156.09,364
365,6854,7003,6121,6235,149,114,11367,0,11367,1.0,6925.8,6174.5,6925.72,6174.71,365
366,9143,9192,6131,6173,49,42,1349,0,1349,1.0,9166.08,6152.14,9166.1,6152.17,367
367,9294,9342,6131,6203,48,72,1910,0,1910,1.0,9318.74,6166.12,9318.48,6166.89,366
368,7221,7525,6139,6415,304,276,52783,4073,48710,0.9228350036943713,7365.53,6289.46,7365.61,6289.42,368
369,8803,8905,6144,6255,102,111,8313,5,8308,0.9993985324191026,8853.93,6198.97,8853.65,6199.22,369
370,9186,9246,6144,6227,60,83,3207,0,3207,1.0,9212.39,6183.5,9212.76,6183.28,370
371,8713,8812,6159,6262,99,103,6408,26,6382,0.9959425717852685,8772.38,6203.38,8772.3,6203.88,371
372,6421,6646,6160,6345,225,185,20573,1235,19338,0.9399698634132115,6541.02,6252.84,6540.56,6253.33,372
373,9322,9381,6161,6246,59,85,3081,0,3081,1.0,9348.71,6203.09,9348.43,6202.77,373
374,9128,9199,6166,6243,71,77,3868,0,3868,1.0,9162.39,6207.72,9162.88,6208.03,374
375,6744,6940,6184,6312,196,128,18179,0,18179,1.0,6838.38,6251.61,6838.5,6251.63,375
376,8639,8785,6190,6345,146,155,14352,0,14352,1.0,8711.26,6272.75,8711.04,6272.53,377
377,9192,9285,6190,6265,93,75,4389,0,4389,1.0,9244.36,6229.21,9243.84,6229.6,376
378,9281,9347,6190,6290,66,100,4353,156,4197,0.9641626464507237,9312.37,6242.36,9312.26,6242.43,378
379,9456,9590,6196,6350,134,154,13133,2115,11018,0.8389553034340973,9521.19,6274.79,9520.8,6274.85,379
380,7744,8240,6204,6960,496,756,202381,0,202381,1.0,8026.16,6638.18,8026.13,6637.75,380
381,6351,6427,6207,6258,76,51,2378,0,2378,1.0,6389.42,6236.07,6389.16,6236.18,381
382,6424,6477,6214,6263,53,49,1720,386,1334,0.7755813953488372,6448.46,6238.72,6448.83,6238.75,382
383,9346,9467,6220,6318,121,98,9293,96,9197,0.9896696438179274,9405.94,6270.32,9405.48,6270.32,383
384,6178,6296,6229,6312,118,83,5347,0,5347,1.0,6233.8,6266.38,6234.1,6266.6,384
385,6628,6772,6229,6403,144,174,16907,64,16843,0.9962145856745727,6695.53,6307.24,6695.45,6307.41,385
386,2221,2562,6231,6766,341,535,102983,0,102983,1.0,2362.81,6455.23,2362.9,6455.41,386
387,6304,6356,6234,6273,52,39,1216,0,1216,1.0,6331.61,6251.94,6332.03,6252.01,387
388,9131,9270,6239,6335,139,96,9644,0,9644,1.0,9192.55,6287.21,9193.07,6287.47,389
389,6353,6426,6244,6335,73,91,4023,0,4023,1.0,6389.0,6288.33,6388.74,6288.7,388
390,8744,8912,6244,6435,168,191,23470,0,23470,1.0,8832.64,6340.84,8832.46,6340.93,390
391,6283,6370,6245,6350,87,105,5561,0,5561,1.0,6329.42,6300.53,6328.63,6300.13,391
392,9263,9301,6247,6300,38,53,1180,0,1180,1.0,9280.37,6271.54,9280.44,6271.65,392
393,2994,3865,6249,6825,871,576,259155,65,259090,0.999749184850765,3375.04,6549.17,3375.31,6549.25,393
394,8556,8680,6256,6383,124,127,10117,39,10078,0.9961451023030543,8617.2,6316.79,8617.28,6316.92,395
395,6224,6305,6266,6340,81,74,3593,0,3593,1.0,6268.71,6305.22,6268.27,6306.59,394
396,6369,6588,6274,6506,219,232,23335,1443,21892,0.9381615598885794,6464.93,6376.9,6464.47,6377.23,397
397,7079,7260,6275,6492,181,217,28200,60,28140,0.997872340425532,7166.64,6387.08,7166.5,6387.13,398
398,6106,6230,6276,6395,124,119,9085,0,9085,1.0,6167.28,6334.76,6167.49,6334.89,396
399,7423,7495,6276,6353,72,77,3469,0,3469,1.0,7457.81,6305.83,7457.5,6306.25,399
400,8363,8593,6280,6550,230,270,37181,0,37181,1.0,8475.94,6420.12,8475.65,6420.24,400
401,9246,9341,6280,6407,95,127,5791,0,5791,1.0,9291.08,6343.08,9291.04,6342.75,401
402,9306,9385,6287,6384,79,97,5116,0,5116,1.0,9345.33,6333.69,9345.3,6333.7,402
403,6716,6910,6300,6452,194,152,17557,392,17165,0.9776727231303753,6807.44,6364.98,6807.46,6365.1,403
404,6848,7011,6306,6603,163,297,27532,0,27532,1.0,6923.07,6480.59,6923.01,6480.09,404
405,6931,7087,6306,6486,156,180,21300,10,21290,0.9995305164319249,7012.42,6386.11,7012.2,6386.33,405
406,9449,9527,6306,6380,78,74,3298,0,3298,1.0,9487.58,6343.84,9487.13,6343.81,406
407,9376,9467,6314,6371,91,57,3985,100,3885,0.9749058971141782,9422.0,6340.46,9421.65,6340.85,407
408,9107,9172,6315,6388,65,73,3196,0,3196,1.0,9139.33,6351.32,9139.02,6351.28,408
409,10591,10721,6319,6598,130,279,25155,0,25155,1.0,10667.17,6458.51,10666.8,6458.37,409
410,6023,6148,6326,6432,125,106,7916,295,7621,0.962733703890854,6080.84,6382.89,6080.7,6382.68,411
411,9061,9380,6326,6878,319,552,110131,1027,109104,0.9906747418982847,9225.93,6594.89,9225.46,6595.0,410
412,8548,8645,6329,6460,97,131,7604,547,7057,0.9280641767490795,8595.3,6398.81,8594.83,6398.33,414
413,9163,9230,6329,6375,67,46,2406,0,2406,1.0,9196.12,6349.59,9195.49,6349.84,412
414,6198,6298,6331,6410,100,79,4265,0,4265,1.0,6245.93,6365.3,6245.43,6365.77,413
415,6569,6681,6334,6457,112,123,9243,0,9243,1.0,6621.54,6396.81,6621.3,6396.5,415
416,6355,6397,6336,6368,42,32,1050,0,1050,1.0,6377.93,6350.7,6377.87,6351.16,416
417,7841,7977,6336,6502,136,166,14990,0,14990,1.0,7909.45,6420.69,7909.25,6420.85,417
418,6256,6407,6339,6576,151,237,22560,0,22560,1.0,6332.26,6450.31,6332.12,6450.5,418
419,9509,9657,6339,6560,148,221,15990,2292,13698,0.8566604127579738,9582.18,6443.05,9581.78,6442.84,419
420,8641,8785,6341,6495,144,154,15737,514,15223,0.9673381203533075,8710.04,6414.91,8710.02,6415.05,420
421,9011,9067,6351,6477,56,126,4776,0,4776,1.0,9039.44,6410.46,9039.13,6410.83,422
422,8223,8261,6352,6390,38,38,950,0,950,1.0,8239.5,6372.07,8239.04,6371.97,421
423,9363,9437,6362,6446,74,84,3707,0,3707,1.0,9398.56,6405.3,9397.88,6405.15,423
424,9406,9460,6364,6411,54,47,1527,138,1389,0.9096267190569745,9431.98,6381.96,9432.09,6382.5,424
425,6476,6581,6366,6505,105,139,10495,195,10300,0.9814197236779418,6525.74,6432.3,6525.46,6432.48,425
426,9438,9535,6373,6470,97,97,6365,0,6365,1.0,9484.94,6422.56,9484.69,6422.91,426
427,8171,8417,6380,6718,246,338,57609,0,57609,1.0,8298.91,6559.16,8298.83,6559.22,427
428,9299,9365,6380,6450,66,70,2861,0,2861,1.0,9333.48,6410.78,9332.75,6411.19,430
429,6148,6240,6381,6482,92,101,5040,0,5040,1.0,6192.24,6423.11,6191.99,6423.83,429
430,5938,6040,6384,6515,102,131,6930,1189,5741,0.8284271284271284,5995.78,6448.69,5995.53,6448.82,428
431,8324,8370,6391,6433,46,42,1330,0,1330,1.0,8350.38,6413.7,8350.55,6413.79,431
432,6649,6764,6396,6537,115,141,9364,64,9300,0.9931653139683896,6703.11,6460.38,6703.02,6460.74,433
433,7206,7492,6397,6650,286,253,50934,1476,49458,0.9710213217104489,7338.48,6517.34,7338.45,6517.5,434
434,6081,6182,6398,6512,101,114,5578,0,5578,1.0,6132.38,6450.44,6131.99,6450.37,432
435,6141,6297,6406,6587,156,181,15666,0,15666,1.0,6229.74,6501.82,6229.51,6502.0,435
436,6699,6881,6414,6652,182,238,26734,0,26734,1.0,6795.3,6534.58,6795.1,6534.65,437
437,9335,9396,6414,6502,61,88,3563,260,3303,0.9270277855739545,9363.05,6456.65,9363.25,6456.76,436
438,6009,6145,6419,6605,136,186,14855,0,14855,1.0,6078.27,6516.45,6077.78,6516.11,438
439,8764,8892,6426,6515,128,89,7417,1478,5939,0.8007280571659701,8831.02,6465.38,8830.72,6465.36,439
440,9389,9470,6434,6520,81,86,4170,0,4170,1.0,9427.33,6471.1,9427.59,6471.45,440
441,6525,6680,6445,6615,155,170,16036,0,16036,1.0,6597.49,6519.88,6597.27,6520.03,442
442,8562,8745,6446,6673,183,227,30728,139,30589,0.9954764384274929,8646.82,6568.1,8646.7,6568.24,441
443,6986,7150,6451,6620,164,169,18438,0,18438,1.0,7072.03,6537.67,7071.86,6537.8,444
444,9029,9110,6451,6528,81,77,4292,1203,3089,0.7197110904007455,9077.03,6486.28,9076.8,6486.77,443
445,6361,6416,6456,6525,55,69,2011,0,2011,1.0,6385.8,6489.74,6385.94,6490.36,445
446,9433,9559,6460,6570,126,110,8696,0,8696,1.0,9500.34,6511.54,9499.76,6511.91,446
447,8911,9085,6466,6635,174,169,18279,0,18279,1.0,8996.69,6545.48,8996.62,6545.62,447
448,8716,8825,6470,6615,109,145,9981,113,9868,0.9886784891293458,8761.9,6537.0,8761.98,6537.43,448
449,5931,5985,6471,6518,54,47,1714,166,1548,0.9031505250875146,5956.5,6496.2,5956.34,6496.18,449
450,7100,7227,6476,6735,127,259,20534,470,20064,0.97711113275543,7169.44,6605.22,7169.36,6604.97,450
451,9354,9420,6480,6550,66,70,2814,0,2814,1.0,9386.33,6512.99,9386.23,6513.59,451
452,6369,6570,6481,6715,201,234,33175,117,33058,0.9964732479276563,6464.51,6603.32,6464.32,6603.45,453
453,7406,7590,6485,6690,184,205,21713,0,21713,1.0,7498.41,6598.03,7498.22,6598.27,452
454,9526,9688,6489,6680,162,191,11252,1429,9823,0.8730003554923569,9598.77,6584.68,9598.53,6584.74,454
455,8786,8927,6495,6622,141,127,10492,2430,8062,0.7683949675943577,8857.97,6554.4,8857.94,6554.54,455
456,8393,8610,6501,6850,217,349,48698,0,48698,1.0,8488.49,6675.75,8488.35,6675.86,456
457,5858,6066,6505,6666,208,161,19959,2695,17264,0.8649731950498522,5967.94,6574.08,5967.94,6574.15,457
458,9396,9465,6518,6613,69,95,5073,0,5073,1.0,9431.03,6563.84,9430.89,6564.6,458
459,5776,5880,6524,6603,104,79,5143,1836,3307,0.6430099163912113,5827.17,6562.9,5827.22,6563.13,459
460,6512,6771,6531,6862,259,331,55303,0,55303,1.0,6647.41,6705.48,6647.26,6705.48,460
461,8523,8562,6534,6568,39,34,1042,0,1042,1.0,8546.69,6550.38,8545.44,6550.3,461
462,9366,9420,6542,6660,54,118,3620,0,3620,1.0,9388.08,6606.1,9387.91,6606.09,462
463,6115,6255,6546,6697,140,151,14861,0,14861,1.0,6183.7,6614.89,6183.34,6615.18,463
464,9616,9720,6551,6648,104,97,5263,0,5263,1.0,9668.98,6597.97,9668.99,6598.34,465
465,3895,4501,6554,7228,606,674,180662,0,180662,1.0,4199.71,6902.6,4200.11,6902.22,464
466,3166,3755,6559,7245,589,686,254003,5110,248893,0.9798821273764483,3483.73,6934.54,3483.68,6934.59,466
467,6246,6385,6559,6731,139,172,16886,0,16886,1.0,6317.37,6638.92,6317.17,6638.89,467
468,9449,9545,6561,6655,96,94,6713,0,6713,1.0,9496.12,6606.58,9495.76,6607.0,468
469,1718,1735,6566,6582,17,16,176,0,176,1.0,0.0,0.0,1726.75,6573.61,0
470,6961,7105,6569,6680,144,111,7170,0,7170,1.0,7020.91,6623.55,7021.1,6623.48,469
471,5761,5930,6576,6755,169,179,20686,3772,16914,0.8176544522865706,5844.08,6668.56,5844.0,6668.26,470
472,8854,8970,6579,6690,116,111,7296,1786,5510,0.7552083333333334,8908.39,6632.7,8908.75,6632.77,472
473,8861,8900,6581,6618,39,37,935,0,935,1.0,8879.12,6598.05,8879.26,6598.1,471
474,6726,7000,6585,6910,274,325,58660,0,58660,1.0,6869.77,6741.32,6869.66,6741.48,473
475,8968,9129,6590,6726,161,136,12483,255,12228,0.9795722182167748,9060.53,6651.66,9060.35,6651.94,475
476,1942,2755,6591,7350,813,759,341807,0,341807,1.0,2357.73,6989.33,2357.48,6989.53,474
477,8714,8875,6594,6805,161,211,22013,199,21814,0.9909598873392995,8797.28,6693.8,8797.18,6693.78,476
478,6063,6125,6596,6655,62,59,3218,0,3218,1.0,6094.06,6626.13,6093.59,6626.19,477
479,9511,9601,6599,6701,90,102,6532,881,5651,0.8651255358236375,9556.92,6651.57,9556.56,6651.84,478
480,9408,9466,6610,6663,58,53,1783,0,1783,1.0,9437.78,6632.93,9437.3,6633.14,479
481,5913,6088,6611,6825,175,214,17911,10,17901,0.9994416838814136,6000.75,6710.34,6000.74,6710.58,480
482,7163,7475,6614,6903,312,289,61357,0,61357,1.0,7311.84,6754.7,7311.68,6754.69,481
483,6973,7196,6629,6950,223,321,44651,0,44651,1.0,7075.62,6797.76,7075.57,6797.98,482
484,9596,9655,6641,6701,59,60,1883,0,1883,1.0,9623.35,6672.51,9623.69,6672.83,484
485,8851,9087,6643,6930,236,287,43414,22,43392,0.999493251025015,8973.1,6774.8,8973.08,6774.88,486
486,7332,7870,6644,7161,538,517,178001,0,178001,1.0,7628.61,6899.28,7628.14,6899.48,485
487,9418,9462,6646,6685,44,39,1083,0,1083,1.0,9437.06,6665.85,9437.51,6665.84,487
488,9649,9740,6646,6785,91,139,8228,0,8228,1.0,9698.61,6712.01,9698.28,6712.33,483
489,6043,6176,6651,6778,133,127,11650,0,11650,1.0,6102.96,6710.71,6102.72,6710.66,489
490,9328,9428,6651,6761,100,110,6884,0,6884,1.0,9377.3,6701.2,9377.61,6701.48,488
491,9459,9515,6654,6728,56,74,3067,0,3067,1.0,9487.63,6687.21,9487.34,6687.67,490
492,6146,6332,6656,6838,186,182,22545,0,22545,1.0,6239.68,6754.4,6239.41,6754.49,491
493,7466,7525,6661,6740,59,79,3169,0,3169,1.0,7491.3,6698.22,7491.16,6698.57,492
494,8203,8285,6665,6760,82,95,3821,0,3821,1.0,8233.92,6709.65,8233.57,6709.73,493
495,8544,8810,6671,6940,266,269,45768,0,45768,1.0,8675.11,6804.03,8674.99,6804.49,494
496,9553,9660,6676,6758,107,82,5628,0,5628,1.0,9608.78,6719.55,9608.17,6719.67,496
497,8353,8397,6679,6728,44,49,1364,0,1364,1.0,8379.08,6706.06,8379.07,6706.31,495
498,9419,9470,6680,6737,51,57,2135,0,2135,1.0,9445.45,6706.58,9445.34,6706.68,497
499,9088,9185,6684,6810,97,126,10001,612,9389,0.9388061193880612,9134.85,6750.32,9134.47,6750.59,498
500,6314,6545,6686,6940,231,254,39994,0,39994,1.0,6422.35,6809.78,6422.33,6809.96,499
501,9501,9552,6691,6745,51,54,1658,0,1658,1.0,9526.67,6715.09,9526.13,6715.47,500
502,5903,5965,6692,6813,62,121,4169,1012,3157,0.7572559366754618,5931.45,6747.39,5931.24,6746.71,501
503,9384,9457,6714,6820,73,106,4382,0,4382,1.0,9422.25,6762.55,9422.02,6763.34,502
504,8166,8415,6716,7043,249,327,55981,0,55981,1.0,8287.25,6866.55,8286.98,6866.79,503
505,9509,9627,6720,6861,118,141,9062,424,8638,0.9532112116530567,9562.35,6791.23,9562.19,6791.46,504
506,9449,9527,6725,6817,78,92,5359,0,5359,1.0,9488.63,6767.07,9488.33,6767.38,505
507,2248,3665,6740,8300,1417,1560,1031238,0,1031238,1.0,2930.83,7530.96,2930.66,7531.12,506
508,5941,6091,6746,6921,150,175,11756,2748,9008,0.7662470227968697,6010.33,6832.51,6009.65,6832.61,507
509,9591,9740,6746,6845,149,99,8704,0,8704,1.0,9671.51,6793.44,9671.25,6793.53,508
510,6077,6185,6757,6869,108,112,8104,0,8104,1.0,6127.44,6814.68,6127.25,6815.12,509
511,9339,9415,6759,6820,76,61,2056,252,1804,0.877431906614786,9380.94,6784.3,9380.49,6784.19,510
512,9329,9415,6776,6835,86,59,2505,0,2505,1.0,9366.4,6808.65,9366.6,6808.57,511
513,8403,8435,6786,6813,32,27,615,0,615,1.0,8418.09,6801.22,8417.91,6801.42,512
514,8780,8998,6791,6990,218,199,28177,0,28177,1.0,8876.34,6904.89,8876.64,6905.23,513
515,9410,9491,6794,6897,81,103,5402,1247,4155,0.7691595705294335,9450.76,6843.03,9450.75,6843.46,514
516,9256,9395,6805,6968,139,163,11753,1609,10144,0.863098783289373,9325.2,6908.06,9325.24,6907.75,515
517,8366,8626,6810,7027,260,217,39195,392,38803,0.9899987243270826,8492.59,6913.05,8492.54,6913.06,517
518,6449,6675,6811,7175,226,364,57455,130,57325,0.9977373596727874,6574.06,6988.69,6573.89,6988.91,516
519,9483,9547,6811,6908,64,97,3543,0,3543,1.0,9514.11,6856.01,9513.85,6856.74,518
520,6113,6390,6814,7057,277,243,39668,216,39452,0.9945548048805082,6261.9,6930.82,6261.9,6930.98,519
521,9331,9417,6814,6890,86,76,4306,0,4306,1.0,9369.67,6854.21,9369.24,6854.05,520
522,9546,9663,6815,6910,117,95,7155,804,6351,0.8876310272536687,9610.11,6862.04,9609.92,6862.15,521
523,6663,6820,6826,7073,157,247,28572,0,28572,1.0,6735.44,6949.26,6735.23,6949.42,523
524,6951,6980,6826,6860,29,34,622,0,622,1.0,6967.88,6842.98,6967.48,6843.1,522
525,8969,9291,6827,7100,322,273,55924,0,55924,1.0,9141.18,6959.82,9141.01,6959.84,525
526,9651,9753,6829,6958,102,129,8164,2813,5351,0.6554385105340519,9705.59,6885.89,9705.28,6886.33,524
527,3538,4073,6832,7614,535,782,234134,0,234134,1.0,3817.8,7247.51,3817.33,7247.52,526
528,5918,6026,6834,7045,108,211,12605,61,12544,0.9951606505355017,5975.89,6930.22,5975.79,6930.44,527
529,6771,7065,6846,7140,294,294,57885,0,57885,1.0,6931.99,7001.72,6931.69,7002.08,528
530,6053,6163,6855,6990,110,135,6920,2082,4838,0.6991329479768786,6100.67,6919.71,6100.77,6920.31,529
531,9443,9516,6865,6957,73,92,4109,103,4006,0.9749330737405695,9478.42,6912.37,9478.19,6913.07,530
532,7041,7511,6870,7298,470,428,132406,0,132406,1.0,7289.87,7075.95,7289.64,7076.14,531
533,9386,9450,6871,6926,64,55,2385,0,2385,1.0,9418.94,6898.71,9418.44,6898.71,532
534,9531,9590,6875,6940,59,65,2158,0,2158,1.0,9559.67,6908.26,9559.31,6908.3,533
535,1572,1877,6881,7300,305,419,66616,0,66616,1.0,1704.59,7039.46,1704.42,7040.22,535
536,9716,9772,6881,7013,56,132,4115,1929,2186,0.5312272174969623,9750.16,6952.73,9749.94,6951.73,534
537,7749,8203,6889,7345,454,456,120738,2658,118080,0.9779853898524077,7970.44,7103.23,7970.19,7103.26,536
538,8624,8845,6896,7128,221,232,33598,0,33598,1.0,8729.64,7013.01,8729.41,7013.0,537
539,9551,9657,6896,6985,106,89,5128,969,4159,0.8110374414976599,9605.95,6938.79,9605.56,6938.91,538
540,6016,6080,6904,7012,64,108,4428,265,4163,0.9401535682023487,6046.08,6957.75,6045.76,6957.53,539
541,9641,9701,6905,6980,60,75,2591,301,2290,0.8838286375916634,9671.54,6942.06,9671.22,6941.97,540
542,9499,9558,6906,6965,59,59,2332,0,2332,1.0,9526.57,6935.99,9526.38,6936.57,541
543,9388,9445,6911,6960,57,49,1718,0,1718,1.0,9413.76,6935.86,9414.2,6936.13,542
544,6357,6500,6934,7113,143,179,18386,0,18386,1.0,6427.09,7030.18,6426.79,7030.08,543
545,9371,9475,6944,7056,104,112,6847,0,6847,1.0,9429.95,6992.11,9430.03,6992.59,544
546,6113,6215,6946,7061,102,115,6021,6,6015,0.9990034877927254,6161.17,7002.58,6161.27,7002.69,545
547,6154,6192,6946,6985,38,39,943,0,943,1.0,6173.61,6965.02,6173.47,6964.83,546
548,9469,9541,6946,7058,72,112,4964,1602,3362,0.6772763900080581,9498.24,7003.75,9498.31,7004.57,547
549,9619,9685,6946,7011,66,65,2334,0,2334,1.0,9651.48,6979.64,9651.31,6979.32,548
550,8093,8515,6954,7380,422,426,115952,0,115952,1.0,8326.8,7167.12,8326.49,7167.28,549
551,9269,9620,6956,7238,351,282,49448,0,49448,1.0,9432.21,7107.64,9432.16,7107.99,551
552,9518,9575,6956,7041,57,85,3524,333,3191,0.9055051078320091,9544.13,6996.61,9544.01,6996.7,550
553,9661,9770,6957,7098,109,141,8626,1706,6920,0.8022258288894041,9719.73,7027.87,9719.65,7028.18,552
554,6054,6315,6966,7248,261,282,34510,0,34510,1.0,6153.57,7127.48,6153.89,7127.53,553
555,9600,9662,6975,7045,62,70,3057,702,2355,0.7703631010794897,9627.13,7014.25,9627.35,7014.17,554
556,8508,8724,6979,7275,216,296,43833,0,43833,1.0,8608.04,7136.75,8607.98,7136.87,555
557,9566,9600,6981,7040,34,59,1683,0,1683,1.0,9583.61,7008.63,9583.64,7008.78,556
558,8801,9000,6989,7175,199,186,25684,0,25684,1.0,8893.32,7067.83,8893.08,7067.74,558
559,5976,6077,6990,7176,101,186,11952,1,11951,0.9999163319946452,6027.71,7088.46,6027.3,7088.01,557
560,8474,8530,7014,7065,56,51,1628,0,1628,1.0,8502.51,7034.23,8502.3,7034.66,559
561,6199,6250,7021,7095,51,74,2514,0,2514,1.0,6226.12,7054.67,6225.85,7054.98,560
562,9413,9456,7021,7083,43,62,1933,0,1933,1.0,9433.26,7053.09,9433.0,7053.22,561
563,9588,9620,7031,7085,32,54,1254,0,1254,1.0,9601.51,7058.66,9601.5,7058.44,563
564,9537,9590,7033,7087,53,54,2178,0,2178,1.0,9563.89,7059.22,9563.33,7059.35,562
565,6245,6306,7039,7128,61,89,3827,0,3827,1.0,6273.73,7078.56,6273.48,7078.79,564
566,8996,9173,7039,7170,177,131,19065,0,19065,1.0,9082.28,7099.26,9082.17,7099.53,565
567,9614,9690,7041,7101,76,60,3456,807,2649,0.7664930555555556,9650.23,7070.27,9650.1,7070.36,566
568,6287,6400,7044,7175,113,131,9934,0,9934,1.0,6338.57,7109.15,6338.28,7109.36,567
569,6631,6842,7046,7185,211,139,22113,0,22113,1.0,6738.47,7122.73,6737.95,7123.36,568
570,9621,9732,7054,7160,111,106,5790,154,5636,0.9734024179620034,9680.17,7109.54,9679.95,7109.61,569
571,7046,7081,7075,7110,35,35,902,0,902,1.0,7061.44,7093.85,7061.27,7094.09,570
572,9056,9362,7076,7321,306,245,42955,728,42227,0.983052031195437,9224.66,7190.89,9224.45,7190.97,571
573,6203,6290,7080,7160,87,80,3608,0,3608,1.0,6240.78,7122.56,6240.75,7122.24,573
574,9568,9620,7080,7140,52,60,1822,478,1344,0.7376509330406147,9590.45,7109.3,9590.18,7109.23,572
575,9601,9631,7080,7125,30,45,846,0,846,1.0,9615.37,7101.67,9615.41,7101.58,574
576,9716,9805,7090,7250,89,160,10001,0,10001,1.0,9760.9,7163.54,9760.84,7163.72,575
577,7471,7823,7096,7460,352,364,91504,0,91504,1.0,7649.82,7288.59,7649.6,7288.69,576
578,6953,7182,7100,7330,229,230,30214,0,30214,1.0,7061.24,7210.44,7061.05,7210.74,577
579,8858,9094,7107,7356,236,249,41308,0,41308,1.0,8965.0,7230.14,8964.7,7230.19,580
580,3948,4490,7110,7735,542,625,208966,0,208966,1.0,4254.68,7421.35,4254.31,7421.44,578
581,6361,6640,7111,7240,279,129,23623,0,23623,1.0,6486.34,7177.87,6486.79,7178.41,579
582,6638,6970,7116,7335,332,219,29886,180,29706,0.9939771130295122,6863.15,7208.23,6861.92,7208.7,581
583,1703,2094,7121,7527,391,406,91895,950,90945,0.989662114369661,1893.06,7311.49,1892.79,7311.39,582
584,8713,8870,7124,7352,157,228,26765,0,26765,1.0,8784.96,7232.28,8784.8,7232.66,583
585,9608,9657,7132,7180,49,48,1436,0,1436,1.0,9629.39,7159.63,9629.25,7159.54,584
586,6956,7010,7134,7185,54,51,1482,0,1482,1.0,6977.52,7152.59,6977.55,7152.87,585
587,9656,9725,7136,7200,69,64,3119,1050,2069,0.6633536389868547,9690.08,7164.9,9689.97,7165.23,586
588,5926,6012,7146,7321,86,175,8102,0,8102,1.0,5970.05,7230.39,5969.6,7230.84,587
589,6008,6065,7151,7245,57,94,3511,44,3467,0.9874679578467673,6033.26,7193.88,6033.21,7193.96,588
590,6295,6415,7167,7288,120,121,9679,0,9679,1.0,6350.89,7228.49,6350.64,7228.78,589
591,9599,9698,7176,7257,99,81,5011,1386,3625,0.7234085012971463,9648.67,7214.96,9648.62,7215.17,590
592,1897,2687,7179,7840,790,661,321017,0,321017,1.0,2323.57,7501.19,2322.34,7501.59,591
593,9690,9730,7184,7237,40,53,1329,15,1314,0.9887133182844243,9708.22,7208.36,9708.62,7207.91,592
594,9301,9490,7186,7400,189,214,20754,405,20349,0.9804856895056374,9405.59,7294.68,9405.16,7294.77,593
595,9396,9657,7186,7485,261,299,40762,3274,37488,0.9196800942053873,9533.01,7339.09,9532.5,7339.28,594
596,7766,8225,7201,7688,459,487,139313,586,138727,0.9957936445270721,8007.08,7449.07,8006.7,7449.21,595
597,6128,6186,7204,7246,58,42,1349,0,1349,1.0,6157.93,7223.56,6157.4,7223.48,598
598,6168,6318,7204,7472,150,268,23535,0,23535,1.0,6252.96,7343.13,6252.77,7343.69,597
599,7061,7305,7205,7486,244,281,43129,3372,39757,0.9218159475063182,7182.66,7344.99,7182.56,7344.94,599
600,4768,5225,7206,7751,457,545,133598,0,133598,1.0,4987.25,7470.74,4987.42,7471.03,596
601,6046,6127,7206,7248,81,42,2463,0,2463,1.0,6083.11,7224.11,6083.38,7224.4,600
602,9559,9605,7206,7250,46,44,1379,0,1379,1.0,9581.59,7229.25,9581.4,7229.17,601
603,9698,9820,7211,7333,122,122,7536,1906,5630,0.7470806794055201,9759.49,7274.24,9758.85,7274.32,602
604,6630,6872,7219,7376,242,157,31316,153,31163,0.995114318559203,6752.02,7292.42,6751.85,7292.61,603
605,6124,6180,7226,7286,56,60,2059,0,2059,1.0,6153.16,7256.31,6153.17,7256.71,604
606,8474,8785,7226,7530,311,304,50731,0,50731,1.0,8635.74,7358.41,8635.51,7358.72,606
607,6392,6640,7229,7390,248,161,25481,309,25172,0.9878733173737294,6497.28,7290.72,6496.36,7291.52,607
608,6023,6135,7230,7297,112,67,4206,522,3684,0.8758915834522111,6072.0,7259.76,6071.65,7260.06,605
609,6171,6227,7234,7315,56,81,3064,0,3064,1.0,6200.27,7275.74,6200.14,7275.92,608
610,5993,6025,7236,7288,32,52,1198,85,1113,0.9290484140233722,6009.17,7261.45,6009.05,7261.66,609
611,9087,9301,7239,7393,214,154,20328,0,20328,1.0,9204.33,7314.18,9204.02,7314.4,610
612,9648,9715,7239,7307,67,68,3215,0,3215,1.0,9683.14,7272.41,9682.89,7272.58,611
613,7237,7505,7266,7683,268,417,77294,0,77294,1.0,7382.37,7473.46,7382.29,7473.85,612
614,6101,6151,7267,7320,50,53,1728,0,1728,1.0,6125.66,7290.81,6125.53,7290.88,613
615,6299,6395,7269,7380,96,111,6545,0,6545,1.0,6345.1,7318.04,6344.88,7318.42,614
616,5936,6051,7273,7470,115,197,15855,4203,11652,0.7349101229895932,5990.07,7369.03,5990.06,7369.23,615
617,7296,7330,7274,7300,34,26,579,0,579,1.0,7309.59,7284.74,7310.21,7285.17,616
618,6034,6105,7279,7331,71,52,2679,0,2679,1.0,6069.62,7301.51,6069.51,7301.68,617
619,6708,7132,7285,7638,424,353,76383,237,76146,0.9968972153489651,6970.63,7455.26,6970.07,7455.53,620
620,6141,6195,7286,7337,54,51,1588,246,1342,0.845088161209068,6168.65,7309.01,6168.83,7309.24,619
621,9638,9695,7286,7335,57,49,1686,621,1065,0.6316725978647687,9662.07,7310.53,9662.28,7310.77,618
622,9684,9783,7294,7369,99,75,4609,0,4609,1.0,9727.75,7331.22,9727.8,7331.46,621
623,6489,6707,7300,7445,218,145,19049,0,19049,1.0,6582.15,7364.11,6581.92,7364.23,622
624,8771,8957,7305,7498,186,193,24689,0,24689,1.0,8861.69,7401.06,8861.59,7401.2,623
625,6051,6145,7307,7385,94,78,5270,0,5270,1.0,6096.5,7348.88,6096.9,7348.97,624
626,8927,9185,7309,7586,258,277,44957,0,44957,1.0,9037.12,7436.4,9036.98,7436.38,625
627,6135,6182,7312,7373,47,61,1734,0,1734,1.0,6158.08,7342.26,6157.66,7342.02,626
628,8183,8524,7319,7672,341,353,85438,0,85438,1.0,8358.56,7487.3,8358.03,7486.85,627
629,9766,9880,7319,7470,114,151,9222,4214,5008,0.5430492301019302,9818.75,7395.47,9818.78,7395.93,628
630,9654,9719,7329,7435,65,106,4123,0,4123,1.0,9680.38,7384.6,9680.3,7384.18,629
631,9171,9403,7331,7526,232,195,30396,1374,29022,0.9547966837741808,9304.45,7429.08,9304.24,7429.25,630
632,6281,6335,7340,7405,54,65,1984,0,1984,1.0,6308.8,7370.72,6309.06,7370.72,631
633,6331,6521,7345,7485,190,140,15646,0,15646,1.0,6413.2,7417.17,6413.68,7417.47,632
634,9703,9777,7354,7408,74,54,3142,0,3142,1.0,9739.63,7379.61,9739.79,7379.71,633
635,6123,6167,7362,7420,44,58,1641,0,1641,1.0,6141.37,7391.56,6142.0,7391.44,634
636,6032,6128,7377,7459,96,82,5647,0,5647,1.0,6080.05,7414.91,6079.9,7415.08,636
637,6149,6179,7379,7435,30,56,1030,0,1030,1.0,6165.33,7407.51,6165.05,7408.3,635
638,8521,8620,7381,7480,99,99,7216,0,7216,1.0,8575.96,7429.9,8575.57,7430.01,637
639,6558,6747,7389,7545,189,156,24539,0,24539,1.0,6654.1,7470.86,6653.66,7470.65,638
640,9458,9678,7394,7527,220,133,18472,389,18083,0.9789411000433088,9571.15,7462.22,9570.97,7462.18,639
641,9641,9810,7401,7564,169,163,15129,2388,12741,0.8421574459647035,9728.68,7473.9,9728.28,7474.29,640
642,7423,8245,7404,8541,822,1137,541282,0,541282,1.0,7831.51,7955.17,7831.48,7955.82,641
643,6313,6347,7406,7448,34,42,1140,0,1140,1.0,6328.08,7428.11,6327.91,7428.34,642
644,5928,6110,7419,7601,182,182,18836,2050,16786,0.8911658526226375,6019.03,7516.56,6018.61,7516.68,644
645,6114,6180,7420,7485,66,65,2875,688,2187,0.760695652173913,6146.37,7451.87,6145.86,7452.09,643
646,6170,6210,7424,7465,40,41,1271,0,1271,1.0,6189.64,7443.52,6189.17,7443.81,645
647,6210,6250,7424,7453,40,29,922,0,922,1.0,6228.45,7437.89,6228.43,7437.87,646
648,6731,6872,7424,7545,141,121,14796,0,14796,1.0,6802.07,7481.91,6801.59,7481.95,647
649,9819,9977,7430,7571,158,141,8714,0,8714,1.0,9910.76,7498.39,9910.25,7498.58,648
650,8723,8800,7436,7531,77,95,3219,0,3219,1.0,8750.98,7478.31,8751.06,7478.24,650
651,9046,9277,7436,7650,231,214,34095,707,33388,0.9792638216747324,9170.43,7550.9,9170.34,7550.91,651
652,8409,8776,7439,7790,367,351,70532,0,70532,1.0,8605.2,7621.52,8604.63,7621.71,649
653,6482,6580,7444,7613,98,169,10909,0,10909,1.0,6527.84,7521.78,6527.61,7522.38,653
654,6063,6122,7445,7498,59,53,2049,0,2049,1.0,6093.88,7469.87,6093.43,7470.27,652
655,6199,6260,7445,7486,61,41,1608,0,1608,1.0,6229.56,7466.39,6229.09,7466.2,654
656,7746,7782,7446,7485,36,39,966,0,966,1.0,7767.56,7466.92,7766.58,7466.48,656
657,6304,6411,7447,7600,107,153,8670,0,8670,1.0,6357.61,7519.57,6357.39,7519.95,655
658,7069,7301,7449,7763,232,314,43573,189,43384,0.9956624515181419,7199.02,7604.53,7198.78,7604.87,657
659,6388,6496,7451,7533,108,82,5275,0,5275,1.0,6442.5,7492.44,6441.94,7492.39,658
660,8733,8971,7461,7703,238,242,38848,0,38848,1.0,8846.88,7581.35,8846.64,7581.38,660
661,6165,6211,7465,7522,46,57,1766,0,1766,1.0,6188.37,7491.15,6188.04,7491.04,663
662,3518,4282,7466,8063,764,597,242294,0,242294,1.0,3971.72,7765.86,3970.92,7765.62,659
663,6221,6290,7466,7557,69,91,4075,0,4075,1.0,6259.91,7510.37,6259.52,7510.62,664
664,6256,6337,7466,7585,81,119,4843,0,4843,1.0,6301.86,7532.79,6301.47,7532.46,662
665,9806,9921,7470,7643,115,173,11164,0,11164,1.0,9868.41,7557.62,9867.96,7557.77,665
666,6099,6170,7475,7540,71,65,3018,0,3018,1.0,6132.57,7504.54,6132.15,7504.83,666
667,9268,9489,7476,7635,221,159,23556,516,23040,0.97809475292919,9387.29,7557.89,9387.09,7558.1,667
668,6189,6235,7486,7550,46,64,1825,16,1809,0.9912328767123287,6214.37,7516.87,6213.78,7517.59,668
669,9783,9842,7499,7638,59,139,6344,0,6344,1.0,9813.56,7566.75,9812.87,7566.87,669
670,9431,9682,7501,7691,251,190,19177,64,19113,0.9966626688220264,9552.4,7583.41,9551.92,7583.58,670
671,6136,6190,7509,7560,54,51,1697,0,1697,1.0,6166.15,7535.33,6165.59,7535.12,672
672,6378,6500,7509,7615,122,106,8010,0,8010,1.0,6441.82,7566.94,6441.69,7567.0,671
673,9461,9795,7511,7782,334,271,43093,3838,39255,0.9109368110830065,9654.91,7657.15,9654.83,7656.89,673
674,9486,9530,7523,7580,44,57,1898,4,1894,0.9978925184404637,9504.96,7551.48,9505.12,7551.0,677
675,6083,6165,7531,7610,82,79,3565,506,3059,0.8580645161290322,6124.38,7567.48,6124.45,7567.88,678
676,8068,8290,7531,7752,222,221,26048,0,26048,1.0,8176.49,7640.58,8176.75,7640.63,679
677,6598,6794,7538,7838,196,300,34778,0,34778,1.0,6699.65,7705.94,6699.28,7705.92,680
678,6758,6971,7540,7702,213,162,21173,0,21173,1.0,6866.04,7612.22,6865.85,7612.34,684
679,6161,6210,7541,7592,49,51,1384,0,1384,1.0,6186.78,7565.17,6186.53,7565.42,682
680,6189,6288,7541,7671,99,130,7918,0,7918,1.0,6236.27,7604.95,6236.28,7605.07,683
681,6536,6727,7541,7705,191,164,19970,0,19970,1.0,6618.02,7609.13,6618.05,7609.17,681
682,9756,9790,7554,7605,34,51,1345,0,1345,1.0,9774.07,7578.73,9773.89,7579.49,685
683,5961,6087,7561,7743,126,182,14797,0,14797,1.0,6021.6,7661.23,6021.79,7661.72,687
684,9884,10015,7561,7705,131,144,11572,3236,8336,0.7203594884203249,9956.98,7637.63,9956.73,7637.81,686
685,6271,6355,7566,7651,84,85,4488,0,4488,1.0,6313.34,7609.32,6312.89,7609.33,688
686,8912,9235,7567,7847,323,280,53197,0,53197,1.0,9044.86,7705.55,9044.63,7705.3,689
687,6136,6197,7576,7640,61,64,2305,0,2305,1.0,6169.98,7608.51,6169.77,7608.7,690
688,6048,6125,7579,7640,77,61,3045,0,3045,1.0,6083.86,7606.92,6083.72,7606.96,691
689,6321,6391,7590,7715,70,125,5336,0,5336,1.0,6361.14,7658.17,6360.99,7658.31,693
690,6436,6743,7590,8013,307,423,48137,0,48137,1.0,6565.18,7807.72,6565.27,7808.54,692
691,6366,6442,7606,7755,76,149,7325,0,7325,1.0,6407.34,7680.48,6407.09,7680.85,694
692,6073,6170,7609,7723,97,114,7747,1862,5885,0.759648896346973,6120.8,7665.54,6120.74,7665.44,696
693,4468,5365,7610,8325,897,715,336326,3413,332913,0.9898521077763837,4858.54,7940.32,4858.71,7940.58,695
694,6853,7143,7614,7905,290,291,48616,0,48616,1.0,7003.52,7756.24,7002.96,7756.81,697
695,9205,9471,7616,7825,266,209,37529,0,37529,1.0,9346.55,7706.16,9346.49,7706.54,698
696,7266,7517,7620,7975,251,355,56352,556,55796,0.9901334469051675,7397.39,7789.18,7397.38,7789.19,699
697,9713,9842,7624,7805,129,181,12745,1843,10902,0.8553942722636328,9790.47,7704.26,9790.06,7704.65,700
698,6269,6334,7631,7683,65,52,2350,409,1941,0.8259574468085107,6303.72,7657.86,6303.96,7657.82,701
699,6166,6222,7634,7713,56,79,3226,0,3226,1.0,6194.38,7672.75,6194.1,7672.74,702
700,9828,9925,7639,7735,97,96,6903,0,6903,1.0,9876.05,7684.2,9875.83,7684.46,703
701,6744,6917,7644,7845,173,201,22024,0,22024,1.0,6828.31,7751.5,6827.99,7751.29,705
702,3651,5505,7645,9160,1854,1515,1321559,0,1321559,1.0,4555.37,8482.28,4555.58,8482.47,706
703,8131,8500,7649,8110,369,461,100079,0,100079,1.0,8318.08,7847.3,8317.88,7847.61,707
704,1896,2635,7651,8675,739,1024,306831,0,306831,1.0,2227.52,8138.38,2227.92,8139.34,704
705,2831,3907,7656,8438,1076,782,541696,0,541696,1.0,3355.58,8055.69,3355.27,8055.96,708
706,6218,6271,7656,7722,53,66,2446,0,2446,1.0,6241.2,7686.7,6241.29,7687.03,709
707,8711,8925,7660,7916,214,256,35457,0,35457,1.0,8814.13,7788.09,8813.83,7788.12,710
708,6264,6335,7675,7735,71,60,2587,0,2587,1.0,6300.87,7703.0,6300.28,7702.79,711
709,6079,6193,7686,7763,114,77,3746,0,3746,1.0,6138.5,7724.44,6138.0,7724.45,712
710,9898,10082,7689,7840,184,151,17855,6567,11288,0.6322038644637357,9988.49,7764.42,9987.62,7764.66,713
711,8491,8745,7694,7955,254,261,40295,0,40295,1.0,8605.57,7823.89,8605.55,7824.03,714
712,7069,7315,7696,7957,246,261,36861,0,36861,1.0,7199.01,7840.61,7199.02,7840.94,715
713,6236,6313,7700,7787,77,87,4071,0,4071,1.0,6270.68,7744.89,6270.81,7744.93,716
714,9448,9570,7704,7855,122,151,11958,0,11958,1.0,9516.8,7773.68,9516.25,7773.59,717
715,6169,6242,7710,7803,73,93,4644,0,4644,1.0,6208.08,7753.78,6207.9,7753.72,718
716,6311,6365,7712,7780,54,68,1984,0,1984,1.0,6339.72,7747.89,6338.83,7747.4,719
717,6346,6372,7714,7750,26,36,698,0,698,1.0,6359.44,7728.87,6359.64,7729.22,720
718,9828,9910,7715,7787,82,72,3938,1630,2308,0.5860843067546978,9867.85,7753.86,9865.33,7751.46,721
719,6319,6500,7717,7882,181,165,16501,26,16475,0.998424337918914,6417.41,7805.79,6416.69,7805.77,722
720,9566,9670,7729,7850,104,121,9079,0,9079,1.0,9613.19,7789.31,9613.01,7789.34,723
721,5963,6126,7731,7845,163,114,13953,0,13953,1.0,6037.9,7791.74,6038.13,7792.17,724
722,6102,6182,7739,7816,80,77,4333,634,3699,0.8536810523886453,6140.03,7774.93,6140.39,7775.04,725
723,9054,9218,7741,7990,164,249,26970,0,26970,1.0,9146.22,7850.69,9145.77,7850.94,726
724,6299,6335,7748,7786,36,38,806,0,806,1.0,6317.66,7767.47,6316.94,7767.59,727
725,9734,9831,7749,7890,97,141,6889,0,6889,1.0,9778.08,7820.32,9777.81,7820.43,728
726,9186,9385,7759,7995,199,236,34718,0,34718,1.0,9286.02,7876.85,9285.79,7877.03,729
727,6266,6317,7770,7870,51,100,3342,0,3342,1.0,6292.56,7821.66,6292.27,7822.02,730
728,9638,9747,7771,7875,109,104,7539,87,7452,0.9884600079586152,9696.48,7822.2,9696.08,7822.58,731
729,6206,6282,7775,7836,76,61,3209,0,3209,1.0,6245.1,7807.22,6245.17,7807.25,733
730,6308,6365,7776,7871,57,95,2583,0,2583,1.0,6332.92,7813.92,6332.47,7813.96,732
731,9803,9912,7781,7893,109,112,7799,3029,4770,0.6116168739581997,9854.87,7830.04,9855.36,7829.86,734
732,6109,6242,7785,7945,133,160,11837,1298,10539,0.8903438371208922,6174.71,7862.65,6175.18,7863.34,735
733,9374,9535,7788,7981,161,193,22232,721,21511,0.9675692695214105,9452.2,7887.21,9451.97,7887.21,736
734,9889,9966,7801,7868,77,67,3119,0,3119,1.0,9925.22,7833.01,9925.18,7832.33,737
735,8828,8986,7806,8159,158,353,37488,0,37488,1.0,8897.87,7978.44,8897.66,7978.38,738
736,9979,10125,7809,7971,146,162,15214,817,14397,0.9462994610227422,10054.69,7884.42,10054.31,7884.56,740
737,6628,6812,7810,7930,184,120,13321,0,13321,1.0,6715.14,7869.6,6715.24,7869.66,739
738,6731,6880,7821,7960,149,139,10323,0,10323,1.0,6811.43,7901.29,6811.18,7901.58,741
739,8958,9138,7824,8060,180,236,27620,0,27620,1.0,9030.86,7952.51,9030.7,7952.53,743
740,9869,9992,7825,7940,123,115,8453,4011,4442,0.5254939074884656,9937.91,7885.07,9937.66,7884.97,742
741,6362,6585,7826,7987,223,161,16090,2131,13959,0.8675574891236792,6483.74,7899.28,6482.88,7899.38,744
742,6223,6265,7829,7889,42,60,1786,0,1786,1.0,6244.06,7855.07,6243.98,7853.78,745
743,9526,9655,7830,7965,129,135,13322,0,13322,1.0,9589.8,7898.74,9589.68,7898.78,746
744,5958,6140,7839,7977,182,138,17568,0,17568,1.0,6042.57,7897.19,6042.36,7897.42,747
745,9701,9897,7841,8060,196,219,19681,1692,17989,0.9140287587012855,9780.15,7956.02,9779.8,7956.13,748
746,6978,7164,7844,8095,186,251,29164,521,28643,0.9821355095323001,7066.98,7957.03,7067.09,7957.47,749
747,8481,8525,7854,7903,44,49,1402,0,1402,1.0,8501.64,7880.83,8501.65,7880.79,750
748,6209,6366,7859,8020,157,161,16177,1231,14946,0.9239043085862645,6292.86,7936.26,6292.57,7936.52,751
749,6816,6982,7864,8020,166,156,16785,0,16785,1.0,6907.4,7946.99,6907.42,7947.08,752
750,9651,9735,7864,7950,84,86,5568,83,5485,0.9850933908045977,9693.78,7906.29,9693.72,7906.41,753
751,7273,7425,7879,8116,152,237,23599,0,23599,1.0,7347.61,8003.49,7347.38,8003.48,754
752,9821,9907,7885,7953,86,68,3714,0,3714,1.0,9862.01,7919.4,9861.98,7919.61,755
753,6358,6445,7890,7958,87,68,3712,0,3712,1.0,6395.59,7925.16,6395.48,7925.42,756
754,8613,8832,7891,8110,219,219,38048,0,38048,1.0,8734.9,8009.7,8734.59,8009.71,757
755,8341,8637,7894,8140,296,246,49078,0,49078,1.0,8495.66,8015.44,8495.65,8015.56,758
756,6183,6227,7899,7960,44,61,1879,0,1879,1.0,6201.58,7925.45,6201.54,7926.09,759
757,9885,10061,7915,8105,176,190,21554,5605,15949,0.7399554607033497,9973.18,8003.74,9972.92,8003.82,760
758,6013,6235,7926,8090,222,164,23435,1123,22312,0.9520802218903349,6127.54,8002.73,6127.39,8002.76,761
759,9606,9732,7927,8030,126,103,7741,0,7741,1.0,9669.58,7978.59,9669.4,7978.41,762
760,9403,9795,7931,8285,392,354,63133,4341,58792,0.9312403972565853,9570.85,8109.27,9570.61,8109.54,763
761,9331,9470,7935,8152,139,217,18147,2642,15505,0.8544111974431036,9400.9,8038.07,9400.87,8038.44,764
762,7101,7292,7936,8248,191,312,39187,0,39187,1.0,7208.51,8087.16,7208.27,8087.67,765
763,6329,6397,7945,8027,68,82,3124,0,3124,1.0,6362.43,7990.84,6362.55,7990.84,766
764,6666,6940,7946,8180,274,234,39919,0,39919,1.0,6804.92,8063.3,6804.58,8063.22,767
765,7271,7305,7946,7982,34,36,811,0,811,1.0,7289.66,7962.92,7289.56,7963.26,768
766,6373,6445,7949,7998,72,49,2442,0,2442,1.0,6410.63,7970.88,6410.11,7971.16,769
767,6381,6576,7949,8075,195,126,14014,0,14014,1.0,6493.58,8003.78,6493.11,8004.03,770
768,9127,9235,7956,8098,108,142,11401,0,11401,1.0,9181.55,8029.5,9181.63,8029.47,771
769,1723,1905,7974,8160,182,186,17842,0,17842,1.0,1816.58,8064.16,1816.56,8064.28,773
770,6923,7050,7974,8158,127,184,16229,0,16229,1.0,6983.49,8066.18,6983.3,8066.32,772
771,9211,9377,7976,8155,166,179,19826,0,19826,1.0,9292.84,8067.76,9293.09,8068.1,774
772,6223,6291,7981,8058,68,77,2859,0,2859,1.0,6254.44,8024.14,6254.67,8025.06,775
773,9751,9890,7984,8105,139,121,7078,2,7076,0.9997174343034756,9814.85,8037.2,9814.97,8037.28,776
774,6535,6867,8001,8438,332,437,56142,2056,54086,0.9633785757543372,6694.62,8220.75,6694.2,8220.96,777
775,6280,6325,8009,8055,45,46,1478,0,1478,1.0,6300.97,8027.41,6301.13,8028.6,778
776,8928,9151,8009,8147,223,138,17619,0,17619,1.0,9052.52,8085.08,9052.26,8085.13,779
777,6314,6365,8010,8070,51,60,1751,0,1751,1.0,6336.05,8040.34,6336.01,8040.18,780
778,9811,9922,8016,8116,111,100,7813,0,7813,1.0,9870.46,8069.3,9870.36,8069.53,782
779,9467,9480,8017,8030,13,13,125,0,125,1.0,0.0,0.0,9473.1,8023.3,0
780,6340,6422,8021,8127,82,106,5469,0,5469,1.0,6381.21,8074.76,6380.88,8074.94,783
781,9451,9548,8030,8145,97,115,5304,0,5304,1.0,9494.05,8088.15,9494.55,8089.64,781
782,7391,7447,8031,8093,56,62,2003,0,2003,1.0,7419.63,8063.89,7419.23,8064.42,784
783,6403,6537,8034,8135,134,101,8125,0,8125,1.0,6471.97,8078.46,6471.89,8078.74,785
784,6189,6257,8035,8104,68,69,2695,0,2695,1.0,6220.3,8068.66,6219.9,8069.43,786
785,6265,6347,8054,8140,82,86,4644,0,4644,1.0,6307.14,8092.0,6307.16,8092.16,787
786,6086,6135,8059,8115,49,56,1841,0,1841,1.0,6109.79,8084.57,6109.59,8084.41,789
787,6203,6282,8059,8150,79,91,3504,0,3504,1.0,6247.15,8105.62,6247.22,8105.84,788
788,8196,8430,8061,8235,234,174,21810,0,21810,1.0,8313.78,8152.42,8313.57,8152.58,790
789,7263,7517,8073,8377,254,304,45074,0,45074,1.0,7400.75,8216.58,7400.55,8216.78,792
790,6129,6197,8074,8135,68,61,2442,0,2442,1.0,6163.44,8100.53,6162.82,8101.36,791
791,8511,8671,8076,8210,160,134,13902,0,13902,1.0,8592.23,8142.6,8592.06,8142.88,793
792,7007,7170,8079,8233,163,154,17009,0,17009,1.0,7091.98,8159.2,7091.69,8159.55,794
793,9809,10007,8081,8268,198,187,21960,8847,13113,0.5971311475409836,9924.28,8174.93,9923.98,8175.02,795
794,8236,8273,8087,8125,37,38,923,0,923,1.0,8251.96,8108.34,8252.01,8107.92,796
795,7276,7326,8089,8139,50,50,1526,0,1526,1.0,7301.21,8114.23,7300.27,8113.85,797
796,9094,9390,8092,8298,296,206,27664,802,26862,0.9710092539039907,9252.76,8179.72,9252.44,8180.04,798
797,6398,6495,8097,8182,97,85,4473,0,4473,1.0,6435.82,8136.37,6435.63,8136.58,800
798,9703,9831,8097,8200,128,103,8958,0,8958,1.0,9769.44,8153.12,9769.31,8152.88,801
799,6467,6557,8100,8253,90,153,8541,837,7704,0.9020021074815595,6509.67,8182.14,6509.86,8182.0,802
800,6138,6235,8101,8217,97,116,6657,0,6657,1.0,6187.97,8160.29,6187.62,8160.22,799
801,8638,8852,8101,8220,214,119,15065,0,15065,1.0,8727.43,8152.64,8727.65,8153.01,803
802,6321,6400,8105,8193,79,88,4830,0,4830,1.0,6362.98,8149.22,6362.69,8149.34,804
803,6106,6153,8110,8195,47,85,2523,0,2523,1.0,6127.89,8149.46,6127.44,8149.88,805
804,9823,9890,8114,8163,67,49,2436,0,2436,1.0,9854.69,8134.73,9853.93,8135.27,806
805,8858,9015,8119,8288,157,169,18671,0,18671,1.0,8932.8,8204.27,8932.57,8204.47,807
806,6201,6343,8125,8270,142,145,13701,3183,10518,0.7676811911539304,6274.33,8197.29,6274.06,8197.37,808
807,6741,6880,8129,8245,139,116,10280,0,10280,1.0,6804.82,8187.79,6804.77,8187.76,809
808,8369,8555,8131,8288,186,157,21230,240,20990,0.988695242581253,8460.18,8208.79,8459.93,8208.95,810
809,8983,9121,8131,8265,138,134,13908,0,13908,1.0,9050.16,8193.94,9049.77,8193.87,811
810,6584,6670,8134,8250,86,116,6360,0,6360,1.0,6630.68,8189.52,6630.24,8189.54,812
811,7478,7826,8137,8387,348,250,53218,0,53218,1.0,7631.56,8278.01,7631.27,8277.87,813
812,6859,7066,8141,8315,207,174,24578,0,24578,1.0,6955.2,8227.24,6954.78,8227.35,814
813,9381,9430,8146,8200,49,54,1845,0,1845,1.0,9403.71,8173.2,9403.44,8173.47,815
814,6518,6577,8150,8195,59,45,1846,722,1124,0.6088840736728061,6547.88,8173.06,6547.96,8173.32,816
815,6419,6496,8154,8375,77,221,9961,0,9961,1.0,6456.56,8269.14,6456.17,8269.01,817
816,8686,8868,8158,8362,182,204,25742,0,25742,1.0,8782.46,8254.85,8782.22,8255.85,818
817,9633,9721,8164,8245,88,81,5106,0,5106,1.0,9680.15,8201.41,9680.03,8201.59,819
818,6379,6425,8173,8226,46,53,1508,0,1508,1.0,6404.76,8197.77,6404.64,8197.92,820
819,6086,6125,8181,8275,39,94,2547,1570,977,0.38358853553199845,6105.31,8227.28,6105.14,8227.68,821
820,3009,3786,8186,8890,777,704,202137,0,202137,1.0,3388.27,8541.25,3388.22,8540.77,822
821,6336,6411,8186,8265,75,79,3725,0,3725,1.0,6372.56,8226.02,6372.41,8225.5,824
822,9106,9343,8186,8388,237,202,25954,0,25954,1.0,9226.12,8288.28,9225.79,8288.32,823
823,6119,6250,8189,8330,131,141,10864,76,10788,0.9930044182621502,6170.53,8258.66,6171.07,8259.14,826
824,9719,9836,8189,8280,117,91,6456,0,6456,1.0,9773.87,8227.81,9773.91,8227.76,825
825,6546,6592,8191,8235,46,44,1609,0,1609,1.0,6566.86,8213.21,6567.12,8213.22,827
826,9556,9634,8194,8265,78,71,3499,1353,2146,0.6133180908831095,9596.39,8224.97,9596.14,8225.55,828
827,8156,8240,8196,8300,84,104,6061,0,6061,1.0,8196.07,8250.36,8195.89,8250.57,829
828,9337,9425,8201,8310,88,109,6038,403,5635,0.9332560450480292,9379.4,8258.3,9379.01,8258.65,830
829,8504,8710,8203,8337,206,134,19408,92,19316,0.9952596867271228,8606.96,8267.36,8606.7,8267.65,831
830,8228,8410,8206,8390,182,184,23170,0,23170,1.0,8308.05,8292.49,8307.98,8292.86,832
831,6276,6375,8224,8293,99,69,3665,114,3551,0.9688949522510232,6329.47,8261.6,6329.26,8262.15,833
832,6399,6450,8225,8291,51,66,2043,0,2043,1.0,6424.47,8260.25,6424.18,8259.83,835
833,6581,6656,8225,8290,75,65,2812,0,2812,1.0,6615.53,8259.9,6615.56,8260.17,834
834,9771,9920,8229,8320,149,91,8204,1963,6241,0.7607264748902974,9851.05,8270.73,9851.04,8270.79,837
835,7146,7378,8230,8411,232,181,25845,0,25845,1.0,7273.06,8315.5,7272.82,8315.65,839
836,6548,6590,8231,8265,42,34,1037,0,1037,1.0,6571.32,8247.45,6570.19,8247.2,836
837,7010,7217,8231,8435,207,204,29551,0,29551,1.0,7113.64,8334.3,7113.68,8334.68,838
838,6483,6610,8239,8350,127,111,8054,0,8054,1.0,6550.07,8291.3,6549.48,8291.45,840
839,9510,9597,8240,8320,87,80,4333,0,4333,1.0,9552.72,8277.62,9552.31,8277.92,841
840,8936,9201,8241,8583,265,342,54086,0,54086,1.0,9063.93,8391.67,9063.83,8391.84,842
841,9390,9515,8251,8333,125,82,6337,2461,3876,0.6116458892220293,9448.63,8292.52,9448.49,8292.6,843
842,8819,8940,8254,8423,121,169,13991,0,13991,1.0,8884.88,8339.72,8884.69,8339.85,844
843,6362,6425,8264,8337,63,73,2978,0,2978,1.0,6395.24,8298.56,6395.01,8298.23,846
844,9536,9617,8265,8365,81,100,4202,0,4202,1.0,9585.06,8317.38,9585.05,8317.37,845
845,6244,6286,8266,8310,42,44,1054,0,1054,1.0,6264.79,8284.71,6265.21,8285.31,847
846,8098,8136,8270,8303,38,33,750,0,750,1.0,8115.99,8288.25,8116.25,8288.25,848
847,6813,6940,8273,8425,127,152,13312,0,13312,1.0,6871.41,8347.51,6871.15,8347.57,849
848,6596,6695,8276,8380,99,104,6313,0,6313,1.0,6648.29,8326.44,6648.42,8326.68,851
849,2458,3215,8279,8840,757,561,230768,0,230768,1.0,2824.85,8525.02,2824.73,8525.2,853
850,6208,6325,8279,8445,117,166,10283,1623,8660,0.8421666828746475,6261.52,8361.04,6261.55,8361.63,850
851,6276,6405,8281,8397,129,116,10214,0,10214,1.0,6337.92,8337.41,6338.1,8337.76,852
852,8320,8538,8284,8462,218,178,25580,271,25309,0.9894057857701329,8431.47,8369.26,8431.18,8369.35,854
853,8039,8235,8286,8435,196,149,19209,0,19209,1.0,8141.71,8354.98,8141.22,8355.32,855
854,6918,7070,8294,8461,152,167,16237,0,16237,1.0,6986.98,8385.65,6987.09,8385.61,857
855,6436,6660,8295,8425,224,130,13695,0,13695,1.0,6544.61,8371.15,6544.51,8371.43,856
856,9483,9577,8300,8435,94,135,6134,0,6134,1.0,9536.27,8367.06,9535.82,8367.2,859
857,8629,8760,8301,8445,131,144,11530,0,11530,1.0,8695.75,8370.68,8695.45,8370.79,858
858,9331,9398,8309,8382,67,73,3217,1257,1960,0.6092632887783649,9360.49,8338.99,9360.22,8339.39,860
859,7765,7840,8310,8427,75,117,4776,0,4776,1.0,7802.13,8365.38,7801.83,8365.76,861
860,8013,8062,8319,8382,49,63,2165,0,2165,1.0,8039.58,8348.33,8039.38,8348.47,863
861,9354,9488,8319,8422,134,103,6474,14,6460,0.9978375038616002,9411.45,8366.03,9411.6,8366.32,864
862,9571,9680,8320,8455,109,135,7698,11,7687,0.9985710574175111,9620.38,8378.8,9619.97,8379.47,862
863,6153,6222,8321,8380,69,59,2483,0,2483,1.0,6191.23,8346.01,6190.42,8345.85,865
864,6401,6445,8327,8378,44,51,1588,0,1588,1.0,6421.84,8352.92,6421.76,8352.63,866
865,8489,8705,8329,8557,216,228,32613,1291,31322,0.9604145586115966,8597.35,8443.56,8597.11,8443.69,867
866,9418,9530,8338,8460,112,122,8650,0,8650,1.0,9480.8,8397.82,9480.45,8397.9,869
867,8744,8857,8340,8475,113,135,9585,0,9585,1.0,8798.62,8408.57,8798.71,8408.6,868
868,7339,7605,8344,8605,266,261,40837,0,40837,1.0,7463.77,8472.16,7463.69,8472.3,870
869,7534,7799,8364,8575,265,211,36432,0,36432,1.0,7676.1,8455.72,7675.59,8455.79,871
870,9179,9228,8365,8415,49,50,1441,0,1441,1.0,9206.4,8386.38,9206.81,8386.51,873
871,2986,3172,8366,8463,186,97,11258,0,11258,1.0,3076.33,8415.58,3076.23,8415.73,872
872,9303,9355,8366,8437,52,71,2248,801,1447,0.6436832740213523,9325.77,8398.56,9325.5,8399.07,874
873,8131,8335,8369,8556,204,187,23562,651,22911,0.9723707664884136,8229.09,8455.6,8229.07,8455.74,875
874,6353,6458,8371,8452,105,81,5404,0,5404,1.0,6402.84,8410.88,6402.6,8410.73,877
875,9199,9322,8371,8505,123,134,10437,0,10437,1.0,9262.73,8438.42,9262.65,8438.67,876
876,7511,7550,8376,8427,39,51,1283,0,1283,1.0,7531.62,8398.2,7531.54,8398.23,878
877,8906,9028,8379,8715,122,336,16065,0,16065,1.0,8969.71,8542.68,8969.31,8542.14,880
878,6608,6865,8380,8508,257,128,18051,0,18051,1.0,6756.47,8452.18,6755.62,8452.42,879
879,9148,9220,8385,8462,72,77,3772,832,2940,0.7794273594909862,9181.43,8423.34,9181.21,8422.8,881
880,8036,8061,8390,8428,25,38,682,0,682,1.0,8045.74,8409.27,8045.48,8409.63,882
881,6318,6360,8391,8428,42,37,1070,0,1070,1.0,6338.6,8407.95,6338.43,8408.15,883
882,7186,7370,8394,8559,184,165,20789,0,20789,1.0,7283.54,8468.78,7283.06,8468.71,884
883,6596,6655,8396,8434,59,38,1639,0,1639,1.0,6623.04,8412.33,6623.49,8412.6,885
884,6414,6487,8398,8475,73,77,3660,0,3660,1.0,6454.38,8440.89,6453.98,8440.96,886
885,9316,9368,8400,8473,52,73,2349,0,2349,1.0,9340.85,8437.46,9340.89,8437.67,887
886,9394,9480,8404,8510,86,106,5397,1332,4065,0.7531962201222901,9439.03,8458.83,9438.74,8458.91,888
887,6484,6545,8409,8492,61,83,3618,0,3618,1.0,6513.8,8449.19,6513.62,8449.35,890
888,6853,6966,8409,8537,113,128,9659,1482,8177,0.8465679676985195,6906.87,8470.0,6906.65,8470.04,889
889,8776,8962,8411,8665,186,254,30677,2652,28025,0.9135508687290153,8866.65,8536.82,8866.55,8536.76,891
890,6251,6385,8419,8535,134,116,9964,0,9964,1.0,6312.09,8472.64,6312.2,8472.6,893
891,6536,6647,8419,8532,111,113,7894,550,7344,0.9303268305041804,6591.24,8472.96,6590.91,8473.26,892
892,9351,9425,8419,8513,74,94,4576,0,4576,1.0,9385.75,8469.1,9385.54,8469.36,894
893,7045,7211,8421,8568,166,147,18109,0,18109,1.0,7123.94,8487.71,7123.74,8488.24,895
894,9466,9605,8421,8535,139,114,6211,760,5451,0.8776364514570922,9523.02,8474.94,9522.8,8474.84,896
895,8673,8800,8430,8635,127,205,16648,119,16529,0.9928519942335415,8739.42,8529.58,8739.32,8529.62,897
896,8421,8566,8435,8560,145,125,11201,1029,10172,0.9081332023926435,8487.77,8503.64,8487.74,8503.72,899
897,8286,8446,8436,8578,160,142,15311,1365,13946,0.910848409640128,8367.63,8506.97,8367.54,8507.06,898
898,3641,3720,8445,8542,79,97,4064,0,4064,1.0,3670.24,8493.32,3670.33,8493.25,900
899,6378,6425,8446,8530,47,84,2473,0,2473,1.0,6397.56,8480.92,6397.55,8481.61,901
900,7541,7605,8446,8500,64,54,1947,0,1947,1.0,7576.15,8468.33,7575.19,8468.15,902
901,6949,7065,8454,8586,116,132,9544,0,9544,1.0,7009.3,8510.8,7009.03,8511.15,903
902,9154,9212,8456,8535,58,79,2898,0,2898,1.0,9181.76,8490.92,9181.43,8491.23,904
903,6441,6522,8464,8525,81,61,3201,0,3201,1.0,6477.94,8496.09,6477.89,8496.28,905
904,9299,9370,8467,8550,71,83,3896,450,3446,0.8844969199178645,9331.0,8508.59,9331.08,8508.86,906
905,6621,6742,8471,8596,121,125,8855,0,8855,1.0,6676.82,8540.56,6676.57,8540.67,907
906,6391,6450,8474,8575,59,101,3176,0,3176,1.0,6419.72,8523.18,6419.47,8523.29,908
907,6519,6576,8476,8546,57,70,2531,0,2531,1.0,6549.02,8510.73,6548.87,8510.87,909
908,9245,9300,8481,8525,55,44,1806,0,1806,1.0,9274.27,8503.98,9274.39,8504.4,910
909,6783,6952,8485,8775,169,290,27083,0,27083,1.0,6849.71,8641.75,6849.56,8641.75,911
910,7725,7996,8489,8770,271,281,54772,0,54772,1.0,7870.09,8612.37,7869.65,8612.76,912
911,6713,6812,8494,8610,99,116,6793,0,6793,1.0,6764.57,8547.42,6764.18,8547.95,913
912,9179,9260,8494,8558,81,64,3262,0,3262,1.0,9218.31,8525.44,9218.23,8525.44,914
913,7986,8186,8496,8714,200,218,31533,0,31533,1.0,8077.53,8603.18,8077.26,8603.18,915
914,6306,6405,8499,8643,99,144,9694,0,9694,1.0,6358.85,8565.65,6358.67,8566.08,916
915,8146,8346,8501,8703,200,202,25561,0,25561,1.0,8246.12,8610.62,8245.64,8610.74,917
916,9087,9166,8504,8623,79,119,6003,0,6003,1.0,9125.43,8566.9,9125.46,8566.84,918
917,7143,7312,8505,8646,169,141,14835,0,14835,1.0,7226.94,8576.12,7226.87,8576.33,919
918,9343,9485,8506,8612,142,106,10214,0,10214,1.0,9407.57,8551.91,9407.58,8552.17,920
919,3401,4170,8511,9230,769,719,240231,5687,234544,0.9763269519753903,3847.42,8856.55,3846.62,8856.46,921
920,6463,6566,8513,8645,103,132,9923,1496,8427,0.8492391413886929,6510.83,8581.34,6510.76,8581.34,922
921,6888,7021,8515,8648,133,133,12684,0,12684,1.0,6953.5,8588.36,6953.15,8588.39,923
922,6388,6470,8519,8695,82,176,8640,0,8640,1.0,6430.68,8611.17,6430.61,8610.96,924
923,6566,6655,8521,8660,89,139,7058,1528,5530,0.7835080759421933,6612.03,8592.54,6611.68,8592.5,925
924,9250,9310,8524,8570,60,46,1855,0,1855,1.0,9280.83,8543.11,9280.31,8543.7,926
925,7299,7505,8528,8723,206,195,25499,0,25499,1.0,7400.46,8622.43,7400.28,8622.53,927
926,9151,9201,8535,8598,50,63,2299,0,2299,1.0,9172.53,8564.71,9172.08,8564.78,928
927,6546,6592,8540,8591,46,51,1553,0,1553,1.0,6569.25,8562.8,6568.55,8562.54,929
928,7009,7191,8542,8705,182,163,19240,0,19240,1.0,7093.0,8627.73,7092.86,8627.85,930
929,8406,8619,8545,8770,213,225,32772,0,32772,1.0,8512.25,8651.08,8512.24,8651.34,932
930,7486,7802,8546,8880,316,334,67188,0,67188,1.0,7649.15,8698.63,7648.99,8699.07,934
931,8581,8707,8546,8658,126,112,10343,0,10343,1.0,8643.08,8597.2,8643.08,8597.34,933
932,9181,9295,8546,8646,114,100,5439,8,5431,0.9985291413862842,9241.1,8587.36,9240.48,8587.74,931
933,9281,9355,8547,8622,74,75,3887,0,3887,1.0,9317.14,8583.2,9316.65,8583.44,935
934,8988,9092,8559,8700,104,141,8654,0,8654,1.0,9040.89,8621.44,9040.41,8622.01,936
935,8274,8455,8574,8808,181,234,28288,0,28288,1.0,8368.38,8698.2,8368.21,8698.01,937
936,6694,6751,8579,8625,57,46,1863,0,1863,1.0,6723.9,8598.92,6723.57,8599.29,938
937,8903,8957,8579,8647,54,68,2502,1283,1219,0.48721023181454837,8929.7,8608.18,8929.39,8608.65,939
938,2431,2820,8583,9018,389,435,90159,286,89873,0.99682782639559,2643.44,8791.12,2643.04,8791.22,940
939,6653,6715,8589,8661,62,72,3308,0,3308,1.0,6681.63,8623.78,6681.54,8624.28,941
940,9140,9210,8592,8668,70,76,3610,0,3610,1.0,9173.17,8630.29,9173.2,8630.82,942
941,9206,9265,8599,8643,59,44,2174,0,2174,1.0,9238.11,8621.97,9237.72,8622.69,943
942,9273,9375,8601,8717,102,116,6932,0,6932,1.0,9317.93,8656.14,9317.54,8656.22,945
943,6744,6800,8604,8687,56,83,2661,0,2661,1.0,6773.9,8639.05,6774.02,8639.87,946
944,3074,3195,8606,8705,121,99,6977,0,6977,1.0,3141.73,8659.28,3141.52,8659.48,944
945,6544,6590,8607,8648,46,41,1194,0,1194,1.0,6566.91,8630.22,6566.64,8630.2,947
946,9331,9395,8611,8698,64,87,2948,517,2431,0.8246268656716418,9369.61,8659.67,9369.02,8660.32,948
947,9066,9104,8613,8675,38,62,1390,0,1390,1.0,9082.6,8645.34,9082.6,8644.94,949
948,7169,7365,8615,8763,196,148,19574,0,19574,1.0,7270.63,8691.55,7270.44,8691.57,951
949,8576,8732,8615,8760,156,145,9477,1851,7626,0.8046850269072491,8657.76,8684.37,8657.42,8684.8,950
950,6711,6775,8619,8693,64,74,2902,0,2902,1.0,6740.96,8655.93,6740.96,8656.25,952
951,8669,8843,8621,8815,174,194,20036,488,19548,0.9756438410860451,8765.51,8716.54,8765.47,8716.78,954
952,9093,9150,8621,8682,57,61,2520,0,2520,1.0,9119.82,8649.28,9119.51,8649.33,953
953,6861,6917,8625,8685,56,60,1561,0,1561,1.0,6886.63,8652.71,6886.83,8652.89,955
954,6441,6555,8626,8768,114,142,10644,0,10644,1.0,6502.51,8689.52,6502.59,8690.02,956
955,8836,8932,8631,8730,96,99,6302,0,6302,1.0,8878.59,8677.86,8878.62,8677.83,957
956,6548,6647,8636,8870,99,234,16590,1427,15163,0.9139843279083786,6598.1,8744.16,6598.12,8744.56,958
957,6886,7026,8640,8750,140,110,8855,0,8855,1.0,6958.54,8686.09,6958.08,8686.7,961
958,6631,6676,8641,8691,45,50,1421,0,1421,1.0,6652.32,8665.17,6652.44,8665.3,960
959,9184,9272,8641,8700,88,59,3897,0,3897,1.0,9234.5,8668.58,9233.53,8668.86,959
960,8911,9030,8644,8783,119,139,7264,0,7264,1.0,8979.98,8718.28,8979.28,8718.43,962
961,6691,6731,8654,8701,40,47,1320,0,1320,1.0,6709.22,8677.48,6708.78,8677.64,963
962,6638,6747,8661,8820,109,159,10103,21,10082,0.997921409482332,6688.43,8748.68,6688.31,8748.61,964
963,9119,9225,8661,8755,106,94,5988,90,5898,0.9849699398797596,9169.48,8704.28,9169.31,8704.73,965
964,9056,9157,8670,8750,101,80,4103,57,4046,0.9861077260541068,9100.6,8708.73,9100.59,8709.06,968
965,8871,8952,8671,8760,81,89,3856,997,2859,0.741441908713693,8913.8,8718.55,8913.42,8718.58,967
966,4566,4622,8678,8750,56,72,2367,0,2367,1.0,4595.54,8715.02,4595.81,8715.92,966
967,6774,6810,8680,8712,36,32,766,0,766,1.0,6792.92,8695.27,6792.8,8695.18,971
968,6991,7092,8680,8820,101,140,9752,0,9752,1.0,7047.06,8746.6,7046.88,8746.45,969
969,7091,7238,8681,8862,147,181,18481,0,18481,1.0,7156.47,8767.73,7156.53,8768.04,970
970,7333,7602,8681,8961,269,280,49067,0,49067,1.0,7460.31,8820.33,7459.92,8820.78,972
971,8063,8183,8681,8850,120,169,15232,0,15232,1.0,8117.34,8770.94,8117.05,8770.73,973
972,6713,6800,8685,8761,87,76,4749,700,4049,0.8526005474836807,6752.17,8723.63,6752.28,8723.92,974
973,8161,8310,8691,8818,149,127,14747,183,14564,0.9875906964128297,8229.36,8753.26,8229.67,8753.89,975
974,7931,8083,8693,8912,152,219,24955,0,24955,1.0,8004.74,8803.25,8004.22,8803.56,976
975,9173,9335,8695,8800,162,105,9206,0,9206,1.0,9250.49,8742.9,9250.31,8743.15,977
976,9018,9079,8701,8765,61,64,2846,0,2846,1.0,9045.45,8731.2,9044.8,8731.68,978
977,3045,3780,8702,9382,735,680,312900,5136,307764,0.9835858101629914,3427.56,9028.04,3427.54,9028.14,979
978,8353,8706,8719,9147,353,428,77512,636,76876,0.9917948188667561,8537.63,8941.4,8537.19,8941.84,980
979,2936,3122,8721,8945,186,224,22433,0,22433,1.0,3039.52,8819.47,3039.0,8818.85,981
980,8813,8915,8723,8818,102,95,5218,0,5218,1.0,8859.7,8774.34,8859.56,8774.6,982
981,9056,9172,8734,8815,116,81,5838,0,5838,1.0,9108.78,8770.47,9109.13,8770.84,983
982,2731,3077,8736,9135,346,399,73339,0,73339,1.0,2895.4,8957.73,2894.91,8957.75,984
983,7798,7935,8739,8911,137,172,18856,0,18856,1.0,7870.35,8821.08,7870.29,8821.39,985
984,6948,7045,8741,8865,97,124,8110,0,8110,1.0,6990.66,8806.19,6990.57,8806.3,986
985,6816,6957,8746,8925,141,179,15510,1928,13582,0.8756931012250161,6885.15,8830.45,6884.74,8830.61,987
986,8949,9025,8751,8797,76,46,2450,0,2450,1.0,8987.0,8770.89,8987.02,8771.34,988
987,6734,6806,8756,8835,72,79,3263,145,3118,0.9555623659209317,6765.77,8794.75,6766.02,8794.72,990
988,7213,7362,8756,8913,149,157,17045,0,17045,1.0,7294.74,8828.28,7294.56,8828.26,991
989,8398,8525,8756,8843,127,87,6323,0,6323,1.0,8458.09,8793.84,8457.62,8794.13,993
990,10141,10721,8756,9820,580,1064,322165,101,322064,0.9996864960501606,10530.52,9383.23,10529.74,9383.0,989
991,9125,9245,8759,8853,120,94,6266,0,6266,1.0,9183.16,8814.05,9182.92,8814.39,992
992,6786,6828,8761,8803,42,42,1230,0,1230,1.0,6805.86,8778.34,6806.02,8778.93,994
993,8643,8777,8761,8903,134,142,9863,677,9186,0.9313596268883707,8700.19,8833.93,8700.53,8834.19,996
994,9004,9065,8761,8837,61,76,2755,0,2755,1.0,9033.54,8796.72,9033.75,8796.25,995
995,8894,8972,8772,8877,78,105,5779,0,5779,1.0,8928.84,8821.52,8928.77,8822.07,998
996,7714,7851,8776,8983,137,207,17987,0,17987,1.0,7774.9,8894.65,7775.19,8894.88,997
997,6620,6682,8779,8888,62,109,4025,0,4025,1.0,6652.06,8836.76,6651.91,8836.63,999
998,8776,8825,8779,8840,49,61,1618,0,1618,1.0,8798.84,8803.39,8798.87,8804.15,1000
999,4916,5465,8784,9230,549,446,83170,0,83170,1.0,5170.29,9046.34,5170.22,9046.3,1001
1000,8968,9033,8786,8876,65,90,3406,0,3406,1.0,8996.27,8833.74,8996.13,8833.33,1002
1001,8263,8478,8791,8987,215,196,25108,0,25108,1.0,8350.09,8882.84,8350.14,8882.84,1003
1002,9033,9140,8796,8870,107,74,4978,134,4844,0.9730815588589795,9087.43,8832.13,9087.22,8832.36,1004
1003,8721,8751,8798,8858,30,60,1172,0,1172,1.0,8736.04,8829.11,8735.98,8829.26,1006
1004,8051,8338,8801,9145,287,344,58940,4541,54399,0.9229555480149304,8192.08,8972.07,8191.86,8972.22,1005
1005,6771,6840,8804,8857,69,53,2402,0,2402,1.0,6804.44,8830.62,6803.99,8830.72,1007
1006,6959,7156,8805,9055,197,250,28039,795,27244,0.9716466350440458,7056.91,8916.37,7056.83,8916.6,1008
1007,8746,8785,8806,8863,39,57,1626,644,982,0.6039360393603936,8763.45,8836.52,8763.25,8836.46,1009
1008,8781,8897,8806,8913,116,107,6788,0,6788,1.0,8836.88,8848.64,8836.82,8849.14,1010
1009,6677,6792,8812,8922,115,110,8272,2325,5947,0.718931334622824,6735.1,8864.61,6734.84,8864.88,1011
1010,6906,6971,8835,8903,65,68,3044,0,3044,1.0,6938.97,8869.28,6939.15,8869.59,1012
1011,7146,7332,8835,9011,186,176,19539,0,19539,1.0,7226.77,8922.92,7226.74,8923.08,1013
1012,8931,8986,8835,8926,55,91,2920,16,2904,0.9945205479452055,8962.93,8879.97,8962.54,8880.19,1014
1013,9026,9088,8839,8906,62,67,2222,0,2222,1.0,9054.16,8871.58,9054.23,8871.42,1015
1014,7616,7744,8846,9031,128,185,17105,0,17105,1.0,7672.71,8944.4,7672.57,8944.16,1017
1015,6786,6845,8847,8905,59,58,2413,275,2138,0.886033982594281,6815.18,8873.58,6814.63,8873.79,1016
1016,8833,8916,8855,8935,83,80,4301,0,4301,1.0,8870.04,8893.09,8870.0,8893.35,1018
1017,8771,8802,8856,8909,31,53,978,0,978,1.0,8787.2,8883.9,8786.85,8884.44,1019
1018,7753,8125,8866,9150,372,284,60086,2813,57273,0.9531837699297674,7932.61,9023.13,7932.6,9023.31,1020
1019,8981,9062,8867,8942,81,75,3913,346,3567,0.9115767952977255,9020.21,8904.23,9019.86,8903.86,1021
1020,8881,8956,8876,9000,75,124,6498,0,6498,1.0,8917.34,8938.59,8917.07,8938.88,1022
1021,7419,7621,8878,9240,202,362,38393,0,38393,1.0,7541.13,9079.55,7541.07,9079.18,1023
1022,10676,10721,8886,9110,45,224,7006,0,7006,1.0,10703.6,9008.58,10703.11,9007.99,1025
1023,8728,8792,8887,8941,64,54,2186,0,2186,1.0,8761.4,8912.02,8761.16,8912.63,1024
1024,8458,8502,8891,8930,44,39,1234,0,1234,1.0,8480.06,8910.08,8480.06,8910.13,1026
1025,8684,8740,8896,8951,56,55,1815,0,1815,1.0,8711.58,8924.98,8711.44,8925.09,1027
1026,6884,6978,8897,8975,94,78,4505,1180,3325,0.7380688124306326,6934.24,8936.46,6933.98,8936.38,1029
1027,6736,6938,8899,9028,202,129,13521,3032,10489,0.7757562310479994,6845.42,8960.78,6845.21,8960.83,1028
1028,3941,4846,8901,10004,905,1103,660922,3692,657230,0.9944138642684008,4428.76,9419.2,4428.51,9419.64,1030
1029,8769,8885,8905,9007,116,102,7583,0,7583,1.0,8823.19,8957.08,8822.9,8957.41,1032
1030,8016,8100,8906,8981,84,75,3462,0,3462,1.0,8055.66,8942.07,8055.64,8942.21,1031
1031,8921,9075,8916,9035,154,119,11829,4498,7331,0.6197480767605038,8993.7,8982.61,8993.79,8982.61,1033
1032,7368,7537,8918,9072,169,154,20242,0,20242,1.0,7456.19,8986.33,7455.61,8987.07,1034
1033,8719,8777,8931,8991,58,60,2266,0,2266,1.0,8745.99,8955.57,8745.62,8956.26,1035
1034,8666,8722,8940,8988,56,48,2072,0,2072,1.0,8694.27,8965.15,8693.77,8965.16,1036
1035,3071,3085,8941,8961,14,20,206,0,206,1.0,0.0,0.0,3077.89,8950.41,0
1036,7219,7412,8945,9155,193,210,26042,712,25330,0.9726595499577605,7314.96,9056.24,7314.86,9056.39,1037
1037,7066,7237,8949,9105,171,156,18311,0,18311,1.0,7146.79,9028.43,7146.68,9028.63,1038
1038,8326,8412,8954,9035,86,81,4438,0,4438,1.0,8368.06,8994.59,8367.84,8994.55,1039
1039,6919,7120,8968,9187,201,219,20717,5432,15285,0.7377998744992036,7014.17,9077.67,7013.94,9077.78,1040
1040,8716,8796,8971,9050,80,79,3729,0,3729,1.0,8753.34,9010.41,8753.17,9010.83,1041
1041,8593,8636,8974,9006,43,32,968,0,968,1.0,8613.56,8987.3,8612.64,8987.89,1042
1042,8601,8681,8974,9041,80,67,3324,0,3324,1.0,8642.14,9009.58,8641.66,9009.02,1043
1043,7658,7870,8979,9198,212,219,20408,0,20408,1.0,7757.55,9097.2,7757.32,9097.15,1044
1044,8826,8895,8982,9060,69,78,3350,0,3350,1.0,8858.46,9015.37,8858.55,9015.46,1045
1045,8668,8726,8986,9042,58,56,2258,0,2258,1.0,8694.61,9010.36,8694.39,9010.83,1046
1046,8881,8927,8996,9040,46,44,1426,0,1426,1.0,8902.41,9017.22,8902.67,9017.06,1047
1047,8751,8857,9004,9120,106,116,7248,0,7248,1.0,8811.63,9062.85,8811.23,9062.77,1049
1048,7598,7681,9005,9135,83,130,6746,0,6746,1.0,7636.68,9075.24,7636.5,9075.74,1048
1049,6851,6890,9009,9050,39,41,961,0,961,1.0,6869.47,9025.05,6869.43,9025.44,1050
1050,4656,5201,9014,9770,545,756,254455,0,254455,1.0,4958.02,9414.89,4957.78,9414.67,1051
1051,8351,8420,9019,9075,69,56,2701,0,2701,1.0,8387.78,9042.57,8387.22,9042.64,1052
1052,2773,3565,9021,9820,792,799,241666,2162,239504,0.9910537684241888,3197.87,9409.49,3197.4,9409.55,1053
1053,6871,6975,9022,9161,104,139,7555,705,6850,0.9066843150231635,6923.47,9085.98,6923.18,9086.29,1054
1054,8663,8760,9029,9117,97,88,5745,2446,3299,0.5742384682332463,8708.26,9071.64,8708.06,9071.82,1055
1055,8311,8377,9031,9084,66,53,1945,0,1945,1.0,8343.49,9059.5,8342.99,9059.22,1057
1056,8603,8675,9031,9110,72,79,3730,0,3730,1.0,8638.5,9066.89,8638.4,9066.93,1056
1057,8253,8360,9064,9155,107,91,6021,0,6021,1.0,8303.93,9108.01,8303.84,9108.77,1058
1058,7336,7507,9070,9293,171,223,18427,0,18427,1.0,7418.35,9189.92,7418.33,9190.12,1059
1059,8123,8161,9074,9142,38,68,1899,926,973,0.5123749341758821,8143.26,9105.04,8143.22,9105.22,1060
1060,8733,8802,9076,9140,69,64,2816,0,2816,1.0,8765.92,9104.18,8765.83,9104.34,1061
1061,8554,8635,9079,9148,81,69,3236,0,3236,1.0,8597.14,9115.55,8597.02,9115.76,1063
1062,7089,7276,9080,9250,187,170,21270,0,21270,1.0,7180.39,9163.92,7180.27,9164.2,1062
1063,7591,7756,9096,9297,165,201,18719,0,18719,1.0,7666.42,9191.74,7666.59,9191.69,1064
1064,7993,8082,9099,9175,89,76,4784,0,4784,1.0,8040.76,9137.07,8040.33,9137.04,1065
1065,8421,8492,9099,9155,71,56,2861,0,2861,1.0,8458.84,9124.62,8458.02,9124.9,1067
1066,8611,8712,9100,9215,101,115,7969,0,7969,1.0,8660.52,9158.63,8660.1,9158.5,1068
1067,8078,8185,9101,9210,107,109,6677,30,6647,0.9955069642054815,8123.18,9159.91,8123.29,9160.0,1066
1068,8694,8738,9104,9170,44,66,1925,0,1925,1.0,8717.05,9133.87,8717.09,9134.18,1069
1069,3641,3781,9111,9261,140,150,9689,0,9689,1.0,3702.89,9186.04,3702.92,9186.29,1070
1070,7961,8012,9123,9185,51,62,2368,699,1669,0.7048141891891891,7985.5,9151.81,7985.46,9152.19,1071
1071,8149,8268,9124,9177,119,53,3824,0,3824,1.0,8202.19,9151.28,8202.23,9151.33,1072
1072,8521,8612,9125,9232,91,107,5331,322,5009,0.9395985743762896,8563.56,9174.91,8563.1,9175.01,1073
1073,8304,8372,9126,9161,68,35,1514,0,1514,1.0,8334.09,9141.99,8333.84,9142.39,1074
1074,8376,8450,9129,9200,74,71,3879,0,3879,1.0,8413.77,9165.42,8413.5,9165.76,1075
1075,8732,8782,9131,9200,50,69,2454,1015,1439,0.5863895680521597,8757.73,9167.06,8757.04,9166.57,1076
1076,6926,7017,9135,9292,91,157,8601,3055,5546,0.644808743169399,6970.34,9212.02,6970.44,9212.4,1078
1077,7849,7970,9136,9227,121,91,6826,0,6826,1.0,7905.32,9177.88,7905.45,9177.75,1077
1078,8438,8537,9136,9210,99,74,4756,0,4756,1.0,8488.44,9173.88,8487.86,9174.3,1079
1079,8299,8382,9146,9220,83,74,3653,0,3653,1.0,8346.36,9181.77,8346.1,9181.81,1082
1080,7001,7133,9149,9337,132,188,14888,922,13966,0.9380709296077377,7059.33,9235.63,7059.08,9236.01,1080
1081,7233,7360,9149,9269,127,120,10515,35,10480,0.9966714217784118,7296.79,9211.32,7296.7,9211.46,1083
1082,8234,8317,9150,9210,83,60,2946,0,2946,1.0,8276.03,9177.1,8275.98,9177.47,1081
1083,7991,8096,9166,9241,105,75,5412,0,5412,1.0,8045.03,9201.69,8044.57,9201.79,1084
1084,8569,8645,9167,9265,76,98,4359,0,4359,1.0,8607.14,9219.91,8607.25,9220.03,1085
1085,7808,7857,9169,9210,49,41,1499,402,1097,0.7318212141427618,7832.51,9189.33,7832.47,9189.1,1087
1086,8186,8241,9169,9221,55,52,2050,0,2050,1.0,8212.03,9192.57,8212.29,9192.52,1086
1087,5153,5595,9176,9567,442,391,97875,0,97875,1.0,5326.71,9355.24,5326.9,9355.61,1088
1088,7918,8005,9181,9240,87,59,3465,430,3035,0.8759018759018758,7957.58,9210.18,7957.75,9210.09,1089
1089,7735,7815,9189,9268,80,79,4720,0,4720,1.0,7772.72,9229.63,7772.43,9229.93,1090
1090,3438,4069,9190,10150,631,960,390853,825,390028,0.9978892320130586,3759.54,9616.34,3759.27,9616.52,1091
1091,8251,8345,9194,9262,94,68,4245,0,4245,1.0,8295.95,9228.07,8295.96,9228.42,1092
1092,8338,8475,9195,9347,137,152,12217,0,12217,1.0,8401.38,9258.19,8401.5,9258.4,1093
1093,7805,7872,9196,9250,67,54,1875,0,1875,1.0,7841.21,9226.79,7840.58,9225.94,1095
1094,8086,8151,9196,9252,65,56,2615,0,2615,1.0,8119.45,9223.5,8119.27,9223.4,1096
1095,8469,8576,9196,9308,107,112,7982,0,7982,1.0,8518.17,9250.54,8518.34,9250.91,1094
1096,8146,8211,9197,9243,65,46,2066,0,2066,1.0,8174.84,9220.99,8174.92,9221.09,1097
1097,8621,8710,9200,9300,89,100,5460,0,5460,1.0,8667.64,9249.85,8667.56,9249.92,1098
1098,8196,8265,9204,9262,69,58,2270,0,2270,1.0,8232.24,9232.43,8231.63,9232.44,1099
1099,2756,3203,9216,9915,447,699,143485,1463,142022,0.9898038122451824,2984.77,9585.4,2984.36,9585.1,1100
1100,7466,7625,9216,9380,159,164,15635,0,15635,1.0,7548.85,9292.26,7548.72,9292.2,1101
1101,7906,8021,9219,9305,115,86,4898,566,4332,0.884442629644753,7957.98,9259.88,7958.05,9259.9,1103
1102,7871,7926,9221,9270,55,49,1993,0,1993,1.0,7898.46,9241.74,7898.34,9241.57,1102
1103,7173,7268,9226,9307,95,81,5112,0,5112,1.0,7218.64,9269.0,7218.6,9269.19,1105
1104,7318,7417,9226,9303,99,77,5014,0,5014,1.0,7368.62,9265.13,7368.39,9265.29,1106
1105,7801,7916,9226,9321,115,95,4759,377,4382,0.9207816768228619,7863.03,9275.68,7862.21,9275.37,1104
1106,8443,8485,9229,9305,42,76,2450,0,2450,1.0,8463.69,9269.14,8463.22,9269.37,1107
1107,7696,7743,9231,9288,47,57,1790,77,1713,0.9569832402234637,7718.73,9255.64,7718.55,9255.91,1108
1108,8014,8110,9231,9315,96,84,6063,1523,4540,0.7488042223321788,8063.07,9269.83,8062.82,9270.04,1109
1109,8123,8225,9239,9318,102,79,5518,652,4866,0.881841246828561,8172.92,9277.62,8172.72,9277.96,1110
1110,7064,7185,9241,9371,121,130,8539,59,8480,0.9930905258226959,7128.86,9302.58,7128.53,9303.03,1111
1111,8279,8365,9246,9328,86,82,4419,0,4419,1.0,8317.18,9286.17,8317.25,9286.17,1112
1112,8103,8140,9249,9308,37,59,1315,0,1315,1.0,8118.87,9274.67,8118.5,9274.62,1114
1113,8202,8287,9250,9350,85,100,5758,607,5151,0.8945814518930184,8248.24,9300.16,8248.13,9300.05,1115
1114,8534,8660,9250,9388,126,138,10989,0,10989,1.0,8594.51,9321.07,8594.34,9321.27,1113
1115,7968,8022,9256,9322,54,66,2482,102,2380,0.958904109589041,7995.18,9284.81,7995.08,9285.38,1116
1116,7593,7784,9259,9365,191,106,12595,359,12236,0.9714966256450973,7675.22,9323.4,7675.1,9323.49,1117
1117,7733,7870,9260,9348,137,88,7043,1480,5563,0.7898622745988925,7806.1,9301.15,7805.88,9301.52,1118
1118,7677,7728,9266,9310,51,44,1332,0,1332,1.0,7700.49,9289.99,7700.31,9289.84,1119
1119,7249,7345,9269,9355,96,86,4844,34,4810,0.9929810074318745,7296.82,9305.2,7296.56,9305.55,1120
1120,6964,7030,9275,9348,66,73,2997,877,2120,0.7073740407073741,7005.28,9306.4,7004.24,9306.94,1121
1121,7308,7565,9284,9458,257,174,24313,0,24313,1.0,7433.38,9363.39,7433.06,9363.75,1122
1122,7950,8001,9294,9355,51,61,2049,0,2049,1.0,7974.12,9324.51,7973.97,9324.84,1123
1123,7181,7255,9299,9355,74,56,3194,0,3194,1.0,7215.28,9323.82,7215.54,9324.1,1124
1124,7899,7955,9300,9368,56,68,2703,571,2132,0.7887532371439142,7926.62,9330.94,7926.63,9331.16,1126
1125,7976,8140,9300,9478,164,178,21509,1697,19812,0.9211027941791808,8058.01,9396.53,8057.87,9396.53,1127
1126,8081,8151,9301,9350,70,49,2073,0,2073,1.0,8117.8,9322.71,8117.1,9322.71,1128
1127,8291,8420,9301,9460,129,159,12998,396,12602,0.9695337744268349,8360.4,9386.3,8360.12,9386.12,1129
1128,8409,8552,9301,9440,143,139,15706,0,15706,1.0,8480.32,9369.39,8480.25,9369.46,1125
1129,8126,8258,9308,9458,132,150,13983,0,13983,1.0,8187.86,9385.92,8187.79,9385.93,1130
1130,7854,7905,9317,9372,51,55,1805,357,1448,0.8022160664819945,7882.6,9343.12,7882.01,9342.94,1131
1131,7199,7310,9324,9413,111,89,6355,0,6355,1.0,7259.49,9370.78,7259.44,9371.03,1132
1132,7101,7205,9329,9404,104,75,5561,2,5559,0.9996403524545945,7151.12,9366.21,7151.28,9366.47,1134
1133,7779,7886,9329,9400,107,71,3594,1704,1890,0.5258764607679466,7835.91,9364.55,7835.33,9364.39,1135
1134,8246,8335,9329,9413,89,84,5343,2257,3086,0.5775781396219353,8286.78,9369.97,8286.66,9369.94,1133
1135,7024,7092,9331,9405,68,74,2450,1428,1022,0.41714285714285715,7060.64,9362.95,7060.51,9363.19,1136
1136,7937,7995,9341,9395,58,54,2058,0,2058,1.0,7966.68,9368.61,7966.26,9368.75,1137
1137,7886,7945,9357,9390,59,33,1267,0,1267,1.0,7914.56,9376.1,7913.26,9375.99,1138
1138,7553,7620,9360,9412,67,52,1592,0,1592,1.0,7585.14,9382.68,7584.79,9382.78,1139
1139,7078,7195,9371,9590,117,219,14947,5951,8996,0.6018599049976584,7131.43,9482.53,7131.02,9482.36,1140
1140,7283,7425,9377,9520,142,143,12446,0,12446,1.0,7349.06,9439.53,7348.77,9439.67,1141
1141,7151,7290,9380,9504,139,124,10850,0,10850,1.0,7218.21,9446.4,7217.61,9446.76,1143
1142,7574,7620,9380,9428,46,48,1245,0,1245,1.0,7598.3,9405.92,7597.88,9406.09,1142
1143,7006,7085,9382,9460,79,78,4123,0,4123,1.0,7048.37,9423.58,7047.85,9423.47,1144
1144,7871,7955,9382,9430,84,48,2655,1636,1019,0.383804143126177,7915.69,9406.64,7915.26,9405.95,1145
1145,7946,7990,9391,9435,44,44,1371,0,1371,1.0,7968.86,9410.54,7968.43,9411.36,1146
1146,8254,8311,9404,9460,57,56,2143,0,2143,1.0,8280.67,9426.84,8280.08,9427.83,1147
1147,4761,5705,9426,10485,944,1059,485102,0,485102,1.0,5236.7,9930.3,5236.48,9930.59,1148
1148,8176,8265,9430,9475,89,45,2199,0,2199,1.0,8225.7,9454.76,8225.91,9454.79,1149
1149,8221,8312,9456,9540,91,84,5387,20,5367,0.9962873584555412,8264.12,9494.38,8264.52,9494.19,1150
1150,7171,7315,9464,9623,144,159,13798,1356,12442,0.901724887664879,7246.5,9546.54,7246.31,9546.8,1151
1151,10228,10297,9475,9592,69,117,4788,0,4788,1.0,10262.96,9541.73,10262.47,9541.39,1152
1152,3873,5131,9604,10979,1258,1375,959396,0,959396,1.0,4417.58,10343.5,4417.55,10343.45,1153
1153,9251,9890,9649,10668,639,1019,294549,1864,292685,0.9936716811124804,9550.54,10173.94,9550.18,10173.24,1154
1154,3161,3747,9676,10402,586,726,232796,0,232796,1.0,3405.56,10044.81,3405.85,10045.52,1155
1155,10224,10721,9729,10185,497,456,155379,653,154726,0.9957973728753564,10494.56,9944.84,10493.8,9945.02,1156
1156,5599,6097,9766,10175,498,409,122466,0,122466,1.0,5889.84,9970.33,5889.27,9970.49,1157
1157,9596,10721,9851,10907,1125,1056,650792,0,650792,1.0,10193.76,10359.43,10193.06,10359.56,1158
1158,9903,10030,9889,10010,127,121,7014,0,7014,1.0,9951.46,9949.38,9951.94,9948.9,1159
1159,3481,4000,9959,11120,519,1161,305723,2269,303454,0.9925782489377639,3763.68,10566.91,3763.48,10566.76,1160
1160,5268,5865,10011,10540,597,529,222176,0,222176,1.0,5578.78,10291.6,5578.57,10291.74,1161
1161,5833,6515,10076,10588,682,512,188788,5029,183759,0.973361654342437,6161.67,10315.29,6161.4,10315.54,1162
1162,3097,3647,10136,11033,550,897,238386,6591,231795,0.9723515642697138,3398.39,10520.46,3398.06,10521.44,1163
1163,6186,7071,10229,11050,885,821,395749,0,395749,1.0,6596.7,10594.15,6596.43,10594.47,1164
1164,3176,3190,10256,10270,14,14,127,0,127,1.0,0.0,0.0,3182.09,10262.87,0
1165,6681,7382,10266,11038,701,772,218314,0,218314,1.0,6999.26,10692.26,6999.49,10691.9,1165
1166,5581,6235,10374,11080,654,706,309443,0,309443,1.0,5948.19,10712.23,5948.08,10712.35,1166
1167,4981,5675,10376,10865,694,489,179385,0,179385,1.0,5328.17,10629.55,5328.02,10629.38,1167
1168,10034,10664,10581,11300,630,719,240874,38,240836,0.9998422411717329,10403.16,10911.22,10402.83,10911.34,1168
1169,9424,10305,10609,11557,881,948,440967,0,440967,1.0,9884.3,11098.72,9884.0,11098.59,1169
1170,4393,5340,10614,11275,947,661,382322,0,382322,1.0,4895.96,10950.62,4895.48,10950.5,1170
1171,10568,10721,10618,10860,153,242,26177,0,26177,1.0,10662.58,10736.41,10661.98,10736.65,1171
1172,3801,4197,10656,11130,396,474,88103,0,88103,1.0,3984.8,10911.12,3984.83,10911.19,1172
1173,4471,5976,10741,12140,1505,1399,1116867,0,1116867,1.0,5284.54,11436.32,5283.74,11436.65,1173
1174,6571,7275,10834,11531,704,697,288683,0,288683,1.0,6909.32,11205.94,6908.93,11205.68,1174
1175,10386,10721,10854,11566,335,712,114811,2459,112352,0.97858219160185,10616.38,11258.12,10615.62,11257.76,1175
1176,3996,4635,10881,11545,639,664,250116,0,250116,1.0,4294.33,11235.89,4294.27,11235.95,1176
1177,5926,7172,10894,12135,1246,1241,753320,0,753320,1.0,6575.26,11546.54,6574.92,11546.2,1177
1178,8551,8875,10989,11143,324,154,33157,0,33157,1.0,8724.93,11066.8,8724.39,11066.99,1178
1179,3688,4105,11006,11371,417,365,69889,0,69889,1.0,3911.34,11163.24,3911.17,11163.75,1179
1180,8841,9385,11046,11670,544,624,196189,0,196189,1.0,9121.87,11407.97,9121.1,11408.08,1180
1181,5911,6048,11056,11236,137,180,12463,0,12463,1.0,5972.37,11133.16,5972.44,11132.94,1181
1182,8394,10198,11094,13335,1804,2241,1968442,5106,1963336,0.9974060703845986,9248.57,12299.57,9248.21,12299.45,1182
1183,7563,8530,11171,13370,967,2199,1221527,25797,1195730,0.978881350964817,8028.46,12264.63,8028.26,12265.18,1183
1184,3656,4035,11219,11708,379,489,116133,2789,113344,0.97598443164303,3852.72,11443.42,3852.62,11443.54,1184
1185,6926,7840,11221,13006,914,1785,744236,0,744236,1.0,7335.64,12134.05,7335.76,12134.93,1185
1186,8158,8585,11241,11875,427,634,136142,2452,133690,0.9819893934274507,8352.01,11517.18,8351.93,11517.52,1186
1187,9951,10605,11241,11916,654,675,185437,1816,183621,0.99020691663476,10249.56,11572.85,10249.61,11572.39,1187
1188,9332,9988,11346,12020,656,674,256551,0,256551,1.0,9659.32,11647.19,9659.02,11647.49,1188
1189,3996,4095,11380,11511,99,131,7445,0,7445,1.0,4041.14,11455.98,4041.02,11456.22,1189
1190,5561,6362,11407,12207,801,800,365374,0,365374,1.0,6010.15,11821.52,6009.78,11821.92,1190
1191,10293,10640,11496,12180,347,684,176249,3039,173210,0.9827573489778666,10469.2,11844.78,10468.93,11845.07,1191
1192,3597,3930,11526,12045,333,519,92158,393,91765,0.9957355845395951,3752.88,11790.35,3752.96,11790.37,1192
1193,10304,10721,11536,12440,417,904,160852,3630,157222,0.9774326710267823,10590.71,12110.15,10590.34,12109.36,1193
1194,7558,7632,11696,11813,74,117,3508,0,3508,1.0,7596.86,11764.82,7596.72,11764.64,1194
1195,9661,10332,11739,12390,671,651,292875,0,292875,1.0,10005.54,12080.94,10005.53,12080.98,1195
1196,7336,7935,11798,12495,599,697,261661,0,261661,1.0,7654.72,12119.35,7654.68,12119.86,1196
1197,4906,5680,11816,12290,774,474,210985,3421,207564,0.9837855771737327,5286.89,12036.53,5286.64,12036.66,1197
1198,6219,7037,11876,12785,818,909,395617,6399,389218,0.983825265345018,6628.14,12295.28,6628.01,12295.25,1198
1199,5763,6425,12074,12730,662,656,215596,65,215531,0.9996985101764411,6125.93,12382.7,6125.5,12382.56,1199
1200,5296,5890,12086,12487,594,401,120083,0,120083,1.0,5618.46,12277.75,5617.98,12277.87,1200
1201,8371,8757,12094,12718,386,624,162384,0,162384,1.0,8575.73,12455.18,8575.55,12454.7,1201
1202,10531,10542,12104,12115,11,11,99,0,99,1.0,0.0,0.0,10536.6,12108.29,0
1203,10002,10435,12220,12770,433,550,120563,1282,119281,0.9893665552449756,10248.0,12484.25,10247.58,12484.58,1202
1204,5716,6753,12328,13160,1037,832,371068,11886,359182,0.9679681352204986,6235.56,12733.49,6235.0,12733.63,1203
1205,10381,10721,12381,12830,340,449,108512,5,108507,0.9999539221468593,10573.71,12583.38,10573.06,12583.39,1204
1206,8206,8978,12576,13415,772,839,379815,4081,375734,0.989255295341153,8622.25,12953.98,8621.86,12953.89,1205
1207,6621,7176,12601,13027,555,426,136301,7042,129259,0.9483349351802262,6945.16,12841.75,6944.82,12841.6,1206
1208,9961,10632,12641,13263,671,622,221347,2240,219107,0.9898801429429809,10278.97,12950.8,10279.07,12950.95,1207
1209,7293,7770,12721,13233,477,512,120226,2118,118108,0.9823831783474456,7521.26,12974.95,7521.41,12975.17,1208
1210,10571,10721,12791,13078,150,287,27675,0,27675,1.0,10661.61,12925.07,10660.73,12924.88,1209
1211,6221,6487,12876,13163,266,287,46323,0,46323,1.0,6362.46,13039.69,6362.03,13039.99,1210
1212,6416,6742,12911,13260,326,349,70568,313,70255,0.9955645618410611,6578.03,13074.49,6577.61,13074.48,1211
1213,8806,9220,12926,13373,414,447,87174,0,87174,1.0,9024.32,13136.12,9024.22,13136.32,1212
1214,6599,6985,12986,13293,386,307,71465,0,71465,1.0,6804.99,13151.21,6804.59,13151.16,1213
1215,10361,10472,13081,13215,111,134,10113,0,10113,1.0,10419.69,13144.89,10419.12,13144.33,1214
1216,9341,9742,13106,13520,401,414,112877,0,112877,1.0,9546.26,13338.35,9545.98,13338.44,1215
