ndimage_cellID,x0,x1,y0,y1,length,height,total_area,nuclei_area,cyto_area,c2t_area_ratio,number_nuclei,orig_comX,orig_comY,ndimage_comX,ndimage_comY,orig_cellID
1,0,15008,0,15008,15008,15008,101810335,48426,101761909,0.9995243508431634,9,7734.7,7218.63,7733.72,7218.41,1
2,5889,6201,1249,1610,312,361,80309,1820,78489,0.977337533775791,1,6048.68,1429.52,6048.15,1429.07,2
3,6005,7082,1438,2064,1077,626,342965,0,342965,1.0,0,6541.2,1737.14,6540.81,1736.8,3
4,4775,5738,1484,2056,963,572,349390,2649,346741,0.992418214602593,1,5241.33,1754.37,5240.83,1753.85,4
5,6742,7044,1508,1682,302,174,32134,0,32134,1.0,0,6917.7,1587.14,6916.97,1586.75,5
6,5636,6013,1554,1829,377,275,69951,0,69951,1.0,0,5851.58,1685.44,5850.76,1684.81,6
7,7039,7468,1557,1817,429,260,71239,0,71239,1.0,0,7239.73,1676.18,7239.37,1675.96,7
8,6830,7090,1640,1815,260,175,32862,0,32862,1.0,0,6959.21,1727.62,6958.72,1727.12,8
9,7588,7851,1647,1882,263,235,36794,0,36794,1.0,0,7701.14,1761.81,7700.85,1761.24,9
10,7505,9147,1697,2666,1642,969,695394,3480,691914,0.9949956427579185,1,8376.57,2136.57,8375.69,2136.13,10
11,7276,7595,1728,2123,319,395,75688,0,75688,1.0,0,7445.81,1912.27,7445.31,1911.82,11
12,7046,7357,1731,2043,311,312,58470,0,58470,1.0,0,7197.24,1881.52,7197.11,1881.4,12
13,6184,6346,1770,1881,162,111,12168,0,12168,1.0,0,6268.7,1829.39,6268.12,1828.85,13
14,4477,4667,1772,1965,190,193,26141,0,26141,1.0,0,4566.39,1872.84,4565.96,1872.28,14
15,5872,6475,1775,2119,603,344,136155,0,136155,1.0,0,6148.43,1950.26,6148.11,1949.79,15
16,4636,4874,1802,2047,238,245,38508,1450,37058,0.9623454866521243,1,4749.56,1919.86,4749.12,1919.35,16
17,5648,5900,1805,2038,252,233,40785,0,40785,1.0,0,5772.18,1924.94,5771.65,1924.35,17
18,4599,5124,1867,2284,525,417,109767,0,109767,1.0,0,4873.68,2073.41,4872.98,2073.14,18
19,6455,6788,1873,2157,333,284,56155,0,56155,1.0,0,6601.12,2014.08,6600.73,2013.64,19
20,5404,5673,1889,2066,269,177,36034,0,36034,1.0,0,5547.09,1976.69,5546.46,1976.17,20
21,5326,5477,1967,2151,151,184,12965,0,12965,1.0,0,5412.46,2048.4,5411.9,2048.1,21
22,7002,7417,1973,2205,415,232,58229,0,58229,1.0,0,7201.31,2082.68,7201.1,2082.31,22
23,5450,6066,1977,2246,616,269,91226,0,91226,1.0,0,5789.52,2124.77,5788.69,2124.19,23
24,7491,7839,1989,2260,348,271,37477,0,37477,1.0,0,7661.0,2092.45,7660.69,2092.29,24
25,4051,4458,1994,2209,407,215,53911,0,53911,1.0,0,4253.24,2105.4,4252.76,2104.78,25
26,3900,4080,2000,2207,180,207,25225,0,25225,1.0,0,3989.71,2096.49,3989.27,2096.06,26
27,6458,7112,2023,2468,654,445,178654,0,178654,1.0,0,6759.9,2241.34,6759.57,2240.79,27
28,7662,7985,2024,2249,323,225,37482,0,37482,1.0,0,7822.77,2151.47,7822.29,2150.96,28
29,5001,5442,2031,2378,441,347,112076,0,112076,1.0,0,5219.08,2197.85,5218.6,2197.41,30
30,6028,6510,2056,2381,482,325,110145,0,110145,1.0,0,6288.6,2201.62,6287.98,2201.11,31
31,4320,4720,2068,2395,400,327,68017,0,68017,1.0,0,4497.8,2230.57,4497.45,2230.18,32
32,7416,7655,2120,2293,239,173,28624,0,28624,1.0,0,7532.22,2207.73,7531.74,2207.21,33
33,5334,6153,2129,2701,819,572,272323,0,272323,1.0,0,5769.07,2399.9,5768.39,2399.45,34
34,7046,7471,2146,2466,425,320,87195,0,87195,1.0,0,7274.35,2293.61,7273.85,2293.22,35
35,3919,4661,2153,2796,742,643,280620,0,280620,1.0,0,4249.34,2499.6,4249.06,2499.14,36
36,3723,4035,2154,2457,312,303,55248,0,55248,1.0,0,3870.12,2281.16,3869.78,2280.82,37
37,4404,5129,2191,2624,725,433,190309,0,190309,1.0,0,4802.96,2405.66,4802.34,2405.26,38
38,7757,8121,2206,2478,364,272,62549,0,62549,1.0,0,7935.57,2342.45,7935.16,2342.03,39
39,3485,3647,2211,2371,162,160,16242,0,16242,1.0,0,3561.98,2290.76,3561.58,2290.29,40
40,7623,7787,2242,2340,164,98,8248,0,8248,1.0,0,7715.77,2278.36,7715.06,2278.07,41
41,7437,7548,2247,2354,111,107,7551,0,7551,1.0,0,7481.3,2298.61,7481.01,2298.13,42
42,3592,3738,2258,2443,146,185,15296,0,15296,1.0,0,3669.55,2343.6,3668.88,2343.3,43
43,6091,6215,2264,2425,124,161,14067,0,14067,1.0,0,6150.88,2346.7,6150.33,2346.07,44
44,7420,7968,2289,2732,548,443,166679,0,166679,1.0,0,7692.31,2517.48,7691.78,2516.92,45
45,9128,9346,2298,2511,218,213,32648,0,32648,1.0,0,9233.62,2394.34,9232.89,2394.1,46
46,6847,7302,2299,2715,455,416,113751,0,113751,1.0,0,7073.75,2494.66,7073.21,2494.12,47
47,9525,9853,2312,2708,328,396,67366,0,67366,1.0,0,9697.73,2486.87,9697.22,2486.71,48
48,9345,9564,2320,2534,219,214,32178,0,32178,1.0,0,9464.0,2429.64,9463.43,2429.1,49
49,6109,6702,2323,2715,593,392,157235,0,157235,1.0,0,6379.24,2544.3,6378.93,2543.78,50
50,5078,5502,2348,2775,424,427,121534,0,121534,1.0,0,5261.37,2556.18,5261.03,2555.83,51
51,8392,8721,2349,2792,329,443,94934,0,94934,1.0,0,8551.04,2578.2,8550.51,2577.64,52
52,3445,3623,2355,2569,178,214,24734,0,24734,1.0,0,3536.25,2449.14,3535.85,2448.88,53
53,3593,3994,2368,2793,401,425,107378,0,107378,1.0,0,3794.41,2569.97,3793.97,2569.62,54
54,6570,6956,2392,2754,386,362,84403,0,84403,1.0,0,6803.04,2567.39,6802.11,2566.76,55
55,8265,8422,2399,2556,157,157,17378,0,17378,1.0,0,8345.78,2469.2,8345.27,2468.66,56
56,8078,8357,2400,2643,279,243,34885,0,34885,1.0,0,8214.02,2512.55,8213.56,2512.19,57
57,7096,7587,2444,2975,491,531,165398,0,165398,1.0,0,7338.8,2727.55,7338.34,2727.04,58
58,7887,8178,2452,2799,291,347,69760,0,69760,1.0,0,8041.92,2635.58,8041.27,2634.96,59
59,9134,9641,2459,2750,507,291,83718,0,83718,1.0,0,9423.06,2589.04,9422.33,2588.55,60
60,5393,5952,2500,2995,559,495,159090,0,159090,1.0,0,5696.52,2723.77,5696.07,2723.42,61
61,8670,9442,2511,3364,772,853,465932,0,465932,1.0,0,9051.86,2929.2,9051.4,2928.74,62
62,4606,5121,2530,2937,515,407,159679,0,159679,1.0,0,4860.57,2739.75,4860.05,2739.24,63
63,8025,8553,2556,3068,528,512,183192,0,183192,1.0,0,8303.0,2847.16,8302.44,2846.49,64
64,9574,9854,2622,2890,280,268,53885,0,53885,1.0,0,9722.54,2759.05,9721.98,2758.63,65
65,5909,6864,2649,3261,955,612,377960,0,377960,1.0,0,6404.2,2910.6,6403.54,2910.17,66
66,6780,7180,2675,3009,400,334,76629,0,76629,1.0,0,6979.54,2833.95,6979.21,2833.52,68
67,4101,4656,2676,2959,555,283,82410,0,82410,1.0,0,4393.83,2832.32,4392.92,2831.64,67
68,3927,4257,2680,3044,330,364,76919,0,76919,1.0,0,4088.27,2864.62,4087.78,2864.09,69
69,9383,9586,2695,2921,203,226,32582,0,32582,1.0,0,9489.41,2810.81,9488.84,2810.29,70
70,7630,8097,2718,3187,467,469,156487,0,156487,1.0,0,7843.53,2950.0,7843.02,2949.56,71
71,5129,5842,2719,3245,713,526,209478,0,209478,1.0,0,5425.48,2972.16,5425.18,2971.75,72
72,7472,7706,2728,3305,234,577,82439,0,82439,1.0,0,7583.78,3004.32,7583.42,3004.12,73
73,3535,3873,2730,2980,338,250,52654,0,52654,1.0,0,3709.83,2835.25,3709.27,2834.89,74
74,5112,5243,2739,2866,131,127,9944,0,9944,1.0,0,5170.52,2794.54,5170.16,2794.17,75
75,8510,8774,2755,3042,264,287,43675,0,43675,1.0,0,8630.26,2912.27,8629.89,2911.77,76
76,3719,4010,2782,3090,291,308,46715,0,46715,1.0,0,3870.65,2951.25,3870.1,2950.63,77
77,4963,5163,2818,3005,200,187,15904,0,15904,1.0,0,5094.27,2915.73,5093.19,2915.14,78
78,9831,10150,2828,3039,319,211,35991,2015,33976,0.9440137812230835,1,9998.35,2926.95,9997.71,2926.46,79
79,9552,9921,2854,3146,369,292,63439,2799,60640,0.9558788757704252,1,9745.89,2979.06,9745.27,2978.58,80
80,4566,5213,2897,3321,647,424,209208,0,209208,1.0,0,4875.42,3108.29,4874.9,3107.82,81
81,9355,9712,2898,3261,357,363,86777,2,86775,0.9999769524182676,0,9524.73,3093.2,9524.28,3092.61,82
82,7067,7524,2901,3296,457,395,88258,0,88258,1.0,0,7344.2,3066.86,7343.52,3066.5,83
83,4167,4619,2929,3352,452,423,124474,0,124474,1.0,0,4424.08,3125.55,4423.33,3125.12,84
84,6528,7327,2943,3537,799,594,290941,0,290941,1.0,0,6925.05,3264.4,6924.55,3263.86,85
85,9877,10047,2961,3224,170,263,29290,0,29290,1.0,0,9966.27,3090.38,9965.75,3089.9,86
86,5498,6115,2977,3550,617,573,240771,0,240771,1.0,0,5822.56,3255.56,5822.02,3255.01,87
87,8635,8825,2979,3167,190,188,17683,0,17683,1.0,0,8725.33,3053.1,8724.94,3052.76,88
88,3808,4162,2997,3201,354,204,42319,0,42319,1.0,0,3982.74,3098.49,3982.28,3097.92,89
89,8323,8818,3013,3503,495,490,140055,0,140055,1.0,0,8582.62,3233.08,8582.08,3232.72,90
90,6016,6136,3014,3103,120,89,6746,0,6746,1.0,0,6079.93,3056.36,6079.32,3055.84,91
91,3946,4346,3044,3300,400,256,55527,0,55527,1.0,0,4162.0,3195.89,4161.29,3195.24,92
92,7878,8463,3050,3552,585,502,209536,0,209536,1.0,0,8145.23,3292.86,8144.9,3292.37,93
93,6041,6284,3086,3422,243,336,54629,0,54629,1.0,0,6178.9,3258.6,6178.26,3258.41,94
94,9633,10062,3092,3423,429,331,79062,0,79062,1.0,0,9856.09,3251.3,9855.5,3250.81,95
95,6265,6613,3125,3441,348,316,76809,0,76809,1.0,0,6411.04,3289.31,6410.67,3288.75,96
96,4853,5634,3148,3662,781,514,257315,0,257315,1.0,0,5290.65,3426.87,5289.99,3426.25,97
97,3830,4156,3163,3525,326,362,58801,0,58801,1.0,0,3984.54,3350.91,3983.97,3350.47,98
98,9127,9422,3165,3356,295,191,33740,0,33740,1.0,0,9301.6,3272.54,9300.7,3272.14,99
99,7547,7914,3168,3536,367,368,88392,0,88392,1.0,0,7758.08,3335.61,7757.43,3335.19,100
100,7029,7713,3196,3817,684,621,271059,0,271059,1.0,0,7380.82,3538.23,7380.25,3537.61,101
101,10052,10395,3221,3488,343,267,62268,0,62268,1.0,0,10221.94,3348.72,10221.42,3348.25,102
102,9134,9884,3246,3698,750,452,194985,0,194985,1.0,0,9524.47,3448.91,9523.69,3448.58,103
103,4104,5107,3257,3888,1003,631,323788,0,323788,1.0,0,4635.03,3555.27,4634.42,3554.85,104
104,2774,2955,3272,3431,181,159,18929,0,18929,1.0,0,2866.92,3342.41,2866.47,3342.08,105
105,4100,4433,3274,3434,333,160,35048,0,35048,1.0,0,4252.67,3352.81,4252.3,3352.33,106
106,10498,10884,3292,3588,386,296,67639,0,67639,1.0,0,10689.47,3448.49,10689.04,3448.05,107
107,9773,10291,3330,3943,518,613,219085,0,219085,1.0,0,10038.8,3647.42,10038.25,3646.84,108
108,8651,9322,3347,3925,671,578,257021,0,257021,1.0,0,8979.0,3606.73,8978.54,3606.38,109
109,8207,8697,3360,3915,490,555,203046,0,203046,1.0,0,8459.66,3643.89,8459.12,3643.37,110
110,5722,6275,3387,3757,553,370,133996,1802,132194,0.9865518373682797,1,6019.11,3585.62,6018.54,3585.0,111
111,3627,4184,3414,3769,557,355,127290,0,127290,1.0,0,3909.45,3599.38,3908.7,3598.95,112
112,3119,3675,3419,4026,556,607,180622,0,180622,1.0,0,3401.5,3702.38,3400.83,3701.84,113
113,6196,6639,3427,3866,443,439,148909,0,148909,1.0,0,6425.17,3635.6,6424.62,3635.18,114
114,7674,8218,3433,3935,544,502,163998,0,163998,1.0,0,7944.08,3677.26,7943.52,3676.76,115
115,10274,10734,3447,3883,460,436,134900,0,134900,1.0,0,10490.42,3653.12,10489.99,3652.71,116
116,6610,7141,3468,3898,531,430,145596,0,145596,1.0,0,6864.06,3672.78,6863.65,3672.28,117
117,11714,11846,3485,3667,132,182,15458,0,15458,1.0,0,11783.33,3582.5,11782.75,3581.88,118
118,10886,11114,3494,3691,228,197,29240,0,29240,1.0,0,11000.13,3587.31,10999.57,3586.8,119
119,11086,11324,3515,3787,238,272,37500,0,37500,1.0,0,11202.5,3633.0,11202.12,3632.65,120
120,5405,5861,3519,3870,456,351,89841,0,89841,1.0,0,5627.06,3710.39,5626.8,3709.87,121
121,11325,11463,3530,3617,138,87,8188,0,8188,1.0,0,11398.11,3572.06,11397.48,3571.57,122
122,10683,10959,3533,3819,276,286,48562,0,48562,1.0,0,10822.65,3692.65,10822.05,3692.18,123
123,2740,3298,3561,4015,558,454,148622,0,148622,1.0,0,3030.87,3797.14,3030.36,3796.65,124
124,9313,9835,3570,4093,522,523,209664,0,209664,1.0,0,9585.87,3830.94,9585.41,3830.43,125
125,11258,11483,3570,3953,225,383,58902,0,58902,1.0,0,11378.22,3768.9,11377.67,3768.3,126
126,11441,11677,3584,3858,236,274,45398,1167,44231,0.9742940217630732,1,11552.04,3726.98,11551.53,3726.39,127
127,2613,2843,3597,3849,230,252,34671,0,34671,1.0,0,2717.99,3715.06,2717.63,3714.68,128
128,4056,4585,3604,4105,529,501,167524,0,167524,1.0,0,4318.04,3847.12,4317.55,3846.66,129
129,2380,2643,3620,3760,263,140,29427,671,28756,0.9771978115336256,0,2509.73,3694.94,2509.24,3694.37,130
130,5026,5415,3633,4010,389,377,98240,0,98240,1.0,0,5231.96,3789.16,5231.37,3788.77,131
131,10908,11338,3640,4055,430,415,95690,0,95690,1.0,0,11080.3,3846.74,11080.34,3846.25,132
132,4679,5201,3699,4374,522,675,237023,0,237023,1.0,0,4934.78,4039.78,4934.26,4039.29,133
133,3644,4166,3704,3964,522,260,79079,0,79079,1.0,0,3899.36,3812.46,3898.83,3812.11,134
134,7369,7962,3712,4293,593,581,198594,0,198594,1.0,0,7689.84,3994.8,7689.04,3994.18,135
135,5764,6102,3723,4017,338,294,53383,0,53383,1.0,0,5913.93,3865.48,5913.68,3864.85,136
136,5926,6475,3725,4212,549,487,176897,0,176897,1.0,0,6198.32,3982.05,6197.86,3981.46,137
137,6370,7056,3732,4428,686,696,329516,0,329516,1.0,0,6696.4,4105.16,6695.92,4104.59,138
138,9158,9346,3746,3993,188,247,29819,0,29819,1.0,0,9260.69,3868.22,9260.07,3867.6,139
139,2305,2699,3756,4105,394,349,102780,0,102780,1.0,0,2495.78,3910.19,2495.33,3909.78,140
140,6980,7525,3762,4188,545,426,158774,0,158774,1.0,0,7250.29,3971.94,7249.85,3971.44,141
141,10108,10639,3771,4303,531,532,213228,0,213228,1.0,0,10352.15,4049.84,10351.67,4049.31,142
142,11652,11767,3777,3880,115,103,7633,0,7633,1.0,0,11715.21,3819.03,11714.58,3818.79,143
143,7918,8532,3779,4351,614,572,244184,0,244184,1.0,0,8221.5,4067.42,8220.95,4066.95,144
144,8480,9022,3781,4280,542,499,169145,0,169145,1.0,0,8756.12,4028.42,8755.61,4027.98,145
145,5353,5784,3782,4067,431,285,71142,0,71142,1.0,0,5576.46,3911.87,5575.66,3911.39,146
146,10562,11057,3788,4242,495,454,157274,0,157274,1.0,0,10795.72,4019.35,10795.14,4018.82,147
147,2081,2327,3798,4037,246,239,38772,0,38772,1.0,0,2205.18,3905.18,2204.69,3904.87,148
148,8980,9261,3807,4107,281,300,59316,0,59316,1.0,0,9112.5,3973.02,9112.13,3972.48,149
149,2490,3129,3821,4323,639,502,171458,0,171458,1.0,0,2777.98,4108.55,2777.6,4107.9,151
150,3423,3881,3821,4287,458,466,155645,0,155645,1.0,0,3632.2,4077.39,3631.75,4076.81,150
151,11479,11817,3834,4077,338,243,51883,0,51883,1.0,0,11638.65,3950.84,11638.28,3950.58,152
152,11163,11352,3852,4051,189,199,27026,0,27026,1.0,0,11248.55,3960.16,11248.15,3959.53,153
153,4319,4734,3866,4343,415,477,123963,0,123963,1.0,0,4546.87,4119.66,4546.34,4119.03,154
154,9787,10130,3878,4336,343,458,109393,0,109393,1.0,0,9972.81,4089.93,9972.18,4089.48,155
155,3809,4079,3883,4084,270,201,40935,0,40935,1.0,0,3941.31,3981.76,3940.83,3981.29,156
156,8425,8592,3892,4058,167,166,15341,0,15341,1.0,0,8506.69,3960.0,8506.2,3959.5,157
157,1982,2195,3905,4162,213,257,33178,0,33178,1.0,0,2087.81,4037.88,2087.38,4037.31,158
158,3032,3439,3907,4297,407,390,93668,0,93668,1.0,0,3264.87,4092.35,3264.12,4091.86,159
159,11297,11597,3913,4183,300,270,49633,0,49633,1.0,0,11443.96,4057.94,11443.33,4057.5,160
160,5177,5498,3926,4501,321,575,109092,0,109092,1.0,0,5334.55,4170.38,5334.12,4170.26,161
161,1827,2047,3948,4180,220,232,28359,0,28359,1.0,0,1923.48,4061.36,1923.2,4061.0,162
162,9240,9504,3959,4216,264,257,42083,0,42083,1.0,0,9376.07,4090.07,9375.47,4089.51,163
163,11735,12007,3968,4187,272,219,38000,0,38000,1.0,0,11882.37,4071.78,11881.73,4071.34,164
164,5394,6005,3981,4578,611,597,271714,0,271714,1.0,0,5697.08,4271.54,5696.59,4271.06,165
165,2163,2498,3991,4354,335,363,87132,0,87132,1.0,0,2331.81,4166.3,2331.27,4165.85,166
166,3886,4426,4026,4606,540,580,212659,0,212659,1.0,0,4145.14,4311.07,4144.56,4310.61,167
167,11324,11998,4031,4481,674,450,168738,0,168738,1.0,0,11622.31,4270.48,11622.14,4269.96,168
168,10980,11348,4042,4406,368,364,87888,0,87888,1.0,0,11188.03,4194.02,11187.51,4193.77,169
169,9447,9980,4050,4529,533,479,162410,0,162410,1.0,0,9715.63,4279.32,9715.1,4278.91,170
170,3719,3988,4069,4642,269,573,82479,0,82479,1.0,0,3855.9,4361.1,3855.65,4360.38,171
171,8725,9500,4083,4604,775,521,278508,0,278508,1.0,0,9098.8,4348.58,9098.39,4348.06,172
172,11899,12236,4088,4288,337,200,47223,0,47223,1.0,0,12072.88,4182.98,12072.43,4182.67,173
173,6935,7287,4106,4337,352,231,48483,0,48483,1.0,0,7103.01,4232.56,7102.56,4231.99,174
174,1902,2262,4120,4468,360,348,81650,0,81650,1.0,0,2087.78,4291.3,2087.29,4290.82,175
175,7278,7651,4132,4339,373,207,48604,0,48604,1.0,0,7445.09,4231.18,7444.91,4230.79,176
176,5914,6424,4151,4582,510,431,143782,0,143782,1.0,0,6182.52,4361.87,6181.89,4361.45,177
177,2904,3208,4167,4391,304,224,51931,0,51931,1.0,0,3067.15,4269.4,3066.55,4268.94,178
178,8333,8840,4184,4756,507,572,168004,0,168004,1.0,0,8583.12,4479.66,8582.77,4479.13,179
179,10453,11146,4190,4580,693,390,174265,0,174265,1.0,0,10816.0,4364.91,10815.46,4364.52,180
180,7132,7357,4193,4569,225,376,34980,0,34980,1.0,0,7238.16,4382.62,7237.8,4381.78,182
181,7641,8048,4194,4596,407,402,95900,0,95900,1.0,0,7838.85,4368.92,7838.39,4368.46,181
182,4845,5330,4211,4607,485,396,125907,0,125907,1.0,0,5096.19,4428.02,5095.72,4427.51,183
183,11940,12276,4242,4520,336,278,62509,0,62509,1.0,0,12120.26,4377.62,12119.59,4377.16,184
184,12261,12584,4243,4452,323,209,47389,0,47389,1.0,0,12425.55,4339.25,12425.04,4338.82,186
185,3201,3442,4244,4371,241,127,21933,0,21933,1.0,0,3321.32,4310.35,3320.86,4309.87,185
186,2564,3005,4257,4625,441,368,106841,0,106841,1.0,0,2794.98,4439.88,2794.39,4439.45,187
187,4321,4889,4258,4800,568,542,187240,0,187240,1.0,0,4605.4,4510.89,4604.92,4510.41,188
188,7866,8349,4258,4772,483,514,155361,0,155361,1.0,0,8125.75,4504.23,8125.13,4503.89,189
189,9972,10140,4267,4426,168,159,18095,0,18095,1.0,0,10056.39,4349.66,10055.86,4349.11,190
190,3327,3769,4269,4627,442,358,109667,0,109667,1.0,0,3574.77,4440.59,3574.1,4440.1,191
191,7258,7750,4275,4876,492,601,192333,0,192333,1.0,0,7493.86,4550.44,7493.36,4550.12,192
192,9929,10537,4283,4605,608,322,114925,0,114925,1.0,0,10252.15,4434.63,10251.55,4434.2,193
193,2239,2670,4286,4543,431,257,76400,842,75558,0.9889790575916231,0,2444.34,4411.52,2443.96,4410.98,194
194,8290,8482,4291,4450,192,159,16685,0,16685,1.0,0,8401.12,4383.75,8400.5,4382.93,195
195,11121,11286,4317,4481,165,164,18077,0,18077,1.0,0,11195.73,4404.62,11195.32,4404.05,196
196,11703,12041,4320,4546,338,226,34965,0,34965,1.0,0,11873.07,4434.23,11872.54,4433.74,197
197,6685,7210,4323,4820,525,497,183071,0,183071,1.0,0,6943.3,4557.82,6942.78,4557.42,198
198,2972,3413,4355,4672,441,317,99977,0,99977,1.0,0,3185.67,4500.15,3185.25,4499.76,199
199,6396,6744,4360,4747,348,387,70584,0,70584,1.0,0,6588.43,4524.57,6587.85,4524.16,200
200,11492,11905,4365,4694,413,329,84856,0,84856,1.0,0,11696.98,4540.18,11696.54,4539.6,201
201,11071,11509,4378,4666,438,288,63405,0,63405,1.0,0,11306.08,4534.3,11305.36,4533.8,202
202,12027,12380,4380,4682,353,302,55092,0,55092,1.0,0,12210.36,4541.08,12209.97,4540.46,203
203,9188,9875,4394,4918,687,524,256230,0,256230,1.0,0,9527.26,4652.3,9526.63,4651.94,204
204,12544,12907,4428,4750,363,322,77692,2081,75611,0.9732147454049322,1,12711.53,4585.68,12711.12,4585.26,205
205,5219,5635,4429,4894,416,465,81829,0,81829,1.0,0,5418.58,4648.42,5417.93,4648.21,207
206,12372,12538,4432,4554,166,122,15083,0,15083,1.0,0,12442.53,4499.22,12442.24,4498.72,206
207,5888,6162,4441,4732,274,291,49643,0,49643,1.0,0,6036.54,4596.23,6035.89,4595.78,208
208,10300,10966,4455,4819,666,364,173634,0,173634,1.0,0,10614.42,4631.76,10614.06,4631.19,209
209,5654,5960,4460,4683,306,223,37646,0,37646,1.0,0,5824.59,4587.27,5823.96,4586.57,210
210,2120,2389,4473,4755,269,282,43222,485,42737,0.9887788626162602,0,2254.25,4614.77,2253.58,4614.31,211
211,2381,2579,4504,4636,198,132,14437,312,14125,0.9783888619519291,0,2467.12,4564.63,2466.9,4564.1,212
212,4200,4421,4506,4683,221,177,22183,0,22183,1.0,0,4325.38,4582.1,4324.82,4581.72,213
213,6083,6638,4509,5103,555,594,241630,0,241630,1.0,0,6361.16,4805.72,6360.65,4805.26,214
214,10899,11355,4513,4902,456,389,97914,0,97914,1.0,0,11136.14,4702.42,11135.5,4701.89,216
215,9855,10102,4514,4731,247,217,35912,0,35912,1.0,0,9957.89,4609.25,9957.51,4608.78,215
216,11847,12248,4517,4826,401,309,67763,0,67763,1.0,0,12015.49,4690.5,12015.19,4689.87,217
217,2323,2756,4526,4874,433,348,87954,0,87954,1.0,0,2547.52,4714.97,2547.02,4714.29,218
218,3683,3863,4540,4688,180,148,15500,0,15500,1.0,0,3781.21,4623.4,3780.55,4622.78,219
219,2615,3260,4546,5039,645,493,184652,0,184652,1.0,0,2938.72,4788.65,2938.19,4788.25,220
220,12197,12634,4549,4922,437,373,103588,12,103576,0.9998841564659999,0,12425.8,4712.91,12425.21,4712.57,221
221,3838,4439,4555,4950,601,395,126265,0,126265,1.0,0,4137.97,4723.76,4137.52,4723.36,222
222,4603,5303,4561,5088,700,527,249227,0,249227,1.0,0,4935.58,4795.3,4935.15,4794.91,223
223,6957,7392,4568,4933,435,365,87380,0,87380,1.0,0,7190.82,4762.01,7190.32,4761.64,224
224,3207,3391,4571,4660,184,89,11593,0,11593,1.0,0,3285.94,4619.86,3285.73,4619.28,225
225,10043,10356,4572,4839,313,267,49637,0,49637,1.0,0,10202.87,4692.57,10202.35,4692.19,226
226,5601,6010,4574,4883,409,309,58542,0,58542,1.0,0,5787.52,4737.45,5786.97,4736.71,227
227,8658,9262,4579,5055,604,476,207410,0,207410,1.0,0,8962.16,4797.15,8961.66,4796.67,228
228,11084,11914,4582,5369,830,787,408914,0,408914,1.0,0,11503.22,4970.98,11502.75,4970.54,229
229,3189,3842,4583,4893,653,310,128059,0,128059,1.0,0,3512.33,4734.46,3511.91,4734.0,230
230,7652,7903,4587,4811,251,224,29262,0,29262,1.0,0,7772.52,4671.27,7772.04,4671.09,231
231,8146,9104,4627,5275,958,648,257966,0,257966,1.0,0,8628.23,4978.83,8627.66,4978.32,232
232,7774,8156,4651,4838,382,187,37122,1206,35916,0.9675125262647487,0,7990.44,4736.65,7989.35,4736.29,233
233,12709,13014,4687,4985,305,298,52323,0,52323,1.0,0,12882.04,4834.92,12881.36,4834.33,235
234,9605,10242,4688,5288,637,600,289677,0,289677,1.0,0,9945.38,4994.74,9944.89,4994.24,234
235,7571,7762,4691,4847,191,156,18481,0,18481,1.0,0,7656.52,4783.86,7656.15,4783.21,236
236,5338,5839,4694,5094,501,400,118440,0,118440,1.0,0,5544.7,4889.16,5544.51,4888.72,237
237,2046,2484,4698,4967,438,269,75727,0,75727,1.0,0,2252.23,4839.01,2251.91,4838.52,238
238,3712,4242,4707,5290,530,583,172455,0,172455,1.0,0,3996.4,5010.2,3995.72,5009.52,239
239,10718,11125,4714,5177,407,463,113611,0,113611,1.0,0,10940.69,4927.83,10940.07,4927.61,240
240,5826,6105,4723,4950,279,227,43879,0,43879,1.0,0,5987.2,4846.87,5986.49,4846.34,241
241,6548,6961,4733,5073,413,340,85295,0,85295,1.0,0,6748.2,4909.59,6747.84,4909.15,242
242,12579,12813,4739,4941,234,202,32581,0,32581,1.0,0,12687.13,4840.37,12686.7,4839.94,243
243,7652,8053,4751,5148,401,397,98079,853,97226,0.9913029292713017,0,7844.53,4944.17,7844.05,4943.81,244
244,10233,10780,4754,5102,547,348,125778,0,125778,1.0,0,10490.97,4914.81,10490.63,4914.32,245
245,4211,4680,4758,5219,469,461,139214,0,139214,1.0,0,4418.57,4969.95,4418.18,4969.57,246
246,11893,12438,4765,5307,545,542,196905,0,196905,1.0,0,12164.02,5002.8,12163.51,5002.46,247
247,5085,5297,4800,5028,212,228,26364,0,26364,1.0,0,5190.71,4911.16,5190.07,4910.87,248
248,7976,8514,4812,5109,538,297,111267,0,111267,1.0,0,8226.64,4955.98,8226.36,4955.6,249
249,7378,7694,4814,5040,316,226,51130,0,51130,1.0,0,7534.92,4933.31,7534.35,4932.85,250
250,2990,3911,4815,5511,921,696,413869,0,413869,1.0,0,3477.03,5140.33,3476.38,5139.84,251
251,6851,7102,4825,5099,251,274,39747,0,39747,1.0,0,6978.22,4974.1,6977.8,4973.47,252
252,7076,7400,4857,5057,324,200,47257,0,47257,1.0,0,7239.58,4956.76,7239.01,4956.36,253
253,2322,2943,4859,5383,621,524,179296,0,179296,1.0,0,2655.71,5082.91,2655.09,5082.6,254
254,9078,9679,4867,5407,601,540,222846,0,222846,1.0,0,9369.58,5107.63,9369.05,5107.32,255
255,12417,12691,4870,5205,274,335,63067,0,63067,1.0,0,12539.77,5024.52,12539.3,5024.1,256
256,1868,2450,4877,5231,582,354,132237,0,132237,1.0,0,2113.59,5062.72,2113.48,5062.36,257
257,5214,5371,4890,5110,157,220,22443,0,22443,1.0,0,5299.04,4997.79,5298.39,4997.37,258
258,5532,5874,4902,5180,342,278,54670,0,54670,1.0,0,5733.77,5059.35,5733.07,5058.75,259
259,12677,12861,4910,5021,184,111,14739,0,14739,1.0,0,12760.79,4961.33,12760.43,4960.88,260
260,5854,6312,4919,5300,458,381,98560,0,98560,1.0,0,6058.09,5092.7,6057.76,5092.39,261
261,13025,13359,4921,5143,334,222,40012,0,40012,1.0,0,13204.01,5022.24,13202.93,5021.97,262
262,1381,1640,4948,5189,259,241,42965,0,42965,1.0,0,1521.1,5062.88,1520.52,5062.45,263
263,12604,13180,4974,5475,576,501,190499,0,190499,1.0,0,12886.37,5217.31,12885.95,5216.85,264
264,10206,10930,4977,5444,724,467,226349,0,226349,1.0,0,10573.03,5202.37,10572.38,5201.76,265
265,4927,5240,4983,5287,313,304,56365,0,56365,1.0,0,5102.27,5135.09,5101.55,5134.57,266
266,13342,13498,4992,5216,156,224,21944,0,21944,1.0,0,13418.21,5089.63,13417.74,5089.36,267
267,7541,7762,5000,5130,221,130,14853,0,14853,1.0,0,7669.17,5063.86,7668.26,5063.28,269
268,4350,4975,5001,5573,625,572,208146,0,208146,1.0,0,4641.76,5258.38,4641.39,5257.93,268
269,7104,7362,5013,5174,258,161,27558,1495,26063,0.9457507801727266,0,7225.37,5094.54,7225.15,5093.81,270
270,7325,7547,5019,5191,222,172,27516,0,27516,1.0,0,7436.96,5103.9,7436.47,5103.29,271
271,1628,1899,5020,5193,271,173,34494,0,34494,1.0,0,1769.42,5097.68,1768.84,5097.23,272
272,6307,6670,5024,5208,363,184,42754,345,42409,0.9919305795948917,0,6488.26,5120.3,6487.85,5119.73,273
273,2901,3160,5030,5291,259,261,38218,0,38218,1.0,0,3004.57,5185.51,3004.29,5184.9,275
274,6587,6895,5030,5276,308,246,46537,1217,45320,0.9738487654984206,0,6733.49,5155.42,6733.07,5154.8,274
275,8994,9084,5039,5144,90,105,5085,0,5085,1.0,0,9050.61,5082.54,9050.01,5082.25,276
276,4344,10648,5047,10616,6304,5569,11324533,161079,11163454,0.9857761022021835,0,7332.84,7920.71,7333.0,7919.59,278
277,5163,5629,5048,5549,466,501,171440,0,171440,1.0,0,5392.59,5295.69,5392.1,5295.17,277
278,13063,13405,5054,5329,342,275,57685,0,57685,1.0,0,13239.11,5183.1,13238.51,5182.62,279
279,1241,1532,5056,5464,291,408,70355,0,70355,1.0,0,1384.22,5264.92,1383.75,5264.36,280
280,11353,12251,5059,5718,898,659,329767,0,329767,1.0,0,11797.53,5394.58,11797.01,5394.06,281
281,7916,8037,5060,5141,121,81,7109,2551,4558,0.6411590941060628,1,7967.4,5098.41,7967.18,5097.79,282
282,10841,11391,5119,5601,550,482,160586,0,160586,1.0,0,11105.7,5361.97,11105.26,5361.48,283
283,6189,6337,5123,5294,148,171,13874,548,13326,0.9605016577771371,0,6266.77,5225.52,6266.31,5224.7,287
284,12294,12646,5125,5441,352,316,60910,0,60910,1.0,0,12444.03,5269.7,12443.76,5269.21,284
285,5596,6026,5127,5548,430,421,119780,0,119780,1.0,0,5809.66,5321.73,5809.17,5321.3,285
286,1510,1829,5130,5395,319,265,56006,0,56006,1.0,0,1654.04,5263.58,1653.72,5263.1,286
287,2164,2831,5147,5552,667,405,140017,0,140017,1.0,0,2516.56,5338.66,2516.01,5338.24,288
288,1758,1972,5165,5325,214,160,21714,0,21714,1.0,0,1868.17,5236.05,1867.62,5235.56,289
289,6456,6681,5175,5368,225,193,28501,572,27929,0.979930528753377,0,6566.54,5276.36,6566.02,5275.7,290
290,3853,4435,5188,5620,582,432,129499,0,129499,1.0,0,4132.55,5369.08,4132.08,5368.69,291
291,9413,10100,5190,5613,687,423,176457,0,176457,1.0,0,9770.41,5397.52,9769.86,5397.07,292
292,4752,5246,5195,5672,494,477,139319,0,139319,1.0,0,5017.13,5425.71,5016.6,5425.29,293
293,6315,6494,5196,5344,179,148,17924,1095,16829,0.9389087257308636,0,6400.34,5267.19,6399.86,5266.68,294
294,12155,12315,5203,5371,160,168,18657,0,18657,1.0,0,12243.49,5291.12,12242.95,5290.56,295
295,1878,2249,5208,5445,371,237,43379,0,43379,1.0,0,2066.01,5311.45,2065.47,5311.02,296
296,13257,13571,5215,5530,314,315,63995,0,63995,1.0,0,13418.04,5377.16,13417.46,5376.76,297
297,2743,3428,5220,5796,685,576,212313,0,212313,1.0,0,3119.08,5496.24,3118.44,5495.85,298
298,10038,10546,5222,5745,508,523,152446,0,152446,1.0,0,10285.95,5476.24,10285.51,5475.72,299
299,5968,6191,5231,5442,223,211,32450,0,32450,1.0,0,6092.62,5339.02,6091.95,5338.62,300
300,8410,8808,5232,5406,398,174,44874,0,44874,1.0,0,8599.64,5313.98,8599.35,5313.35,301
301,8800,9017,5243,5436,217,193,33478,0,33478,1.0,0,8914.43,5336.47,8913.88,5335.98,302
302,9006,9451,5256,5565,445,309,82732,873,81859,0.9894478557269255,0,9215.11,5400.24,9214.72,5399.81,303
303,6188,6381,5266,5450,193,184,22944,0,22944,1.0,0,6285.2,5355.06,6284.73,5354.58,304
304,12373,12935,5286,5717,562,431,156823,0,156823,1.0,0,12642.26,5507.76,12641.7,5507.24,305
305,1091,1320,5290,5494,229,204,31332,0,31332,1.0,0,1194.6,5387.31,1194.28,5386.86,306
306,13113,13269,5291,5493,156,202,23043,0,23043,1.0,0,13199.48,5393.1,13198.91,5392.59,307
307,8684,8845,5298,5430,161,132,14116,0,14116,1.0,0,8768.14,5373.69,8767.66,5373.08,308
308,1672,2128,5311,5759,456,448,147982,0,147982,1.0,0,1894.86,5539.48,1894.34,5538.99,309
309,2069,2516,5319,5702,447,383,106890,0,106890,1.0,0,2305.64,5503.78,2305.22,5503.47,310
310,1427,1697,5326,5596,270,270,47630,0,47630,1.0,0,1565.22,5466.52,1564.7,5465.91,311
311,13497,13993,5340,5774,496,434,108868,0,108868,1.0,0,13778.8,5561.6,13778.06,5561.01,312
312,10484,11141,5347,5760,657,413,164889,0,164889,1.0,0,10806.61,5578.44,10806.22,5577.89,313
313,12008,12440,5353,5874,432,521,131449,0,131449,1.0,0,12249.98,5626.02,12249.39,5625.46,314
314,5414,5728,5356,5711,314,355,56910,0,56910,1.0,0,5583.24,5538.59,5582.5,5538.22,315
315,6083,6281,5371,5538,198,167,20158,0,20158,1.0,0,6185.7,5460.6,6185.11,5460.08,316
316,12906,13339,5396,5750,433,354,90276,0,90276,1.0,0,13127.21,5584.61,13126.59,5584.07,317
317,3411,4071,5409,6002,660,593,308551,0,308551,1.0,0,3757.04,5689.33,3756.49,5688.88,318
318,1213,1526,5411,5711,313,300,68902,0,68902,1.0,0,1357.96,5574.56,1357.54,5574.03,319
319,8924,9120,5415,5526,196,111,13310,1117,12193,0.9160781367392937,0,9016.83,5472.66,9016.46,5472.12,320
320,5894,6106,5425,5577,212,152,22093,0,22093,1.0,0,6002.69,5495.58,6002.13,5495.15,321
321,3949,4626,5437,6249,677,812,333981,0,333981,1.0,0,4304.98,5817.89,4304.4,5817.53,322
322,4601,4937,5444,5861,336,417,87599,0,87599,1.0,0,4766.98,5664.06,4766.47,5663.56,323
323,1058,1224,5458,5652,166,194,24747,0,24747,1.0,0,1141.51,5561.98,1141.01,5561.41,324
324,13267,13734,5464,5807,467,343,70498,0,70498,1.0,0,13485.55,5628.71,13485.21,5628.3,325
325,9272,9624,5477,5748,352,271,54090,0,54090,1.0,0,9462.57,5599.64,9461.97,5599.21,326
326,9051,9287,5485,5674,236,189,28640,262,28378,0.9908519553072626,0,9163.05,5578.2,9162.62,5577.72,327
327,9939,10298,5512,5955,359,443,77498,0,77498,1.0,0,10120.31,5712.91,10119.79,5712.5,328
328,11082,11747,5514,6065,665,551,244382,0,244382,1.0,0,11404.97,5793.54,11404.46,5793.06,329
329,2491,3267,5518,6209,776,691,360531,0,360531,1.0,0,2878.73,5869.68,2878.11,5869.15,330
330,6011,6166,5518,5663,155,145,16744,0,16744,1.0,0,6089.24,5590.43,6088.74,5589.91,331
331,4853,5148,5523,5777,295,254,37492,0,37492,1.0,0,4980.34,5657.27,4979.96,5656.57,332
332,5175,5453,5529,5722,278,193,36080,1257,34823,0.9651607538802661,0,5313.52,5617.0,5312.97,5616.52,333
333,9519,9930,5537,5858,411,321,88218,0,88218,1.0,0,9739.06,5695.37,9738.49,5694.97,334
334,11704,12128,5548,5960,424,412,100825,0,100825,1.0,0,11923.88,5763.04,11923.25,5762.59,335
335,5577,5740,5557,5748,163,191,18425,0,18425,1.0,0,5665.21,5663.58,5664.77,5662.85,336
336,2133,2550,5580,5960,417,380,79020,0,79020,1.0,0,2350.14,5766.44,2349.32,5765.61,337
337,1459,1797,5582,5859,338,277,63932,0,63932,1.0,0,1628.86,5716.58,1628.21,5716.25,338
338,1689,2289,5585,6157,600,572,192412,0,192412,1.0,0,2008.32,5910.48,2007.92,5909.75,339
339,9907,10027,5599,5746,120,147,10156,0,10156,1.0,0,9960.81,5688.67,9960.35,5687.95,340
340,12701,13056,5609,5977,355,368,98700,0,98700,1.0,0,12866.9,5790.41,12866.42,5789.95,341
341,7116,7476,5619,5936,360,317,84450,0,84450,1.0,0,7309.46,5767.76,7308.89,5767.37,342
342,1026,1280,5625,5902,254,277,46451,0,46451,1.0,0,1141.42,5753.88,1141.03,5753.46,343
343,9290,9502,5644,5856,212,212,25549,0,25549,1.0,0,9395.28,5755.35,9394.68,5754.73,344
344,10191,10839,5645,6255,648,610,264132,0,264132,1.0,0,10498.86,5951.14,10498.33,5950.67,345
345,6752,7108,5646,5978,356,332,69926,0,69926,1.0,0,6965.92,5803.19,6965.15,5802.73,346
346,5249,5446,5653,5871,197,218,27314,0,27314,1.0,0,5352.58,5767.61,5352.07,5767.07,347
347,5040,5291,5663,5971,251,308,46220,598,45622,0.9870618779749026,0,5148.36,5811.94,5147.99,5811.38,348
348,12968,13425,5668,6183,457,515,159442,0,159442,1.0,0,13206.51,5931.17,13206.03,5930.57,349
349,12333,12767,5679,6144,434,465,129217,0,129217,1.0,0,12556.3,5888.68,12555.85,5888.31,350
350,13349,13546,5684,5910,197,226,27376,0,27376,1.0,0,13442.69,5793.93,13442.22,5793.47,351
351,1202,1485,5689,6008,283,319,63963,1673,62290,0.9738442537091756,1,1344.58,5840.49,1344.15,5840.08,352
352,7089,7180,5694,5914,91,220,11618,0,11618,1.0,0,7122.51,5818.49,7122.08,5817.71,353
353,3148,3766,5702,6443,618,741,280225,0,280225,1.0,0,3456.99,6075.54,3456.38,6074.97,354
354,10644,10856,5704,5882,212,178,22154,0,22154,1.0,0,10757.3,5777.92,10756.7,5777.39,355
355,10818,11102,5719,6017,284,298,54099,0,54099,1.0,0,10936.88,5851.29,10936.47,5850.93,356
356,9819,10113,5728,6013,294,285,52496,0,52496,1.0,0,9960.1,5875.33,9959.61,5874.84,357
357,13497,13934,5730,6093,437,363,81371,0,81371,1.0,0,13704.52,5905.64,13704.47,5904.99,358
358,4875,5066,5750,5932,191,182,19643,0,19643,1.0,0,4983.16,5836.9,4982.46,5836.51,359
359,4514,4938,5751,6253,424,502,131853,0,131853,1.0,0,4717.2,5989.16,4716.66,5988.72,360
360,13704,13937,5753,5919,233,166,19045,0,19045,1.0,0,13807.57,5843.17,13807.35,5842.58,361
361,6647,6917,5761,5997,270,236,26032,0,26032,1.0,0,6801.98,5860.59,6801.26,5860.22,362
362,1181,1792,5799,6430,611,631,218743,2,218741,0.9999908568502763,0,1498.56,6123.26,1498.0,6122.73,363
363,9589,9904,5820,6018,315,198,33380,1926,31454,0.9423007789095267,1,9736.25,5911.13,9736.11,5911.01,364
364,11989,12594,5828,6478,605,650,278872,0,278872,1.0,0,12271.48,6159.37,12271.03,6158.86,365
365,5152,5336,5833,6071,184,238,28708,0,28708,1.0,0,5244.92,5950.87,5244.38,5950.44,366
366,10805,11285,5840,6250,480,410,111450,0,111450,1.0,0,11050.57,6058.05,11050.08,6057.48,367
367,8204,8371,5847,5964,167,117,12485,0,12485,1.0,0,8284.52,5906.7,8284.08,5906.2,368
368,7501,7626,5869,5993,125,124,9095,0,9095,1.0,0,7567.14,5933.96,7566.52,5933.5,369
369,2130,2804,5870,6679,674,809,377991,0,377991,1.0,0,2495.23,6262.45,2494.66,6261.98,370
370,7973,8099,5875,5985,126,110,9358,0,9358,1.0,0,8044.52,5925.77,8043.79,5925.2,371
371,7399,7535,5877,5992,136,115,10424,0,10424,1.0,0,7471.7,5933.64,7471.09,5933.24,372
372,7831,8006,5880,5974,175,94,10174,0,10174,1.0,0,7926.31,5921.24,7925.65,5920.83,373
373,7292,7440,5883,6005,148,122,9138,0,9138,1.0,0,7362.19,5943.78,7361.79,5943.28,374
374,11032,12035,5891,6699,1003,808,554754,0,554754,1.0,0,11566.14,6302.11,11565.58,6301.65,375
375,7085,7266,5895,6037,181,142,14368,2116,12252,0.852728285077951,1,7167.74,5955.25,7166.96,5955.05,376
376,7661,7864,5897,6043,203,146,14969,3268,11701,0.7816821430957311,1,7765.59,5974.4,7765.01,5973.82,377
377,8097,8145,5897,5937,48,40,1348,0,1348,1.0,0,8116.94,5919.18,8116.64,5918.64,378
378,8140,8247,5899,5975,107,76,4424,0,4424,1.0,0,8185.89,5941.2,8185.89,5940.73,379
379,4857,5165,5901,6173,308,272,45726,0,45726,1.0,0,5017.35,6028.1,5016.78,6027.74,380
380,7619,7729,5905,5957,110,52,3781,0,3781,1.0,0,7672.78,5927.82,7672.35,5927.47,381
381,13397,13609,5906,6147,212,241,32358,0,32358,1.0,0,13499.85,6018.18,13499.37,6017.82,382
382,1046,1321,5908,6111,275,203,35411,0,35411,1.0,0,1179.0,6011.55,1178.6,6011.1,383
383,8342,8492,5908,5998,150,90,7559,0,7559,1.0,0,8413.28,5950.28,8412.97,5949.89,384
384,7267,7333,5911,5960,66,49,1828,0,1828,1.0,0,7303.36,5929.83,7302.55,5929.7,385
385,8091,8162,5932,6010,71,78,3622,0,3622,1.0,0,8121.86,5970.09,8121.48,5969.6,386
386,7610,7664,5936,5993,54,57,2032,0,2032,1.0,0,7636.64,5961.91,7636.16,5961.56,387
387,7229,7298,5939,5991,69,52,2407,569,1838,0.7636061487328625,0,7268.19,5965.83,7267.64,5965.34,388
388,8200,8368,5939,6030,168,91,8210,0,8210,1.0,0,8284.3,5986.1,8283.99,5985.46,390
389,7030,7121,5941,6005,91,64,3707,0,3707,1.0,0,7079.96,5971.9,7079.34,5971.45,389
390,5223,5441,5943,6152,218,209,23794,0,23794,1.0,0,5340.88,6040.63,5340.14,6040.3,391
391,7849,7926,5945,5990,77,45,1925,0,1925,1.0,0,7891.32,5964.43,7890.67,5964.02,392
392,9912,10259,5946,6230,347,284,71679,1053,70626,0.9853095048759051,0,10090.06,6077.25,10089.53,6076.78,393
393,6944,7002,5953,5990,58,37,1505,0,1505,1.0,0,6968.11,5974.43,6967.92,5973.84,394
394,12581,13121,5953,6518,540,565,209178,0,209178,1.0,0,12838.0,6226.8,12837.54,6226.37,395
395,7588,7635,5957,6017,47,60,1454,0,1454,1.0,0,7611.85,5989.64,7611.3,5988.96,398
396,7924,8034,5958,6041,110,83,6347,0,6347,1.0,0,7976.27,5996.96,7975.9,5996.53,396
397,6809,6947,5959,6083,138,124,11585,0,11585,1.0,0,6883.88,6024.69,6883.48,6024.19,397
398,8447,8599,5959,6091,152,132,10593,0,10593,1.0,0,8524.32,6026.35,8523.59,6025.79,399
399,7821,7928,5962,6030,107,68,4898,0,4898,1.0,0,7868.27,5999.75,7867.93,5999.19,400
400,7468,7525,5969,6059,57,90,3697,0,3697,1.0,0,7495.54,6012.07,7495.05,6011.61,401
401,6930,7099,5972,6091,169,119,11452,1435,10017,0.8746943765281173,1,7005.57,6026.7,7005.19,6026.25,402
402,8131,8251,5972,6056,120,84,6262,0,6262,1.0,0,8188.37,6015.16,8187.89,6014.71,403
403,8021,8152,5973,6113,131,140,12023,0,12023,1.0,0,8084.56,6043.92,8083.97,6043.37,404
404,7158,7305,5974,6056,147,82,7046,2721,4325,0.613823445926767,1,7229.03,6012.72,7228.81,6012.14,405
405,7331,7413,5975,6052,82,77,4147,0,4147,1.0,0,7371.98,6012.26,7371.46,6011.8,406
406,8331,8487,5975,6107,156,132,12193,0,12193,1.0,0,8406.42,6032.41,8405.94,6032.04,407
407,7635,7685,5976,6022,50,46,1362,0,1362,1.0,0,7659.71,5999.01,7659.29,5998.54,408
408,4359,4625,5983,6349,266,366,54875,0,54875,1.0,0,4499.69,6178.18,4499.18,6177.46,409
409,7521,7559,5985,6026,38,41,1136,0,1136,1.0,0,7538.5,6005.01,7538.06,6004.52,410
410,3708,4264,5986,6610,556,624,247771,0,247771,1.0,0,3978.91,6295.01,3978.38,6294.46,411
411,7394,7453,5986,6067,59,81,3386,0,3386,1.0,0,7427.86,6026.31,7427.25,6025.9,412
412,7546,7615,5987,6072,69,85,3943,0,3943,1.0,0,7580.15,6027.79,7579.64,6027.33,413
413,7450,7482,5990,6071,32,81,1549,0,1549,1.0,0,7462.57,6033.6,7462.18,6033.0,414
414,7667,7704,6002,6050,37,48,1142,0,1142,1.0,0,7686.11,6025.4,7685.64,6024.91,415
415,6646,6819,6003,6156,173,153,18724,2993,15731,0.8401516769920957,1,6734.39,6076.81,6733.93,6076.32,416
416,13499,13882,6003,6461,383,458,109016,0,109016,1.0,0,13674.7,6246.39,13674.23,6245.77,418
417,7280,7335,6004,6039,55,35,1355,0,1355,1.0,0,7309.92,6021.05,7309.23,6020.55,417
418,7610,7669,6007,6064,59,57,2209,0,2209,1.0,0,7637.64,6034.72,7637.17,6034.28,419
419,13770,14053,6008,6280,283,272,48454,2146,46308,0.9557105708507038,1,13907.0,6138.84,13906.68,6138.48,420
420,7892,7945,6009,6065,53,56,2105,0,2105,1.0,0,7917.95,6039.23,7917.52,6038.57,421
421,9739,10012,6012,6289,273,277,44151,1153,42998,0.9738850762157143,0,9875.55,6156.98,9875.06,6156.41,422
422,8203,8307,6013,6076,104,63,3673,0,3673,1.0,0,8260.77,6051.58,8259.98,6050.93,423
423,7735,7836,6016,6060,101,44,2959,0,2959,1.0,0,7782.1,6039.9,7781.83,6039.27,424
424,8302,8355,6017,6107,53,90,3279,0,3279,1.0,0,8326.81,6061.14,8326.33,6060.63,425
425,7833,8050,6019,6120,217,101,10399,0,10399,1.0,0,7954.54,6072.96,7953.41,6072.55,426
426,7219,7296,6025,6107,77,82,3861,0,3861,1.0,0,7259.85,6068.12,7259.39,6067.51,427
427,7101,7190,6026,6083,89,57,3188,0,3188,1.0,0,7143.69,6052.0,7143.35,6051.51,429
428,7502,7555,6026,6076,53,50,1783,0,1783,1.0,0,7529.98,6049.1,7529.36,6048.74,428
429,7833,7895,6027,6070,62,43,2231,0,2231,1.0,0,7866.06,6048.06,7865.45,6047.52,430
430,7059,7108,6034,6083,49,49,1750,0,1750,1.0,0,7083.82,6062.8,7083.4,6062.06,431
431,7281,7368,6034,6113,87,79,4511,0,4511,1.0,0,7323.38,6074.12,7322.88,6073.73,432
432,7358,7418,6038,6083,60,45,1907,0,1907,1.0,0,7386.59,6062.7,7386.16,6062.16,433
433,7627,7695,6039,6118,68,79,3010,0,3010,1.0,0,7659.6,6075.4,7659.15,6075.03,434
434,7693,7749,6039,6089,56,50,1930,0,1930,1.0,0,7719.83,6061.2,7719.37,6060.78,435
435,7159,7231,6041,6131,72,90,4252,0,4252,1.0,0,7194.27,6087.92,7193.85,6087.35,436
436,7777,7840,6041,6092,63,51,1876,0,1876,1.0,0,7810.45,6071.53,7810.1,6070.74,439
437,8337,8385,6042,6119,48,77,2036,0,2036,1.0,0,8361.8,6083.6,8361.25,6082.92,437
438,8123,8353,6043,6223,230,180,23074,0,23074,1.0,0,8222.46,6139.6,8222.28,6139.12,438
439,6473,6651,6045,6202,178,157,16611,1954,14657,0.8823671061344892,1,6557.11,6120.7,6556.72,6120.18,440
440,8399,8527,6045,6167,128,122,7854,0,7854,1.0,0,8468.39,6111.18,8467.67,6110.58,441
441,1623,2206,6047,6481,583,434,160256,0,160256,1.0,0,1917.43,6277.92,1916.9,6277.47,442
442,7576,7632,6049,6101,56,52,1609,0,1609,1.0,0,7608.53,6074.56,7607.85,6074.05,443
443,6984,7100,6055,6120,116,65,4549,0,4549,1.0,0,7037.76,6086.74,7037.44,6086.24,445
444,939,1059,6056,6188,120,132,9695,0,9695,1.0,0,1003.82,6125.49,1003.27,6124.95,444
445,7727,7784,6056,6107,57,51,1707,0,1707,1.0,0,7756.43,6081.12,7755.82,6080.72,446
446,7462,7527,6059,6117,65,58,2645,0,2645,1.0,0,7492.32,6087.68,7491.87,6087.22,447
447,7411,7468,6061,6098,57,37,1493,0,1493,1.0,0,7440.31,6079.37,7439.74,6078.9,450
448,7526,7576,6061,6099,50,38,1337,0,1337,1.0,0,7551.5,6080.26,7550.98,6079.74,448
449,6814,6866,6062,6106,52,44,1159,0,1159,1.0,0,6833.59,6080.61,6833.35,6080.29,449
450,8515,8612,6066,6183,97,117,6626,0,6626,1.0,0,8561.51,6124.22,8561.14,6123.71,451
451,1011,1236,6067,6340,225,273,37907,0,37907,1.0,0,1116.14,6198.27,1115.83,6197.81,452
452,7658,7757,6067,6147,99,80,4761,0,4761,1.0,0,7707.72,6115.05,7707.15,6114.33,453
453,13067,13528,6068,6508,461,440,136559,0,136559,1.0,0,13309.7,6296.27,13309.2,6295.74,455
454,8217,8304,6069,6123,87,54,3350,0,3350,1.0,0,8257.64,6093.4,8257.2,6092.89,454
455,4807,5045,6072,6424,238,352,57971,0,57971,1.0,0,4923.33,6253.53,4922.77,6252.97,456
456,6808,6908,6073,6151,100,78,3660,0,3660,1.0,0,6862.09,6108.49,6861.65,6108.0,458
457,7091,7167,6073,6143,76,70,3756,0,3756,1.0,0,7130.43,6105.15,7129.89,6104.75,457
458,6885,7009,6076,6136,124,60,4611,0,4611,1.0,0,6941.61,6105.19,6941.45,6104.58,459
459,7570,7617,6079,6127,47,48,1224,0,1224,1.0,0,7591.03,6101.07,7590.64,6100.68,460
460,7364,7422,6081,6127,58,46,1792,0,1792,1.0,0,7394.46,6101.95,7393.82,6101.34,461
461,7750,7918,6086,6203,168,117,12413,0,12413,1.0,0,7826.18,6141.82,7825.87,6141.23,462
462,7862,8078,6087,6257,216,170,16103,0,16103,1.0,0,7970.1,6176.09,7969.8,6175.46,464
463,7502,7591,6088,6166,89,78,4210,0,4210,1.0,0,7548.8,6126.12,7548.35,6125.58,463
464,7306,7376,6090,6144,70,54,2235,0,2235,1.0,0,7341.04,6119.99,7340.67,6119.36,465
465,7899,8009,6091,6156,110,65,4621,0,4621,1.0,0,7959.73,6123.01,7959.0,6122.5,466
466,7262,7307,6093,6149,45,56,1552,0,1552,1.0,0,7286.42,6121.54,7285.81,6120.92,467
467,7413,7469,6094,6137,56,43,1721,0,1721,1.0,0,7441.55,6114.0,7441.04,6113.6,468
468,10392,11085,6095,6663,693,568,217346,0,217346,1.0,0,10711.25,6365.35,10710.88,6364.99,470
469,5040,5153,6096,6306,113,210,16558,0,16558,1.0,0,5093.62,6218.01,5093.15,6217.1,474
470,6554,6670,6096,6199,116,103,4753,0,4753,1.0,0,6617.2,6152.71,6616.59,6152.13,469
471,7198,7277,6098,6184,79,86,4721,0,4721,1.0,0,7235.84,6141.83,7235.35,6141.31,471
472,7905,8145,6098,6345,240,247,28926,0,28926,1.0,0,8044.13,6242.25,8043.61,6241.6,472
473,7588,7663,6101,6157,75,56,2579,0,2579,1.0,0,7625.79,6128.97,7625.27,6128.47,473
474,6904,7091,6105,6217,187,112,11555,0,11555,1.0,0,6984.51,6160.4,6984.64,6159.59,475
475,8342,8424,6106,6188,82,82,4761,0,4761,1.0,0,8381.88,6144.84,8381.45,6144.41,476
476,6795,6866,6109,6207,71,98,4934,0,4934,1.0,0,6828.53,6162.48,6828.0,6161.83,477
477,7045,7134,6112,6204,89,92,5512,0,5512,1.0,0,7092.0,6161.71,7091.42,6161.1,478
478,7454,7509,6114,6151,55,37,1446,0,1446,1.0,0,7484.13,6132.47,7483.47,6132.01,479
479,7359,7460,6119,6186,101,67,4356,0,4356,1.0,0,7412.74,6152.88,7412.03,6152.21,480
480,6726,6798,6122,6195,72,73,3097,0,3097,1.0,0,6769.88,6156.97,6769.19,6156.44,481
481,7131,7199,6122,6171,68,49,1892,0,1892,1.0,0,7162.82,6147.28,7162.44,6146.7,482
482,7634,7690,6127,6181,56,54,1982,658,1324,0.6680121089808274,0,7665.47,6155.78,7664.83,6155.25,483
483,6865,6919,6133,6175,54,42,1656,0,1656,1.0,0,6891.05,6155.2,6890.62,6154.64,484
484,7291,7371,6137,6185,80,48,2205,0,2205,1.0,0,7335.78,6156.91,7334.96,6156.46,485
485,8456,8539,6137,6213,83,76,3491,0,3491,1.0,0,8502.6,6170.87,8501.96,6170.5,486
486,7389,7512,6138,6345,123,207,12790,0,12790,1.0,0,7458.15,6255.29,7457.81,6254.31,488
487,8573,8702,6138,6238,129,100,8095,0,8095,1.0,0,8633.74,6189.99,8633.31,6189.38,487
488,7680,7792,6139,6240,112,101,7757,0,7757,1.0,0,7731.15,6188.26,7730.75,6187.77,490
489,7567,7683,6141,6227,116,86,5801,3012,2789,0.4807791760041372,1,7623.82,6189.02,7623.25,6188.42,489
490,7486,7577,6142,6220,91,78,4953,0,4953,1.0,0,7528.8,6180.01,7528.38,6179.57,491
491,6626,6763,6143,6215,137,72,6026,0,6026,1.0,0,6700.13,6179.89,6699.28,6179.3,493
492,7222,7297,6143,6219,75,76,2967,0,2967,1.0,0,7263.35,6185.46,7262.77,6184.82,494
493,6338,6473,6144,6255,135,111,7921,0,7921,1.0,0,6402.99,6192.57,6402.45,6192.2,492
494,8395,8498,6145,6256,103,111,6442,0,6442,1.0,0,8445.44,6203.72,8444.91,6203.08,495
495,10124,10458,6146,6371,334,225,42854,0,42854,1.0,0,10278.61,6259.05,10278.29,6258.63,496
496,7111,7221,6149,6256,110,107,6447,0,6447,1.0,0,7161.13,6201.89,7160.74,6201.38,497
497,7355,7399,6161,6205,44,44,1142,0,1142,1.0,0,7378.33,6181.53,7377.75,6181.11,498
498,7287,7341,6162,6205,54,43,1171,0,1171,1.0,0,7311.86,6182.28,7311.22,6181.95,499
499,7014,7113,6170,6263,99,93,4583,0,4583,1.0,0,7067.84,6218.73,7067.18,6218.1,500
500,6838,6933,6173,6245,95,72,4866,0,4866,1.0,0,6887.89,6211.47,6887.31,6210.94,501
501,8477,8597,6175,6300,120,125,9792,0,9792,1.0,0,8540.51,6239.23,8539.96,6238.75,502
502,8214,8323,6176,6293,109,117,8201,0,8201,1.0,0,8271.1,6227.7,8270.41,6227.49,503
503,8313,8423,6178,6295,110,117,8347,0,8347,1.0,0,8366.54,6233.6,8365.99,6233.24,504
504,7338,7382,6179,6225,44,46,1290,0,1290,1.0,0,7357.56,6204.11,7357.17,6203.49,505
505,6511,6642,6180,6283,131,103,8202,0,8202,1.0,0,6568.81,6229.48,6568.55,6228.9,506
506,7351,7441,6182,6277,90,95,4904,0,4904,1.0,0,7395.34,6228.29,7394.76,6227.9,507
507,6393,6507,6183,6259,114,76,3544,0,3544,1.0,0,6445.71,6215.56,6445.16,6215.26,508
508,8655,8763,6185,6255,108,70,4284,0,4284,1.0,0,8707.09,6219.28,8706.69,6218.9,509
509,4198,4486,6187,6511,288,324,50800,0,50800,1.0,0,4350.2,6358.14,4349.44,6357.4,510
510,6609,6780,6188,6300,171,112,11363,0,11363,1.0,0,6681.03,6248.46,6680.84,6247.99,511
511,6742,6845,6188,6263,103,75,5309,0,5309,1.0,0,6794.47,6226.05,6793.91,6225.49,512
512,7289,7406,6191,6332,117,141,7756,0,7756,1.0,0,7340.47,6269.22,7339.94,6268.53,513
513,7489,7640,6196,6338,151,142,11956,1586,10370,0.8673469387755102,0,7560.89,6259.29,7560.53,6258.9,514
514,7740,7894,6198,6286,154,88,9840,0,9840,1.0,0,7818.26,6242.47,7817.76,6241.97,516
515,2909,3445,6199,6744,536,545,197988,0,197988,1.0,0,3171.54,6447.34,3171.05,6446.9,515
516,6396,6519,6199,6303,123,104,6946,0,6946,1.0,0,6467.27,6257.5,6466.7,6256.88,517
517,6267,6358,6201,6302,91,101,6350,0,6350,1.0,0,6316.23,6254.1,6315.69,6253.66,518
518,6940,7019,6201,6243,79,42,2138,0,2138,1.0,0,6983.38,6223.58,6982.71,6223.04,519
519,4459,4834,6202,6550,375,348,80940,0,80940,1.0,0,4665.56,6367.25,4664.9,6366.88,521
520,2749,3170,6203,6741,421,538,79282,0,79282,1.0,0,2905.79,6489.26,2905.93,6489.36,520
521,8109,8246,6203,6344,137,141,12115,0,12115,1.0,0,8178.03,6267.19,8177.63,6266.82,522
522,7209,7308,6205,6323,99,118,5995,0,5995,1.0,0,7268.67,6267.66,7267.91,6267.07,523
523,7198,7265,6208,6285,67,77,3006,0,3006,1.0,0,7231.91,6244.78,7231.3,6244.49,524
524,7161,7215,6210,6279,54,69,2559,0,2559,1.0,0,7189.28,6239.14,7188.72,6238.86,525
525,6564,7151,6217,6565,587,348,97485,0,97485,1.0,0,6860.88,6394.89,6860.79,6394.38,526
526,7638,7767,6220,6295,129,75,6621,0,6621,1.0,0,7699.41,6259.88,7698.96,6259.32,527
527,8697,8832,6221,6288,135,67,6080,1700,4380,0.7203947368421053,0,8768.53,6257.76,8767.82,6257.28,528
528,9985,10145,6221,6364,160,143,17299,2310,14989,0.8664662697265738,1,10066.73,6289.32,10066.22,6288.83,529
529,13828,14044,6234,6502,216,268,38107,1709,36398,0.9551525966357887,1,13945.87,6365.63,13945.37,6365.17,530
530,6804,6898,6236,6316,94,80,4608,0,4608,1.0,0,6847.54,6276.04,6847.34,6275.36,532
531,8507,8712,6237,6388,205,151,13649,0,13649,1.0,0,8601.54,6307.41,8600.99,6306.99,531
532,7109,7250,6239,6411,141,172,12136,0,12136,1.0,0,7175.97,6324.38,7175.27,6323.78,533
533,8367,8500,6247,6351,133,104,9190,0,9190,1.0,0,8435.36,6297.7,8434.94,6297.26,535
534,994,1408,6252,6700,414,448,102702,0,102702,1.0,0,1202.69,6479.67,1202.23,6479.22,536
535,7623,7962,6252,6439,339,187,33548,0,33548,1.0,0,7790.07,6339.24,7789.77,6338.74,537
536,6544,6627,6254,6340,83,86,5307,0,5307,1.0,0,6586.77,6300.75,6586.29,6300.16,539
537,6329,6403,6255,6321,74,66,2726,0,2726,1.0,0,6370.19,6285.64,6369.38,6285.41,538
538,6740,6808,6257,6312,68,55,2765,0,2765,1.0,0,6776.02,6284.81,6775.56,6284.31,540
539,7631,7669,6258,6302,38,44,1130,0,1130,1.0,0,7649.14,6282.27,7648.64,6281.63,541
540,6152,6271,6260,6317,119,57,3617,0,3617,1.0,0,6209.2,6286.72,6208.91,6286.18,542
541,9868,10067,6262,6437,199,175,15742,0,15742,1.0,0,9971.67,6347.3,9971.19,6346.75,543
542,8225,8392,6268,6409,167,141,17094,0,17094,1.0,0,8307.08,6337.23,8306.62,6336.77,544
543,6659,6770,6272,6355,111,83,5442,0,5442,1.0,0,6713.49,6320.19,6713.06,6319.61,545
544,6481,6549,6277,6350,68,73,3418,0,3418,1.0,0,6513.0,6311.55,6512.55,6311.09,547
545,8655,8796,6277,6396,141,119,10898,0,10898,1.0,0,8728.26,6331.85,8727.81,6331.27,546
546,6191,6294,6280,6361,103,81,4050,0,4050,1.0,0,6237.34,6319.23,6236.95,6318.7,548
547,7476,7647,6281,6525,171,244,27253,1736,25517,0.9363005907606502,0,7563.25,6407.88,7563.01,6407.18,549
548,8791,8899,6281,6362,108,81,5657,0,5657,1.0,0,8843.68,6318.33,8843.31,6317.96,551
549,6383,6488,6282,6395,105,113,7175,0,7175,1.0,0,6427.01,6331.03,6426.69,6330.76,550
550,8492,8557,6287,6333,65,46,1876,0,1876,1.0,0,8525.42,6308.56,8524.78,6308.05,552
551,6287,6329,6292,6324,42,32,817,0,817,1.0,0,6308.18,6306.61,6307.62,6306.22,553
552,6602,6672,6295,6368,70,73,2903,0,2903,1.0,0,6636.52,6332.29,6636.13,6331.56,554
553,6048,6194,6300,6399,146,99,11066,13,11053,0.9988252304355684,0,6122.65,6349.05,6122.16,6348.57,555
554,7217,7355,6300,6412,138,112,10606,0,10606,1.0,0,7290.42,6359.28,7289.84,6358.71,556
555,6357,6386,6303,6368,29,65,1396,0,1396,1.0,0,6371.93,6336.51,6371.41,6335.89,558
556,7490,7541,6303,6344,51,41,1309,0,1309,1.0,0,7521.73,6324.81,7520.74,6324.44,557
557,8578,8732,6303,6513,154,210,15873,0,15873,1.0,0,8656.8,6406.58,8656.29,6406.22,559
558,6302,6360,6306,6389,58,83,3336,0,3336,1.0,0,6329.47,6347.9,6328.95,6347.35,560
559,6207,6305,6310,6420,98,110,6010,0,6010,1.0,0,6262.78,6364.72,6262.18,6364.22,563
560,7339,7483,6310,6392,144,82,7425,0,7425,1.0,0,7407.56,6351.44,7407.14,6350.99,564
561,7909,8072,6310,6433,163,123,10740,0,10740,1.0,0,7999.24,6369.5,7998.38,6369.09,561
562,10118,10522,6310,6645,404,335,79627,11,79616,0.9998618559031485,0,10325.33,6478.03,10324.75,6477.42,562
563,8063,8252,6311,6502,189,191,26280,0,26280,1.0,0,8156.0,6404.5,8155.49,6404.1,565
564,8349,8513,6312,6482,164,170,15195,0,15195,1.0,0,8441.19,6395.88,8440.71,6395.21,566
565,6506,6560,6326,6373,54,47,1415,0,1415,1.0,0,6531.64,6348.77,6531.19,6348.32,567
566,8762,8829,6326,6390,67,64,2605,0,2605,1.0,0,8794.21,6357.98,8793.64,6357.5,568
567,5954,6068,6328,6448,114,120,5895,2024,3871,0.6566581849024598,0,6018.95,6399.89,6018.32,6399.15,569
568,13453,13599,6330,6471,146,141,11681,0,11681,1.0,0,13511.42,6408.91,13511.21,6408.43,570
569,6525,6609,6338,6451,84,113,5504,0,5504,1.0,0,6564.78,6387.0,6564.42,6386.72,571
570,3469,3880,6342,6800,411,458,105859,0,105859,1.0,0,3684.91,6557.38,3684.37,6556.93,572
571,6660,6709,6343,6387,49,44,1279,0,1279,1.0,0,6688.21,6362.55,6687.49,6362.09,573
572,6443,6508,6346,6383,65,37,1911,0,1911,1.0,0,6475.4,6364.55,6474.94,6363.95,574
573,8807,8865,6348,6450,58,102,4000,0,4000,1.0,0,8837.06,6397.61,8836.51,6397.24,575
574,1351,1732,6351,6616,381,265,54281,0,54281,1.0,0,1540.41,6471.05,1539.93,6470.66,576
575,8861,9014,6352,6497,153,145,13671,0,13671,1.0,0,8936.19,6421.8,8935.73,6421.37,577
576,12316,12831,6352,6758,515,406,129982,0,129982,1.0,0,12559.78,6562.12,12559.44,6561.62,580
577,10023,10245,6353,6647,222,294,37460,4590,32870,0.8774693005872931,1,10135.32,6506.35,10134.79,6505.75,578
578,6638,6690,6354,6405,52,51,1779,0,1779,1.0,0,6661.12,6380.16,6660.75,6379.63,579
579,6999,7500,6358,6574,501,216,63369,1779,61590,0.9719263362211807,1,7263.67,6470.35,7263.06,6469.88,581
580,6187,6261,6360,6456,74,96,3216,0,3216,1.0,0,6225.81,6415.66,6224.96,6414.42,582
581,6324,6390,6361,6416,66,55,2221,0,2221,1.0,0,6354.69,6394.07,6354.29,6393.41,584
582,6998,7061,6361,6395,63,34,1575,0,1575,1.0,0,7030.3,6379.08,7029.73,6378.66,583
583,6367,6400,6363,6402,33,39,628,0,628,1.0,0,6385.78,6380.51,6385.2,6380.13,586
584,6582,6672,6363,6433,90,70,3961,0,3961,1.0,0,6619.34,6402.65,6619.13,6402.16,585
585,6440,6575,6368,6529,135,161,11752,0,11752,1.0,0,6507.93,6446.86,6507.34,6446.41,587
586,12014,12352,6369,6811,338,442,82966,0,82966,1.0,0,12191.07,6587.96,12190.37,6587.29,588
587,6120,6211,6371,6458,91,87,5104,0,5104,1.0,0,6165.58,6418.92,6165.17,6418.31,590
588,7785,7942,6371,6507,157,136,14934,0,14934,1.0,0,7866.54,6436.56,7865.98,6436.12,589
589,6388,6449,6372,6465,61,93,3635,0,3635,1.0,0,6421.87,6419.79,6421.38,6419.08,591
590,8497,8537,6375,6413,40,38,1159,0,1159,1.0,0,8515.59,6395.51,8515.16,6394.97,592
591,6245,6330,6378,6454,85,76,3862,0,3862,1.0,0,6295.63,6422.06,6294.83,6421.61,594
592,8762,8829,6378,6470,67,92,3335,0,3335,1.0,0,8795.16,6421.62,8794.82,6421.25,593
593,6977,7124,6379,6455,147,76,5857,0,5857,1.0,0,7050.92,6413.55,7050.35,6413.05,595
594,8475,8630,6381,6513,155,132,11769,0,11769,1.0,0,8559.88,6444.67,8559.44,6444.34,596
595,8251,8294,6385,6429,43,44,1259,0,1259,1.0,0,8267.4,6405.44,8267.09,6405.03,597
596,7618,7790,6388,6520,172,132,14666,0,14666,1.0,0,7703.99,6447.97,7703.47,6447.53,598
597,6063,6130,6389,6459,67,70,2705,0,2705,1.0,0,6098.47,6418.16,6098.05,6417.99,599
598,13625,13960,6390,6763,335,373,74239,0,74239,1.0,0,13787.95,6555.53,13787.49,6555.1,600
599,8718,8762,6394,6442,44,48,1628,0,1628,1.0,0,8738.49,6416.3,8738.04,6415.87,601
600,12785,13238,6394,6957,453,563,170893,3999,166894,0.9765993926023886,1,13022.81,6640.0,13022.36,6639.72,602
601,4769,4917,6396,6595,148,199,18741,0,18741,1.0,0,4848.01,6489.64,4847.48,6489.11,603
602,7935,8110,6404,6533,175,129,14564,0,14564,1.0,0,8024.76,6462.35,8024.3,6461.96,604
603,8192,8443,6404,6596,251,192,34002,0,34002,1.0,0,8323.23,6504.79,8322.67,6504.27,605
604,6320,6403,6407,6502,83,95,5676,0,5676,1.0,0,6361.92,6453.6,6361.33,6452.96,606
605,6019,6109,6411,6501,90,90,4963,2667,2296,0.46262341325811,1,6063.65,6458.33,6063.17,6457.76,607
606,8708,8824,6412,6502,116,90,4823,0,4823,1.0,0,8764.95,6465.02,8764.47,6464.54,609
607,9010,9135,6413,6566,125,153,13233,140,13093,0.9894203884228822,0,9071.97,6494.2,9071.38,6493.56,608
608,10333,11186,6420,6866,853,446,185007,0,185007,1.0,0,10831.92,6660.23,10830.67,6659.85,610
609,2002,2507,6422,6942,505,520,187324,0,187324,1.0,0,2243.74,6695.11,2243.26,6694.57,611
610,8827,8888,6425,6480,61,55,2093,0,2093,1.0,0,8859.62,6450.63,8859.09,6450.21,613
611,1559,2082,6426,7162,523,736,268259,0,268259,1.0,0,1829.48,6772.16,1829.04,6771.8,612
612,5893,6021,6431,6536,128,105,10529,1832,8697,0.8260043688859341,1,5950.78,6479.67,5950.48,6479.09,614
613,6439,6482,6433,6480,43,47,1733,0,1733,1.0,0,6461.2,6456.89,6460.67,6456.39,615
614,4104,4335,6436,6760,231,324,39667,0,39667,1.0,0,4222.75,6607.39,4222.41,6606.73,616
615,3249,3660,6442,7000,411,558,123532,0,123532,1.0,0,3445.69,6756.26,3445.23,6755.53,617
616,6163,6226,6443,6488,63,45,2252,0,2252,1.0,0,6195.46,6465.78,6194.92,6465.29,618
617,8871,8920,6444,6496,49,52,1427,0,1427,1.0,0,8893.96,6472.88,8893.53,6472.21,620
618,5789,5904,6445,6612,115,167,10687,0,10687,1.0,0,5848.32,6529.31,5847.81,6528.86,619
619,4300,4686,6450,6882,386,432,108101,1098,107003,0.9898428321662149,1,4509.33,6642.55,4508.73,6642.15,621
620,6210,6303,6451,6517,93,66,4019,0,4019,1.0,0,6256.14,6480.7,6255.63,6480.28,622
621,6243,6347,6451,6648,104,197,11069,2503,8566,0.7738729785888517,1,6293.86,6558.59,6293.44,6557.72,623
622,13169,13718,6451,6891,549,440,177595,0,177595,1.0,0,13422.26,6677.26,13421.87,6676.77,624
623,6104,6165,6454,6495,61,41,1621,0,1621,1.0,0,6131.36,6471.98,6131.08,6471.54,625
624,6383,6480,6458,6549,97,91,4567,0,4567,1.0,0,6430.79,6497.93,6430.26,6497.56,626
625,8428,8828,6460,6756,400,296,51780,0,51780,1.0,0,8648.0,6609.47,8647.16,6608.75,627
626,8821,8872,6460,6504,51,44,1364,0,1364,1.0,0,8845.75,6483.52,8845.21,6482.91,628
627,7868,8055,6464,6585,187,121,13052,0,13052,1.0,0,7957.21,6529.6,7956.86,6529.04,629
628,6635,7004,6468,6800,369,332,69125,0,69125,1.0,0,6823.98,6618.02,6823.7,6617.65,630
629,11771,12178,6470,6993,407,523,110525,0,110525,1.0,0,11986.94,6720.72,11986.47,6720.48,631
630,8881,8951,6471,6527,70,56,1690,0,1690,1.0,0,8916.11,6497.28,8915.5,6496.82,632
631,5991,6069,6476,6539,78,63,2907,0,2907,1.0,0,6032.19,6507.89,6031.58,6507.43,633
632,6129,6186,6476,6520,57,44,1637,0,1637,1.0,0,6156.33,6497.62,6155.91,6497.12,634
633,7697,7884,6476,6612,187,136,17333,0,17333,1.0,0,7791.72,6548.7,7791.2,6548.2,635
634,8641,8750,6477,6576,109,99,7428,0,7428,1.0,0,8700.42,6522.46,8699.9,6522.12,636
635,4675,4826,6478,6675,151,197,20144,0,20144,1.0,0,4748.54,6584.04,4748.06,6583.4,637
636,8963,9028,6481,6563,65,82,3250,0,3250,1.0,0,8993.24,6519.33,8992.73,6519.0,638
637,13897,14104,6481,6673,207,192,28250,0,28250,1.0,0,14011.03,6584.8,14010.42,6584.3,639
638,7573,7712,6483,6563,139,80,8326,0,8326,1.0,0,7643.42,6526.64,7642.9,6526.12,640
639,8744,8880,6485,6588,136,103,9052,1434,7618,0.8415819708351745,1,8803.45,6534.12,8803.12,6533.65,641
640,8861,8910,6485,6550,49,65,1600,0,1600,1.0,0,8885.33,6523.07,8884.65,6522.12,644
641,6067,6130,6486,6528,63,42,1892,0,1892,1.0,0,6097.27,6507.74,6096.84,6507.21,642
642,6145,6219,6488,6541,74,53,2180,0,2180,1.0,0,6186.42,6516.52,6185.53,6516.12,643
643,8910,8970,6490,6552,60,62,2669,0,2669,1.0,0,8943.13,6523.96,8942.55,6523.37,645
644,8028,8234,6494,6670,206,176,26568,0,26568,1.0,0,8135.82,6583.34,8135.29,6582.82,647
645,6473,6653,6495,6729,180,234,25869,0,25869,1.0,0,6564.23,6614.36,6563.73,6613.79,646
646,6309,6504,6496,6638,195,142,17655,1173,16482,0.9335598980458794,1,6401.46,6568.68,6401.11,6568.14,648
647,7399,7597,6499,6657,198,158,20381,0,20381,1.0,0,7491.35,6570.9,7490.9,6570.49,650
648,14095,14310,6499,6702,215,203,32096,0,32096,1.0,0,14194.06,6608.06,14193.6,6607.52,649
649,9118,9182,6503,6588,64,85,2311,0,2311,1.0,0,9147.65,6539.7,9146.95,6539.68,651
650,6068,6145,6507,6604,77,97,4227,0,4227,1.0,0,6106.64,6554.79,6106.24,6554.25,652
651,6963,7092,6507,6671,129,164,11326,0,11326,1.0,0,7014.71,6585.36,7014.37,6584.9,653
652,6193,6268,6509,6613,75,104,5235,0,5235,1.0,0,6231.17,6558.62,6230.56,6558.15,654
653,7147,7313,6512,6648,166,136,15268,0,15268,1.0,0,7228.53,6571.31,7228.02,6570.94,655
654,8979,9044,6517,6606,65,89,3340,2161,1179,0.3529940119760479,1,9014.71,6567.91,9014.23,6567.13,658
655,11441,11852,6517,7011,411,494,116320,0,116320,1.0,0,11646.3,6759.1,11645.57,6758.62,659
656,5951,6028,6519,6576,77,57,2626,0,2626,1.0,0,5988.89,6544.27,5988.38,6543.87,656
657,6026,6077,6521,6566,51,45,1484,0,1484,1.0,0,6053.36,6544.71,6052.82,6544.15,657
658,9131,9241,6527,6618,110,91,6014,0,6014,1.0,0,9188.09,6577.09,9187.55,6576.53,660
659,5893,5952,6531,6586,59,55,2269,0,2269,1.0,0,5920.5,6554.42,5920.04,6554.08,661
660,14273,14474,6536,6709,201,173,25284,0,25284,1.0,0,14386.18,6616.46,14385.58,6616.0,662
661,6139,6203,6537,6588,64,51,2119,0,2119,1.0,0,6174.01,6558.14,6173.4,6557.81,663
662,8406,8556,6540,6669,150,129,14408,0,14408,1.0,0,8486.69,6604.93,8486.08,6604.4,664
663,8867,8986,6542,6637,119,95,5381,0,5381,1.0,0,8931.1,6587.65,8930.36,6587.06,665
664,5725,5787,6544,6611,62,67,2526,0,2526,1.0,0,5751.38,6570.8,5750.91,6570.56,666
665,861,1689,6547,7155,828,608,306400,0,306400,1.0,0,1312.49,6860.78,1311.82,6860.27,667
666,5912,5985,6548,6642,73,94,3794,0,3794,1.0,0,5947.82,6594.64,5947.12,6594.24,669
667,8952,8987,6548,6600,35,52,1187,0,1187,1.0,0,8968.99,6575.59,8968.45,6574.96,668
668,3842,4168,6550,7026,326,476,93426,0,93426,1.0,0,4002.58,6770.64,4002.06,6770.08,670
669,5969,6044,6553,6641,75,88,3267,0,3267,1.0,0,6006.1,6592.2,6005.46,6591.99,671
670,7299,7403,6553,6650,104,97,7038,0,7038,1.0,0,7353.86,6595.82,7353.3,6595.45,672
671,9040,9076,6553,6592,36,39,960,102,858,0.89375,0,9054.59,6572.67,9054.28,6572.11,673
672,6120,6173,6555,6597,53,42,1522,0,1522,1.0,0,6144.73,6579.8,6144.23,6579.16,674
673,8791,8915,6558,6674,124,116,7109,0,7109,1.0,0,8838.11,6610.47,8837.95,6609.97,675
674,7836,8043,6559,6704,207,145,20723,0,20723,1.0,0,7943.43,6628.91,7942.83,6628.4,677
675,6035,6086,6560,6623,51,63,2297,0,2297,1.0,0,6059.36,6593.95,6058.91,6593.38,676
676,8227,8277,6561,6614,50,53,1659,0,1659,1.0,0,8247.07,6587.07,8246.71,6586.61,678
677,7571,7736,6562,6676,165,114,13988,0,13988,1.0,0,7652.72,6615.35,7652.26,6614.9,679
678,5728,5819,6563,6638,91,75,4100,0,4100,1.0,0,5777.24,6610.07,5776.68,6609.37,680
679,9221,9357,6565,6725,136,160,10502,0,10502,1.0,0,9280.36,6651.8,9279.97,6651.25,682
680,9061,9134,6566,6654,73,88,4254,0,4254,1.0,0,9095.23,6604.32,9094.73,6603.98,681
681,7001,7206,6568,6797,205,229,31582,0,31582,1.0,0,7107.94,6680.86,7107.45,6680.38,683
682,2433,2962,6570,7188,529,618,209689,0,209689,1.0,0,2681.64,6894.58,2681.17,6893.94,684
683,5833,5918,6572,6633,85,61,3912,0,3912,1.0,0,5878.0,6601.87,5877.43,6601.42,685
684,6106,6214,6582,6670,108,88,5402,0,5402,1.0,0,6155.27,6620.49,6154.88,6619.99,686
685,8318,8421,6588,6632,103,44,3054,0,3054,1.0,0,8371.83,6607.52,8371.19,6607.05,687
686,9019,9071,6588,6646,52,58,2010,0,2010,1.0,0,9046.56,6616.07,9046.06,6615.78,688
687,8212,8458,6592,6738,246,146,22744,0,22744,1.0,0,8330.77,6665.8,8330.35,6665.23,689
688,5637,5729,6596,6726,92,130,7702,0,7702,1.0,0,5685.36,6657.25,5684.71,6656.96,690
689,8853,8955,6596,6692,102,96,7015,0,7015,1.0,0,8900.24,6647.54,8899.89,6647.07,691
690,8986,9032,6597,6664,46,67,1555,0,1555,1.0,0,9008.18,6625.06,9007.85,6625.01,692
691,5896,6049,6599,6718,153,119,8473,0,8473,1.0,0,5979.97,6669.14,5979.32,6668.47,695
692,9113,9155,6599,6656,42,57,1753,0,1753,1.0,0,9136.49,6628.6,9135.91,6628.09,694
693,914,1160,6600,6735,246,135,24930,0,24930,1.0,0,1039.08,6670.49,1038.54,6669.99,693
694,5817,5860,6603,6658,43,55,1398,0,1398,1.0,0,5836.61,6629.7,5836.27,6629.27,697
695,6041,6106,6603,6653,65,50,1984,0,1984,1.0,0,6077.98,6630.09,6077.32,6629.46,696
696,6356,6478,6605,6675,122,70,5411,0,5411,1.0,0,6419.94,6640.2,6419.66,6639.74,698
697,7195,7344,6605,6741,149,136,13597,0,13597,1.0,0,7269.76,6676.13,7269.32,6675.56,702
698,7698,7911,6605,6772,213,167,26271,0,26271,1.0,0,7803.22,6692.64,7802.73,6692.1,699
699,9153,9199,6605,6664,46,59,2031,0,2031,1.0,0,9174.5,6634.44,9174.03,6633.96,700
700,6141,6252,6606,6725,111,119,6624,0,6624,1.0,0,6192.46,6668.5,6192.2,6667.89,701
701,10173,10442,6606,6854,269,248,41207,4498,36709,0.8908437886766811,1,10297.13,6723.35,10296.7,6722.85,703
702,7464,7609,6610,6740,145,130,12510,0,12510,1.0,0,7535.55,6674.14,7535.1,6673.65,704
703,7303,7479,6612,6785,176,173,20436,0,20436,1.0,0,7393.79,6708.72,7393.26,6708.12,706
704,2793,3041,6613,6909,248,296,38793,0,38793,1.0,0,2934.32,6742.94,2933.79,6742.59,705
705,9193,9223,6615,6649,30,34,769,0,769,1.0,0,9209.7,6630.5,9209.0,6630.22,707
706,5918,5982,6622,6658,64,36,1723,0,1723,1.0,0,5951.77,6641.52,5951.15,6640.99,708
707,10996,11516,6623,7152,520,529,198057,0,198057,1.0,0,11260.96,6907.37,11260.3,6906.73,709
708,8954,9022,6624,6676,68,52,2037,0,2037,1.0,0,8986.72,6649.64,8986.41,6649.26,710
709,7984,8146,6628,6816,162,188,17445,0,17445,1.0,0,8066.02,6723.0,8065.51,6722.36,711
710,5848,5919,6629,6679,71,50,2390,0,2390,1.0,0,5882.38,6651.2,5881.91,6650.78,712
711,5699,5831,6630,6762,132,132,11293,0,11293,1.0,0,5757.96,6694.44,5757.66,6693.81,713
712,6024,6148,6635,6720,124,85,5955,0,5955,1.0,0,6085.56,6679.73,6085.11,6679.21,714
713,6250,6379,6635,6725,129,90,5953,78,5875,0.9868973626742819,0,6320.02,6676.62,6319.11,6676.44,715
714,9022,9078,6637,6689,56,52,1956,0,1956,1.0,0,9052.54,6661.85,9051.98,6661.41,716
715,13741,14146,6640,6879,405,239,54633,0,54633,1.0,0,13939.29,6751.85,13938.63,6751.46,717
716,8531,8624,6641,6730,93,89,5123,0,5123,1.0,0,8578.76,6685.42,8578.18,6684.89,718
717,9076,9141,6641,6695,65,54,2191,0,2191,1.0,0,9109.24,6666.3,9108.8,6665.89,719
718,6200,6295,6644,6715,95,71,4397,1530,2867,0.6520354787355015,1,6245.45,6678.02,6245.06,6677.48,720
719,6028,6058,6646,6677,30,31,612,0,612,1.0,0,6041.76,6660.15,6041.26,6659.77,721
720,9195,9264,6647,6718,69,71,3416,0,3416,1.0,0,9222.89,6685.24,9222.54,6684.62,722
721,8110,8332,6648,6898,222,250,34724,0,34724,1.0,0,8217.76,6778.16,8217.34,6777.66,724
722,5797,5872,6649,6727,75,78,3606,0,3606,1.0,0,5831.95,6691.34,5831.53,6690.7,725
723,6913,7033,6649,6772,120,123,10009,0,10009,1.0,0,6966.57,6712.48,6966.17,6712.01,723
724,4046,4480,6652,7131,434,479,126231,3692,122539,0.9707520339694686,1,4273.95,6902.75,4273.41,6902.27,726
725,9120,9198,6653,6732,78,79,3729,0,3729,1.0,0,9163.5,6689.25,9162.95,6688.75,727
726,8954,9011,6656,6697,57,41,1451,0,1451,1.0,0,8976.22,6678.72,8976.02,6678.12,728
727,5866,6583,6661,7023,717,362,125064,0,125064,1.0,0,6210.35,6824.4,6209.84,6824.03,729
728,13739,14542,6661,7178,803,517,254964,2698,252266,0.9894181139298097,1,14153.94,6929.82,14153.63,6929.44,730
729,8431,8583,6666,6795,152,129,12066,0,12066,1.0,0,8508.14,6726.45,8507.63,6725.98,731
730,4668,4783,6668,6787,115,119,9585,0,9585,1.0,0,4728.52,6720.54,4727.99,6720.21,732
731,9299,9430,6668,6813,131,145,9876,3266,6610,0.6692993114621304,1,9372.57,6733.56,9372.08,6733.24,733
732,8963,9077,6669,6781,114,112,7207,0,7207,1.0,0,9020.71,6725.83,9019.89,6725.41,737
733,12134,12582,6669,6925,448,256,71368,0,71368,1.0,0,12386.35,6804.23,12385.63,6803.84,734
734,7551,7741,6670,6831,190,161,21522,0,21522,1.0,0,7647.75,6749.16,7647.24,6748.69,735
735,8827,8863,6670,6699,36,29,759,0,759,1.0,0,8842.61,6683.86,8842.25,6683.43,736
736,5842,5928,6672,6788,86,116,5973,0,5973,1.0,0,5888.74,6730.68,5888.2,6730.19,738
737,9066,9124,6679,6732,58,53,2333,0,2333,1.0,0,9094.53,6706.17,9094.02,6705.64,739
738,8902,8964,6683,6720,62,37,1471,0,1471,1.0,0,8935.62,6699.31,8935.03,6698.82,740
739,8813,8965,6685,6781,152,96,8565,0,8565,1.0,0,8886.13,6732.06,8886.02,6731.81,741
740,13575,13766,6687,7015,191,328,38241,0,38241,1.0,0,13676.9,6835.46,13676.41,6835.23,742
741,5481,5654,6690,6915,173,225,18890,0,18890,1.0,0,5570.43,6799.88,5569.84,6799.63,743
742,6567,6733,6692,6878,166,186,20802,0,20802,1.0,0,6653.96,6781.12,6653.47,6780.73,744
743,9237,9288,6692,6746,51,54,1448,0,1448,1.0,0,9260.72,6720.05,9260.33,6719.49,746
744,12561,12963,6693,7083,402,390,108590,0,108590,1.0,0,12756.06,6885.68,12755.62,6885.19,745
745,6713,6844,6695,6868,131,173,14626,0,14626,1.0,0,6773.79,6776.63,6773.37,6776.22,747
746,6078,6154,6696,6776,76,80,3523,0,3523,1.0,0,6109.98,6728.12,6109.46,6727.93,748
747,8950,8991,6697,6759,41,62,1766,0,1766,1.0,0,8969.91,6730.33,8969.37,6729.65,749
748,5920,5986,6698,6750,66,52,2013,0,2013,1.0,0,5950.86,6722.19,5950.36,6721.79,750
749,7895,8035,6698,6813,140,115,8997,0,8997,1.0,0,7964.66,6757.39,7964.16,6756.96,752
750,7909,7943,6699,6727,34,28,826,0,826,1.0,0,7925.85,6713.7,7925.33,6713.19,751
751,5921,6081,6704,6790,160,86,9140,0,9140,1.0,0,6007.27,6751.78,6006.58,6751.31,753
752,8309,8504,6710,6853,195,143,19874,0,19874,1.0,0,8401.26,6785.07,8400.92,6784.54,754
753,9115,9192,6713,6768,77,55,2939,0,2939,1.0,0,9156.78,6738.85,9156.19,6738.41,755
754,3418,3919,6715,7148,501,433,112591,0,112591,1.0,0,3688.7,6934.59,3688.01,6934.2,756
755,7442,7568,6715,6827,126,112,9074,0,9074,1.0,0,7503.89,6775.4,7503.34,6774.82,758
756,8660,9044,6715,7105,384,390,68392,1016,67376,0.9851444613405077,0,8856.58,6901.45,8856.03,6900.94,757
757,9184,9271,6716,6813,87,97,5297,0,5297,1.0,0,9228.16,6762.08,9227.71,6761.69,759
758,5568,5715,6717,6918,147,201,14788,0,14788,1.0,0,5647.04,6824.93,5646.53,6824.4,760
759,7127,7333,6718,6882,206,164,22811,0,22811,1.0,0,7227.62,6803.47,7227.14,6802.92,761
760,8554,8683,6722,6853,129,131,10952,0,10952,1.0,0,8619.35,6787.25,8618.8,6786.78,763
761,9260,9301,6722,6762,41,40,1022,0,1022,1.0,0,9282.32,6742.95,9281.66,6742.46,764
762,3016,3280,6723,6891,264,168,36872,0,36872,1.0,0,3146.75,6807.21,3146.32,6806.65,762
763,5746,5847,6725,6804,101,79,4346,0,4346,1.0,0,5797.49,6762.81,5797.04,6762.29,765
764,9051,9148,6725,6786,97,61,3704,0,3704,1.0,0,9098.13,6757.72,9097.65,6757.14,766
765,4619,4745,6738,6916,126,178,14224,0,14224,1.0,0,4686.87,6828.06,4686.26,6827.5,768
766,5452,5534,6739,6811,82,72,4178,0,4178,1.0,0,5496.49,6772.29,5495.95,6771.78,769
767,9262,9380,6744,6839,118,95,5889,1922,3967,0.673628799456614,1,9327.2,6789.84,9326.65,6789.44,770
768,6919,6956,6750,6795,37,45,936,0,936,1.0,0,6936.4,6772.44,6935.97,6771.94,771
769,5779,5892,6751,6856,113,105,6939,0,6939,1.0,0,5835.54,6803.72,5834.97,6803.25,772
770,6924,7129,6753,6913,205,160,22768,0,22768,1.0,0,7022.82,6832.53,7022.37,6832.02,773
771,7685,7950,6754,6971,265,217,43531,0,43531,1.0,0,7817.27,6863.36,7816.8,6862.84,774
772,5676,5749,6756,6879,73,123,4883,0,4883,1.0,0,5710.3,6818.96,5709.96,6818.3,776
773,8863,8936,6756,6833,73,77,3362,0,3362,1.0,0,8897.55,6787.12,8897.08,6786.85,775
774,9006,9134,6757,6837,128,80,6277,331,5946,0.9472678030906484,0,9063.95,6800.5,9063.62,6799.93,777
775,9130,9210,6762,6833,80,71,4026,0,4026,1.0,0,9169.86,6796.88,9169.43,6796.31,778
776,5395,5472,6767,6834,77,67,3317,0,3317,1.0,0,5430.14,6798.44,5429.78,6798.0,779
777,10325,10619,6771,7122,294,351,53837,3872,49965,0.9280792020357747,1,10473.11,6923.37,10472.78,6923.19,780
778,7300,7476,6774,6890,176,116,14416,0,14416,1.0,0,7390.4,6833.96,7389.89,6833.41,782
779,8905,9033,6774,6894,128,120,8046,1317,6729,0.8363161819537659,1,8969.02,6823.62,8968.63,6823.27,781
780,9375,9502,6775,6920,127,145,10962,0,10962,1.0,0,9446.04,6844.65,9445.52,6844.23,783
781,6902,6940,6776,6820,38,44,966,0,966,1.0,0,6919.77,6798.0,6919.37,6797.52,784
782,5281,5424,6780,6952,143,172,13417,0,13417,1.0,0,5350.47,6863.26,5350.02,6862.79,785
783,5883,5933,6782,6831,50,49,1567,0,1567,1.0,0,5906.75,6804.67,5906.27,6804.27,787
784,6485,6588,6782,6869,103,87,6122,0,6122,1.0,0,6533.79,6820.09,6533.37,6819.73,786
785,6783,6938,6786,6906,155,120,12890,0,12890,1.0,0,6864.41,6853.48,6863.81,6852.93,788
786,10570,11076,6788,7279,506,491,176422,0,176422,1.0,0,10849.74,7020.57,10849.21,7020.04,789
787,5722,5788,6789,6870,66,81,3844,2010,1834,0.47710718002081165,1,5752.68,6830.23,5752.3,6829.77,790
788,8461,8599,6789,6939,138,150,13640,0,13640,1.0,0,8536.87,6861.71,8536.31,6861.27,791
789,7435,7705,6791,7014,270,223,44229,0,44229,1.0,0,7567.84,6910.64,7567.34,6910.09,792
790,9249,9315,6794,6847,66,53,2153,0,2153,1.0,0,9282.38,6818.06,9281.86,6817.63,793
791,7939,8196,6797,6990,257,193,34231,0,34231,1.0,0,8056.7,6887.16,8056.36,6886.63,795
792,9190,9280,6797,6866,90,69,3783,0,3783,1.0,0,9230.43,6835.95,9230.12,6835.44,794
793,5417,5529,6801,6863,112,62,4056,0,4056,1.0,0,5473.29,6830.91,5472.67,6830.42,796
794,9091,9215,6808,6909,124,101,7272,1277,5995,0.8243949394939494,0,9153.97,6861.28,9153.39,6860.62,797
795,9301,9347,6810,6863,46,53,1367,0,1367,1.0,0,9321.93,6836.98,9321.5,6836.46,798
796,5252,5303,6812,6894,51,82,2159,497,1662,0.7698008337193145,0,5279.57,6843.0,5278.93,6843.01,799
797,4451,4696,6820,7041,245,221,29577,0,29577,1.0,0,4587.04,6930.14,4586.46,6929.68,801
798,5812,5894,6820,6904,82,84,4007,0,4007,1.0,0,5857.8,6861.52,5857.13,6860.92,800
799,6516,6683,6827,6964,167,137,15949,0,15949,1.0,0,6596.05,6901.23,6595.58,6900.66,802
800,8596,8731,6832,6947,135,115,9788,0,9788,1.0,0,8663.65,6887.2,8663.24,6886.78,803
801,8967,9120,6834,6927,153,93,10237,1834,8403,0.8208459509621959,1,9046.81,6882.17,9046.21,6881.72,804
802,8286,8515,6838,6991,229,153,26037,0,26037,1.0,0,8394.93,6916.09,8394.5,6915.58,806
803,9329,9403,6838,6906,74,68,3242,0,3242,1.0,0,9364.98,6867.99,9364.56,6867.57,805
804,11576,12186,6838,7510,610,672,271036,0,271036,1.0,0,11865.4,7160.28,11864.89,7159.79,807
805,6661,6809,6840,6969,148,129,12822,0,12822,1.0,0,6732.73,6912.22,6732.28,6911.62,810
806,9279,9338,6840,6892,59,52,1398,0,1398,1.0,0,9308.96,6866.02,9308.43,6865.52,808
807,6426,6529,6841,6935,103,94,6876,0,6876,1.0,0,6480.08,6890.82,6479.53,6890.2,809
808,6942,7282,6843,7096,340,253,55085,0,55085,1.0,0,7111.22,6986.91,7110.78,6986.42,811
809,7224,7435,6845,7065,211,220,27541,0,27541,1.0,0,7315.76,6950.43,7315.4,6949.93,812
810,10233,10368,6847,6972,135,125,10487,1679,8808,0.839897015352341,0,10306.98,6909.88,10306.33,6909.24,813
811,552,801,6849,7058,249,209,28466,0,28466,1.0,0,682.88,6945.39,682.26,6944.84,814
812,5382,5496,6851,6928,114,77,4761,0,4761,1.0,0,5440.12,6888.07,5439.87,6887.61,815
813,5520,5909,6855,7078,389,223,46669,2644,44025,0.9433456898583642,0,5733.22,6964.14,5732.44,6963.68,816
814,9260,9324,6855,6921,64,66,2332,0,2332,1.0,0,9287.36,6888.78,9287.06,6888.28,817
815,5708,5782,6859,6900,74,41,1985,832,1153,0.5808564231738035,0,5750.36,6880.8,5749.53,6880.25,818
816,9200,9289,6861,6949,89,88,4068,0,4068,1.0,0,9238.25,6900.22,9238.06,6900.06,819
817,9373,9461,6865,6939,88,74,3001,0,3001,1.0,0,9420.17,6905.73,9419.42,6905.06,821
818,6312,6448,6866,6981,136,115,10543,0,10543,1.0,0,6378.28,6923.09,6377.83,6922.62,820
819,9494,9559,6867,6925,65,58,2370,0,2370,1.0,0,9524.37,6898.6,9523.88,6898.11,822
820,8136,8345,6873,7092,209,219,29445,0,29445,1.0,0,8234.75,6985.53,8234.31,6984.97,823
821,13133,13684,6877,7303,551,426,166997,0,166997,1.0,0,13420.78,7056.55,13420.18,7056.19,824
822,2801,3345,6883,7589,544,706,269703,0,269703,1.0,0,3090.76,7194.99,3090.49,7194.73,825
823,6769,6993,6884,7028,224,144,21652,0,21652,1.0,0,6881.23,6957.74,6880.78,6957.19,826
824,7408,7439,6885,6928,31,43,1057,0,1057,1.0,0,7423.96,6906.43,7423.52,6905.93,827
825,9310,9391,6887,6975,81,88,4662,0,4662,1.0,0,9351.56,6931.51,9351.04,6931.0,829
826,12093,12645,6887,7391,552,504,205019,0,205019,1.0,0,12363.2,7121.98,12362.62,7121.54,828
827,12886,13199,6888,7165,313,277,56307,5148,51159,0.9085726463849966,1,13047.93,7030.29,13047.43,7029.83,830
828,9082,9197,6890,6955,115,65,4025,11,4014,0.9972670807453416,0,9130.57,6924.06,9130.56,6923.38,831
829,754,975,6892,7141,221,249,39621,0,39621,1.0,0,856.37,7022.33,855.94,7021.78,832
830,10558,10655,6894,7013,97,119,7059,0,7059,1.0,0,10601.02,6960.74,10600.62,6960.16,833
831,5418,5533,6897,6982,115,85,5661,0,5661,1.0,0,5473.02,6933.32,5472.77,6933.02,834
832,8575,8704,6898,7037,129,139,10471,0,10471,1.0,0,8641.33,6966.39,8640.66,6965.83,835
833,7880,7972,6901,6970,92,69,3072,0,3072,1.0,0,7929.48,6937.56,7928.6,6937.15,837
834,1973,2557,6902,7479,584,577,233868,0,233868,1.0,0,2266.23,7169.85,2265.74,7169.34,836
835,9176,9244,6902,6982,68,80,2522,0,2522,1.0,0,9210.5,6942.04,9209.98,6941.46,839
836,6218,6321,6903,7031,103,128,8949,0,8949,1.0,0,6264.26,6961.26,6263.81,6960.92,838
837,5296,5455,6906,7027,159,121,10305,1916,8389,0.8140708393983503,1,5379.07,6972.32,5378.5,6972.02,840
838,9287,9530,6908,7081,243,173,21545,1525,20020,0.9292179159897889,1,9417.14,6997.73,9416.59,6997.01,841
839,9235,9379,6911,7006,144,95,6664,0,6664,1.0,0,9299.1,6963.21,9298.93,6962.74,843
840,8703,8837,6912,7050,134,138,12859,0,12859,1.0,0,8769.93,6977.85,8769.45,6977.42,842
841,9512,9599,6916,7025,87,109,5069,0,5069,1.0,0,9554.88,6969.29,9554.4,6968.88,844
842,6099,6225,6920,7035,126,115,10913,0,10913,1.0,0,6165.42,6972.97,6164.83,6972.54,845
843,8992,9083,6922,7020,91,98,4599,1104,3495,0.7599478147423353,0,9041.25,6966.4,9040.69,6966.05,846
844,9063,9156,6925,7020,93,95,4507,0,4507,1.0,0,9098.68,6971.51,9098.6,6970.96,847
845,8453,8634,6929,7096,181,167,20308,0,20308,1.0,0,8540.79,7014.88,8540.31,7014.37,848
846,6386,6545,6933,7054,159,121,13128,0,13128,1.0,0,6467.07,6988.81,6466.6,6988.33,849
847,9149,9208,6936,6982,59,46,2067,1300,767,0.3710691823899371,1,9176.37,6960.63,9175.94,6960.1,850
848,7686,7720,6937,6963,34,26,496,0,496,1.0,0,7700.73,6953.36,7700.47,6952.73,852
849,451,656,6938,7163,205,225,32346,0,32346,1.0,0,546.96,7046.62,546.54,7046.16,853
850,3740,4150,6938,7270,410,332,73809,0,73809,1.0,0,3938.64,7099.98,3938.25,7099.53,851
851,5455,5534,6939,7029,79,90,4146,0,4146,1.0,0,5489.73,6984.78,5489.37,6984.26,854
852,3265,3531,6941,7381,266,440,63985,0,63985,1.0,0,3397.24,7181.75,3396.36,7180.84,859
853,6500,6678,6947,7080,178,133,15752,0,15752,1.0,0,6590.49,7015.52,6590.01,7014.98,855
854,7380,7451,6948,7038,71,90,3934,0,3934,1.0,0,7414.87,6993.47,7414.4,6992.93,856
855,5291,5336,6950,7015,45,65,1783,98,1685,0.9450364554122266,0,5312.95,6979.85,5312.39,6979.48,857
856,7889,7974,6953,6990,85,37,1974,0,1974,1.0,0,7930.9,6970.42,7930.54,6969.85,858
857,7865,8169,6954,7252,304,298,63499,0,63499,1.0,0,8013.44,7110.72,8012.77,7110.16,860
858,12573,12773,6957,7204,200,247,30603,0,30603,1.0,0,12662.23,7099.34,12661.63,7098.53,867
859,5908,6035,6958,7093,127,135,12434,0,12434,1.0,0,5970.92,7021.52,5970.4,7021.1,861
860,7541,7912,6960,7256,371,296,77185,0,77185,1.0,0,7739.82,7104.78,7739.43,7104.4,862
861,4383,4623,6962,7141,240,179,28127,2881,25246,0.897571728232659,1,4509.06,7050.01,4508.46,7049.5,863
862,6613,6809,6962,7131,196,169,22883,0,22883,1.0,0,6716.64,7051.57,6716.07,7051.0,864
863,6251,6405,6963,7110,154,147,14420,0,14420,1.0,0,6325.82,7037.69,6325.35,7037.12,865
864,8082,8158,6964,7039,76,75,3096,0,3096,1.0,0,8124.38,7001.09,8123.78,7000.64,866
865,13671,13893,6967,7272,222,305,31664,0,31664,1.0,0,13776.52,7130.37,13776.0,7129.74,868
866,9218,9300,6972,7049,82,77,3082,0,3082,1.0,0,9261.06,7005.05,9260.58,7004.7,869
867,9510,9558,6974,7039,48,65,1378,0,1378,1.0,0,9534.19,7006.9,9533.77,7006.43,870
868,7440,7483,6976,7015,43,39,906,0,906,1.0,0,7458.16,7000.22,7457.83,6999.42,871
869,9146,9225,6977,7034,79,57,3184,0,3184,1.0,0,9184.28,7003.06,9183.82,7002.59,872
870,9093,9173,6981,7071,80,90,3111,1263,1848,0.5940212150433944,1,9129.51,7021.06,9129.25,7020.79,873
871,6024,6134,6983,7091,110,108,8104,0,8104,1.0,0,6075.37,7033.22,6074.98,7032.83,874
872,8303,8520,6986,7186,217,200,28472,0,28472,1.0,0,8409.51,7083.49,8409.07,7083.07,875
873,5574,5713,6989,7106,139,117,11448,0,11448,1.0,0,5643.18,7047.4,5642.67,7046.92,876
874,9485,9560,6989,7068,75,79,2772,0,2772,1.0,0,9520.08,7032.61,9519.66,7032.03,877
875,5491,5579,6993,7066,88,73,4508,0,4508,1.0,0,5533.56,7029.69,5533.09,7029.18,878
876,8612,8781,6999,7195,169,196,21838,0,21838,1.0,0,8700.42,7093.41,8699.89,7092.94,880
877,973,1211,7000,7299,238,299,40732,0,40732,1.0,0,1074.24,7118.83,1073.92,7118.63,879
878,5380,5455,7002,7067,75,65,3072,0,3072,1.0,0,5414.06,7030.53,5413.59,7030.12,881
879,6776,6985,7003,7126,209,123,16023,0,16023,1.0,0,6880.7,7071.28,6880.23,7070.79,883
880,7581,7627,7003,7048,46,45,1136,0,1136,1.0,0,7605.92,7020.85,7605.34,7020.53,882
881,7364,7611,7007,7252,247,245,42176,0,42176,1.0,0,7480.53,7120.92,7479.95,7120.55,885
882,11219,11669,7007,7459,450,452,117922,0,117922,1.0,0,11490.66,7260.39,11489.72,7259.86,884
883,9176,9257,7009,7074,81,65,3359,0,3359,1.0,0,9214.91,7041.1,9214.52,7040.55,886
884,6089,6274,7011,7202,185,191,25360,0,25360,1.0,0,6184.67,7109.0,6184.15,7108.47,887
885,10564,10671,7013,7194,107,181,11468,0,11468,1.0,0,10625.82,7110.82,10625.28,7110.13,888
886,1472,2051,7015,7694,579,679,246674,0,246674,1.0,0,1756.31,7349.87,1755.95,7349.09,889
887,8917,9546,7017,7492,629,475,125937,414,125523,0.9967126420353034,0,9264.7,7234.07,9263.93,7233.64,891
888,5279,5385,7018,7142,106,124,9468,0,9468,1.0,0,5331.61,7076.68,5331.11,7076.26,890
889,7308,7396,7021,7075,88,54,2721,0,2721,1.0,0,7354.58,7048.64,7353.98,7048.17,892
890,8777,8922,7021,7149,145,128,12356,0,12356,1.0,0,8846.77,7087.43,8846.36,7086.91,895
891,9556,9731,7021,7181,175,160,13724,26,13698,0.9981055085980763,0,9634.55,7109.63,9634.02,7108.95,893
892,5429,5515,7022,7129,86,107,6112,0,6112,1.0,0,5465.83,7071.81,5465.5,7071.39,894
893,5187,5292,7026,7162,105,136,10436,0,10436,1.0,0,5239.39,7090.79,5238.88,7090.51,896
894,5689,5835,7029,7209,146,180,17595,0,17595,1.0,0,5766.87,7113.48,5766.35,7113.07,897
895,6340,6514,7030,7163,174,133,15633,0,15633,1.0,0,6424.75,7098.75,6424.29,7098.2,898
896,9446,9528,7030,7096,82,66,2967,0,2967,1.0,0,9483.62,7060.6,9483.31,7060.17,900
897,8134,8221,7031,7122,87,91,3401,0,3401,1.0,0,8174.56,7076.49,8174.06,7075.88,899
898,9127,9199,7033,7094,72,61,2693,0,2693,1.0,0,9161.26,7068.69,9160.97,7067.97,902
899,9227,9281,7033,7091,54,58,2178,0,2178,1.0,0,9257.09,7063.49,9256.47,7062.98,901
900,4304,4529,7042,7283,225,241,35857,0,35857,1.0,0,4403.9,7167.93,4403.45,7167.38,903
901,9281,9351,7043,7117,70,74,2749,0,2749,1.0,0,9318.17,7076.78,9317.66,7076.4,904
902,14174,14406,7046,7273,232,227,27645,0,27645,1.0,0,14278.78,7156.93,14278.39,7156.36,905
903,5824,5951,7051,7187,127,136,10911,0,10911,1.0,0,5879.07,7113.92,5878.73,7113.47,906
904,5480,5614,7052,7175,134,123,11574,0,11574,1.0,0,5546.31,7116.92,5545.85,7116.34,907
905,5370,5446,7054,7150,76,96,4403,0,4403,1.0,0,5405.25,7100.98,5404.9,7100.59,908
906,9339,9405,7058,7120,66,62,1913,0,1913,1.0,0,9366.86,7086.96,9366.68,7086.28,909
907,12732,13121,7061,7394,389,333,78766,0,78766,1.0,0,12889.32,7223.99,12889.11,7223.4,910
908,5870,6130,7063,7255,260,192,32856,0,32856,1.0,0,6004.56,7167.96,6004.0,7167.46,911
909,7119,7379,7063,7309,260,246,47690,0,47690,1.0,0,7247.53,7191.26,7247.07,7190.63,912
910,9503,9558,7064,7103,55,39,1421,0,1421,1.0,0,9527.69,7082.5,9527.4,7081.95,913
911,6780,7153,7065,7338,373,273,67039,0,67039,1.0,0,6982.45,7205.84,6981.74,7205.23,914
912,9507,9609,7065,7189,102,124,5083,1241,3842,0.7558528428093646,0,9563.61,7129.8,9562.99,7129.11,916
913,9366,9440,7066,7165,74,99,4496,0,4496,1.0,0,9405.62,7116.16,9405.21,7115.59,915
914,7314,7406,7069,7192,92,123,6070,0,6070,1.0,0,7361.31,7121.4,7360.79,7121.09,917
915,8148,8454,7069,7330,306,261,49081,0,49081,1.0,0,8289.56,7208.52,8289.28,7208.06,918
916,6443,6659,7072,7252,216,180,25213,0,25213,1.0,0,6547.51,7161.71,6547.01,7161.21,919
917,9264,9322,7072,7113,58,41,1499,0,1499,1.0,0,9291.66,7095.1,9291.26,7094.65,920
918,3307,3918,7074,7542,611,468,144455,0,144455,1.0,0,3637.68,7307.02,3636.96,7306.65,921
919,9428,9552,7076,7177,124,101,6664,234,6430,0.9648859543817527,0,9481.43,7125.36,9481.22,7124.99,923
920,8503,8651,7077,7210,148,133,13218,0,13218,1.0,0,8576.99,7141.69,8576.57,7141.27,922
921,1062,1600,7086,7561,538,475,177372,0,177372,1.0,0,1311.97,7338.07,1311.64,7337.66,924
922,7088,7133,7087,7126,45,39,935,0,935,1.0,0,7113.28,7101.55,7112.63,7101.26,925
923,13885,14180,7093,7323,295,230,47481,0,47481,1.0,0,14040.29,7212.64,14039.63,7212.09,926
924,4003,4331,7098,7450,328,352,64012,0,64012,1.0,0,4179.09,7245.84,4178.41,7245.64,927
925,5579,5753,7099,7262,174,163,19236,0,19236,1.0,0,5664.35,7182.6,5663.91,7182.11,928
926,6228,6480,7103,7363,252,260,42878,0,42878,1.0,0,6340.94,7241.69,6340.41,7241.08,929
927,774,1076,7111,7367,302,256,50272,0,50272,1.0,0,917.2,7243.79,916.86,7243.43,930
928,5256,5356,7115,7223,100,108,7387,0,7387,1.0,0,5305.69,7175.77,5305.09,7175.12,931
929,11069,11377,7116,7348,308,232,46143,0,46143,1.0,0,11226.52,7232.39,11225.9,7231.75,938
930,6574,6836,7117,7299,262,182,30635,0,30635,1.0,0,6716.6,7214.08,6716.03,7213.57,932
931,5343,5407,7119,7179,64,60,2580,0,2580,1.0,0,5371.74,7151.23,5371.3,7150.67,933
932,8691,8924,7119,7345,233,226,35621,0,35621,1.0,0,8807.72,7233.52,8807.21,7233.05,934
933,10510,10678,7119,7415,168,296,29401,0,29401,1.0,0,10589.48,7271.27,10588.91,7270.73,935
934,5402,5508,7122,7222,106,100,7174,0,7174,1.0,0,5454.1,7170.95,5453.65,7170.48,936
935,8885,8970,7122,7244,85,122,6043,0,6043,1.0,0,8926.92,7181.89,8926.4,7181.38,937
936,9730,9788,7124,7219,58,95,2939,1040,1899,0.6461381422252467,0,9763.32,7169.4,9762.7,7168.89,939
937,10938,11240,7135,7478,302,343,44812,0,44812,1.0,0,11072.83,7350.25,11072.44,7349.21,944
938,13516,13962,7135,7471,446,336,90360,8,90352,0.9999114652501107,0,13743.53,7316.96,13742.99,7316.42,941
939,4496,4622,7136,7329,126,193,16848,1503,15345,0.9107905982905983,0,4561.89,7230.92,4561.36,7230.41,940
940,9413,9523,7141,7238,110,97,5798,1036,4762,0.8213176957571576,0,9467.17,7192.28,9466.67,7191.72,942
941,5166,5276,7149,7305,110,156,10572,0,10572,1.0,0,5229.0,7219.87,5228.38,7219.27,943
942,10639,10957,7154,7482,318,328,48940,0,48940,1.0,0,10804.22,7316.78,10803.45,7316.16,945
943,9497,9587,7156,7297,90,141,7354,234,7120,0.9681805819961925,0,9544.02,7223.9,9543.45,7223.41,946
944,9624,9763,7157,7227,139,70,6368,2082,4286,0.6730527638190955,0,9695.84,7195.02,9695.29,7194.5,947
945,12922,13354,7159,7555,432,396,115812,0,115812,1.0,0,13135.52,7361.88,13135.12,7361.34,948
946,8414,8612,7164,7330,198,166,19971,0,19971,1.0,0,8518.29,7239.28,8517.64,7238.85,949
947,8604,8703,7167,7296,99,129,9638,0,9638,1.0,0,8655.25,7236.57,8654.73,7235.93,950
948,5721,5916,7169,7350,195,181,21706,0,21706,1.0,0,5819.46,7259.7,5818.95,7259.2,951
949,9566,9633,7170,7246,67,76,3052,0,3052,1.0,0,9596.2,7203.71,9595.73,7203.41,952
950,5273,5466,7172,7319,193,147,16656,0,16656,1.0,0,5364.74,7248.2,5364.21,7247.65,953
951,5485,5622,7173,7292,137,119,11998,0,11998,1.0,0,5551.06,7232.23,5550.63,7231.76,954
952,2384,2967,7175,7841,583,666,256459,0,256459,1.0,0,2666.48,7499.5,2666.01,7499.01,955
953,6207,6261,7177,7235,54,58,1968,0,1968,1.0,0,6237.46,7206.94,6236.83,7206.35,956
954,8400,8422,7182,7216,22,34,436,0,436,1.0,0,8412.97,7198.45,8412.36,7198.04,957
955,8920,9122,7185,7356,202,171,16044,0,16044,1.0,0,9024.02,7251.91,9023.87,7251.93,958
956,7598,8008,7186,7529,410,343,87533,0,87533,1.0,0,7812.68,7364.72,7812.01,7364.04,959
957,12531,12784,7194,7467,253,273,42960,0,42960,1.0,0,12666.2,7336.07,12665.65,7335.61,960
958,6085,6240,7196,7397,155,201,23331,0,23331,1.0,0,6162.55,7290.03,6161.99,7289.58,961
959,8105,8150,7198,7233,45,35,1155,0,1155,1.0,0,8130.28,7216.86,8129.73,7216.3,962
960,7336,7681,7206,7514,345,308,66489,1331,65158,0.979981651100182,1,7486.39,7350.76,7486.42,7350.06,963
961,9628,9776,7210,7344,148,134,11660,1522,10138,0.8694682675814751,0,9704.32,7269.42,9703.86,7268.88,964
962,9579,9631,7215,7321,52,106,3729,0,3729,1.0,0,9607.04,7267.36,9606.6,7267.04,965
963,5433,5593,7218,7390,160,172,13566,0,13566,1.0,0,5497.86,7314.14,5497.4,7313.39,966
964,7968,8238,7224,7513,270,289,45893,0,45893,1.0,0,8105.58,7340.52,8104.98,7340.6,967
965,3885,3957,7239,7330,72,91,4599,0,4599,1.0,0,3918.29,7288.12,3917.87,7287.43,969
966,5895,6100,7239,7409,205,170,23973,0,23973,1.0,0,6009.4,7312.31,6008.78,7311.95,968
967,4313,4585,7244,7536,272,292,41572,691,40881,0.9833782353507168,0,4435.39,7365.83,4434.92,7365.6,970
968,7943,7983,7246,7278,40,32,725,0,725,1.0,0,7963.77,7258.32,7963.15,7257.99,971
969,6395,6728,7247,7567,333,320,76421,0,76421,1.0,0,6567.02,7397.9,6566.36,7397.57,972
970,5589,5733,7253,7385,144,132,12110,0,12110,1.0,0,5659.35,7306.84,5658.9,7306.52,973
971,9117,9187,7260,7367,70,107,5336,0,5336,1.0,0,9149.52,7312.51,9149.0,7312.14,974
972,3658,4139,7261,7930,481,669,221675,0,221675,1.0,0,3920.6,7611.59,3920.16,7610.97,975
973,1986,2099,7263,7449,113,186,14775,0,14775,1.0,0,2042.5,7358.11,2041.83,7357.56,976
974,13268,13808,7266,7605,540,339,101480,0,101480,1.0,0,13501.35,7442.32,13501.26,7441.84,977
975,5337,5456,7268,7448,119,180,10154,0,10154,1.0,0,5403.1,7352.38,5402.74,7351.98,978
976,7112,7160,7270,7303,48,33,918,0,918,1.0,0,7136.01,7290.02,7135.51,7289.44,979
977,9618,9709,7270,7389,91,119,6816,0,6816,1.0,0,9658.45,7332.32,9657.97,7331.75,981
978,8976,9085,7271,7330,109,59,3297,0,3297,1.0,0,9031.77,7297.87,9031.4,7297.53,980
979,8352,8685,7276,7522,333,246,51089,0,51089,1.0,0,8518.51,7382.45,8518.21,7382.08,982
980,5227,5300,7278,7346,73,68,2640,0,2640,1.0,0,5268.66,7312.96,5267.96,7312.39,985
981,6824,7012,7278,7416,188,138,17293,0,17293,1.0,0,6903.04,7354.08,6902.78,7353.55,983
982,8826,8953,7278,7412,127,134,10350,0,10350,1.0,0,8889.48,7349.43,8889.06,7348.76,984
983,6725,6830,7281,7387,105,106,8147,0,8147,1.0,0,6782.0,7335.92,6781.51,7335.44,987
984,13955,14219,7281,7554,264,273,46047,0,46047,1.0,0,14077.06,7401.9,14076.61,7401.47,986
985,9707,9840,7284,7413,133,129,9002,0,9002,1.0,0,9774.79,7355.13,9774.23,7354.54,988
986,9536,9591,7287,7376,55,89,3319,0,3319,1.0,0,9561.71,7328.92,9561.23,7328.53,989
987,8667,8844,7292,7485,177,193,22318,0,22318,1.0,0,8750.26,7390.64,8749.77,7390.14,990
988,7299,7350,7293,7351,51,58,1657,0,1657,1.0,0,7331.4,7315.8,7330.8,7315.62,991
989,6705,6749,7295,7327,44,32,874,0,874,1.0,0,6724.51,7307.15,6724.24,7306.79,992
990,8919,9120,7295,7463,201,168,25126,0,25126,1.0,0,9025.26,7386.56,9024.74,7385.92,993
991,5676,5806,7297,7420,130,123,10764,0,10764,1.0,0,5741.09,7367.27,5740.58,7366.59,994
992,6977,7347,7299,7610,370,311,89274,0,89274,1.0,0,7172.1,7449.04,7171.57,7448.6,995
993,11803,12653,7303,7887,850,584,294431,0,294431,1.0,0,12176.97,7595.09,12176.95,7594.43,997
994,5281,5362,7304,7348,81,44,2062,0,2062,1.0,0,5324.57,7325.85,5323.82,7325.48,996
995,5782,6018,7306,7563,236,257,39545,0,39545,1.0,0,5894.81,7435.5,5894.31,7434.97,998
996,9575,9629,7312,7376,54,64,2117,0,2117,1.0,0,9605.84,7344.07,9605.2,7343.64,1000
997,8147,8426,7314,7573,279,259,42271,0,42271,1.0,0,8290.9,7440.73,8290.42,7440.31,999
998,9116,9254,7315,7424,138,109,7952,0,7952,1.0,0,9188.3,7377.84,9187.66,7377.31,1001
999,5471,5674,7318,7449,203,131,10590,0,10590,1.0,0,5554.92,7384.44,5555.02,7383.85,1002
1000,4071,4388,7327,7719,317,392,81577,4974,76603,0.9390269316106256,1,4246.2,7525.63,4245.64,7525.12,1003
1001,10460,10885,7330,7620,425,290,81575,3829,77746,0.9530615997548268,1,10658.2,7484.3,10657.66,7483.65,1004
1002,6357,6408,7333,7384,51,51,1512,0,1512,1.0,0,6388.6,7358.92,6387.86,7358.43,1005
1003,6986,7041,7337,7381,55,44,1484,0,1484,1.0,0,7011.78,7353.12,7011.35,7352.8,1006
1004,886,1165,7340,7742,279,402,80262,0,80262,1.0,0,1017.68,7553.22,1017.24,7552.64,1007
1005,749,971,7341,7576,222,235,27187,0,27187,1.0,0,838.43,7465.22,838.4,7464.22,1009
1006,6037,6482,7342,7678,445,336,98124,0,98124,1.0,0,6265.02,7518.02,6264.53,7517.56,1010
1007,5277,5372,7343,7479,95,136,7057,0,7057,1.0,0,5332.8,7397.15,5332.2,7397.01,1011
1008,12378,12543,7347,7496,165,149,18209,0,18209,1.0,0,12467.2,7414.94,12466.64,7414.51,1012
1009,9663,9723,7354,7413,60,59,1638,0,1638,1.0,0,9693.74,7384.76,9693.29,7384.19,1015
1010,9290,9338,7355,7402,48,47,1376,1128,248,0.18023255813953487,1,9310.71,7376.42,9310.37,7376.08,1013
1011,9479,9557,7355,7433,78,78,4307,0,4307,1.0,0,9520.53,7390.43,9519.99,7390.02,1014
1012,9236,9308,7357,7432,72,75,3421,8,3413,0.9976615024846536,0,9273.5,7392.69,9273.0,7392.24,1016
1013,9553,9638,7360,7444,85,84,4740,0,4740,1.0,0,9590.75,7399.5,9590.32,7399.01,1017
1014,5989,6139,7365,7560,150,195,19721,0,19721,1.0,0,6069.18,7465.21,6068.62,7464.7,1019
1015,6706,7003,7365,7570,297,205,38242,0,38242,1.0,0,6860.98,7466.87,6860.29,7466.14,1018
1016,5422,5467,7368,7405,45,37,946,0,946,1.0,0,5444.49,7386.32,5443.94,7385.81,1020
1017,9766,9855,7383,7464,89,81,5018,0,5018,1.0,0,9811.12,7422.34,9810.63,7421.87,1021
1018,9305,9361,7385,7447,56,62,2410,0,2410,1.0,0,9332.64,7415.42,9332.17,7414.92,1022
1019,12428,13116,7385,7989,688,604,267702,0,267702,1.0,0,12801.93,7707.68,12801.3,7707.14,1025
1020,5449,5699,7386,7650,250,264,42108,0,42108,1.0,0,5580.32,7507.57,5579.75,7507.11,1023
1021,9623,9686,7386,7439,63,53,2337,0,2337,1.0,0,9653.8,7414.56,9653.31,7413.95,1024
1022,9679,9769,7387,7487,90,100,5445,0,5445,1.0,0,9723.3,7431.22,9722.81,7430.91,1026
1023,5397,5491,7390,7522,94,132,6098,0,6098,1.0,0,5444.26,7460.2,5443.92,7459.61,1028
1024,7411,7724,7390,7878,313,488,83286,0,83286,1.0,0,7580.38,7621.51,7579.62,7621.54,1027
1025,8804,8974,7395,7549,170,154,16756,0,16756,1.0,0,8891.71,7469.83,8891.18,7469.35,1029
1026,9115,9221,7403,7544,106,141,8030,2763,5267,0.6559153175591532,1,9167.66,7475.66,9167.03,7475.03,1030
1027,9154,9222,7404,7463,68,59,2271,199,2072,0.912373403786878,0,9192.66,7430.87,9191.81,7430.29,1031
1028,9468,9553,7405,7510,85,105,5316,0,5316,1.0,0,9508.27,7461.72,9507.75,7461.06,1033
1029,5337,5414,7406,7560,77,154,6978,0,6978,1.0,0,5378.3,7487.93,5377.8,7487.33,1032
1030,11006,11687,7407,7896,681,489,241365,0,241365,1.0,0,11334.5,7648.19,11334.11,7647.82,1034
1031,8595,8759,7409,7592,164,183,18838,0,18838,1.0,0,8673.91,7503.39,8673.32,7502.75,1035
1032,7879,8140,7411,7645,261,234,30831,0,30831,1.0,0,7997.16,7520.15,7996.81,7519.71,1036
1033,9201,9334,7412,7569,133,157,11083,3,11080,0.9997293151673734,0,9262.85,7479.29,9262.36,7478.97,1037
1034,8065,8124,7414,7486,59,72,2436,0,2436,1.0,0,8099.59,7449.82,8098.91,7449.32,1038
1035,3124,3761,7417,8050,637,633,279175,4513,274662,0.9838345124026149,1,3425.11,7751.33,3424.65,7750.74,1039
1036,5681,5841,7418,7616,160,198,21997,0,21997,1.0,0,5757.55,7516.49,5757.14,7516.08,1040
1037,9536,9590,7419,7475,54,56,1755,0,1755,1.0,0,9562.13,7450.32,9561.66,7449.67,1041
1038,9586,9711,7419,7525,125,106,7152,0,7152,1.0,0,9639.38,7471.07,9639.09,7470.63,1042
1039,1890,2519,7422,8044,629,622,286304,0,286304,1.0,0,2196.36,7727.04,2195.92,7726.58,1043
1040,6683,6727,7423,7482,44,59,1435,0,1435,1.0,0,6701.29,7456.46,6700.94,7455.78,1044
1041,10840,11072,7428,7738,232,310,42709,0,42709,1.0,0,10955.04,7565.44,10954.57,7565.07,1045
1042,11549,11833,7428,7790,284,362,57936,0,57936,1.0,0,11694.9,7590.51,11694.39,7590.16,1047
1043,13846,13987,7429,7563,141,134,9945,211,9734,0.9787833081950729,0,13941.17,7497.43,13940.12,7496.73,1046
1044,9726,9783,7441,7506,57,65,2511,0,2511,1.0,0,9755.83,7477.32,9755.32,7476.67,1048
1045,9322,9364,7447,7508,42,61,1295,0,1295,1.0,0,9341.93,7480.85,9341.46,7480.1,1049
1046,9777,9841,7449,7528,64,79,3537,0,3537,1.0,0,9812.75,7489.53,9812.25,7488.99,1050
1047,9419,9497,7450,7570,78,120,5542,0,5542,1.0,0,9457.87,7512.25,9457.36,7511.65,1051
1048,2795,3188,7457,7909,393,452,99130,0,99130,1.0,0,2989.88,7675.39,2989.41,7674.91,1052
1049,13692,13982,7457,7873,290,416,84484,2589,81895,0.9693551441693101,1,13840.19,7670.02,13839.66,7669.43,1053
1050,8940,9183,7461,7633,243,172,27921,0,27921,1.0,0,9062.75,7536.62,9062.25,7536.21,1054
1051,6377,6833,7466,7709,456,243,58535,0,58535,1.0,0,6648.66,7604.07,6647.59,7603.49,1055
1052,4357,4528,7467,7628,171,161,16704,0,16704,1.0,0,4452.12,7555.76,4451.31,7555.41,1056
1053,8744,8873,7471,7652,129,181,15550,0,15550,1.0,0,8803.66,7559.26,8803.25,7558.8,1057
1054,9542,9602,7471,7542,60,71,2941,0,2941,1.0,0,9570.64,7503.98,9570.36,7503.65,1058
1055,9678,9780,7474,7601,102,127,8891,0,8891,1.0,0,9724.76,7545.14,9724.2,7544.56,1059
1056,8360,8650,7480,7816,290,336,68801,1662,67139,0.9758433743695586,1,8516.82,7635.37,8516.27,7635.0,1060
1057,9287,9345,7484,7527,58,43,1618,0,1618,1.0,0,9315.98,7509.55,9315.46,7508.94,1061
1058,9252,9408,7485,7638,156,153,12012,0,12012,1.0,0,9327.44,7563.97,9327.18,7563.32,1062
1059,9386,9429,7486,7547,43,61,2002,0,2002,1.0,0,9408.03,7515.9,9407.53,7515.43,1063
1060,7307,7415,7490,7576,108,86,4029,0,4029,1.0,0,7361.57,7531.62,7360.82,7531.44,1064
1061,13037,13449,7494,7848,412,354,104120,0,104120,1.0,0,13246.41,7668.64,13245.89,7668.17,1065
1062,9591,9621,7495,7545,30,50,1058,0,1058,1.0,0,9605.87,7521.01,9605.37,7520.44,1066
1063,9751,9789,7497,7539,38,42,846,0,846,1.0,0,9772.79,7517.31,9772.06,7516.64,1067
1064,9456,9593,7501,7669,137,168,11691,0,11691,1.0,0,9518.98,7585.07,9518.89,7584.69,1068
1065,9649,9691,7503,7571,42,68,1750,0,1750,1.0,0,9671.71,7536.02,9671.22,7535.57,1069
1066,7594,8113,7506,8175,519,669,208536,0,208536,1.0,0,7858.52,7847.79,7857.77,7847.3,1070
1067,7982,8414,7509,7851,432,342,100747,0,100747,1.0,0,8210.49,7676.93,8209.9,7676.47,1071
1068,7841,7880,7511,7546,39,35,784,0,784,1.0,0,7865.8,7527.07,7865.01,7526.68,1074
1069,13987,14325,7511,7702,338,191,40139,0,40139,1.0,0,14171.87,7610.52,14171.08,7609.82,1072
1070,5383,5467,7512,7609,84,97,5274,0,5274,1.0,0,5424.35,7560.61,5423.95,7560.06,1073
1071,5815,6042,7512,7751,227,239,36776,0,36776,1.0,0,5931.87,7629.17,5931.36,7628.67,1075
1072,9612,9652,7515,7547,40,32,693,0,693,1.0,0,9634.71,7529.53,9633.74,7529.76,1076
1073,9774,9834,7519,7591,60,72,3073,0,3073,1.0,0,9800.77,7553.1,9800.37,7552.6,1077
1074,1115,1673,7521,8031,558,510,229345,0,229345,1.0,0,1383.57,7771.58,1383.01,7771.03,1078
1075,5607,5753,7522,7763,146,241,20285,0,20285,1.0,0,5681.7,7656.32,5681.23,7655.58,1079
1076,9139,9262,7531,7654,123,123,10381,0,10381,1.0,0,9201.65,7597.44,9201.17,7596.96,1080
1077,8855,9052,7535,7727,197,192,23819,0,23819,1.0,0,8946.01,7624.19,8945.6,7623.79,1081
1078,9539,9612,7535,7600,73,65,3309,0,3309,1.0,0,9574.51,7566.22,9574.1,7565.65,1082
1079,7176,7559,7537,7886,383,349,83630,0,83630,1.0,0,7362.54,7702.37,7362.02,7701.88,1083
1080,13385,13731,7540,7957,346,417,91242,43,91199,0.9995287258060981,0,13576.16,7738.52,13575.49,7738.03,1084
1081,9606,9692,7541,7633,86,92,4906,0,4906,1.0,0,9645.93,7584.17,9645.54,7583.82,1085
1082,9418,9458,7544,7591,40,47,886,0,886,1.0,0,9440.19,7571.22,9439.23,7570.09,1086
1083,6781,7218,7545,7865,437,320,97191,0,97191,1.0,0,7010.56,7701.18,7010.13,7700.88,1087
1084,6823,6864,7546,7580,41,34,790,0,790,1.0,0,6840.47,7565.62,6840.07,7564.89,1088
1085,9332,9470,7547,7692,138,145,12603,0,12603,1.0,0,9401.7,7627.55,9401.2,7626.94,1089
1086,5322,5384,7551,7642,62,91,3548,0,3548,1.0,0,5350.02,7594.48,5349.52,7594.01,1090
1087,706,964,7560,7847,258,287,45627,0,45627,1.0,0,825.78,7697.78,825.41,7697.5,1091
1088,5367,5406,7565,7637,39,72,1932,0,1932,1.0,0,5385.74,7604.93,5385.19,7604.2,1092
1089,10638,10899,7569,7818,261,249,43629,0,43629,1.0,0,10772.55,7685.81,10772.03,7685.35,1093
1090,5450,5489,7570,7624,39,54,1622,0,1622,1.0,0,5470.24,7597.5,5469.72,7596.94,1094
1091,10415,10651,7574,7779,236,205,33539,0,33539,1.0,0,10538.11,7669.91,10537.54,7669.45,1095
1092,8630,8826,7575,7751,196,176,24319,32,24287,0.9986841564209055,0,8723.01,7664.51,8722.59,7663.97,1096
1093,9569,9647,7581,7696,78,115,5762,0,5762,1.0,0,9607.17,7643.81,9606.64,7643.12,1097
1094,5487,5522,7583,7646,35,63,1605,0,1605,1.0,0,5504.78,7610.4,5504.33,7610.23,1098
1095,9742,9868,7586,7734,126,148,9715,0,9715,1.0,0,9808.41,7666.42,9807.87,7665.83,1099
1096,9762,9810,7589,7651,48,62,2282,0,2282,1.0,0,9787.18,7619.34,9786.62,7618.81,1100
1097,9629,9768,7593,7717,139,124,11843,0,11843,1.0,0,9704.16,7656.44,9703.58,7655.94,1101
1098,7160,7230,7598,7644,70,46,1425,0,1425,1.0,0,7197.24,7619.04,7196.73,7618.73,1102
1099,5391,5508,7599,7703,117,104,7553,0,7553,1.0,0,5440.84,7652.55,5440.55,7651.99,1103
1100,5731,5858,7608,7739,127,131,10178,0,10178,1.0,0,5784.79,7670.94,5784.52,7670.64,1104
1101,9135,9357,7609,7722,222,113,14642,0,14642,1.0,0,9255.45,7672.93,9254.57,7672.49,1105
1102,4094,4194,7612,7739,100,127,9397,0,9397,1.0,0,4142.03,7671.53,4141.56,7671.15,1106
1103,5603,5650,7616,7663,47,47,1324,0,1324,1.0,0,5626.82,7639.65,5626.31,7639.2,1107
1104,9027,9159,7619,7728,132,109,9870,0,9870,1.0,0,9095.74,7670.81,9095.17,7670.35,1108
1105,5501,5617,7622,7800,116,178,10563,0,10563,1.0,0,5556.39,7695.85,5555.74,7695.79,1109
1106,9435,9496,7629,7732,61,103,4197,0,4197,1.0,0,9466.32,7683.75,9465.93,7683.17,1110
1107,5279,5397,7633,7791,118,158,11847,0,11847,1.0,0,5342.99,7709.98,5342.4,7709.57,1112
1108,5980,6132,7633,7776,152,143,12278,0,12278,1.0,0,6052.91,7704.62,6052.47,7704.15,1111
1109,1587,2044,7635,8080,457,445,122424,0,122424,1.0,0,1809.82,7887.21,1809.36,7886.65,1113
1110,8804,8946,7636,7797,142,161,14247,0,14247,1.0,0,8866.75,7720.33,8866.35,7719.78,1114
1111,9491,9578,7637,7691,87,54,2698,0,2698,1.0,0,9528.2,7664.44,9528.19,7664.09,1115
1112,6340,6625,7642,7909,285,267,52029,0,52029,1.0,0,6482.48,7761.97,6481.97,7761.51,1116
1113,5483,5530,7646,7726,47,80,2235,0,2235,1.0,0,5507.8,7683.58,5507.16,7683.22,1117
1114,5276,5317,7653,7711,41,58,1427,0,1427,1.0,0,5297.19,7680.29,5296.66,7679.96,1119
1115,6004,6634,7654,8139,630,485,138577,0,138577,1.0,0,6329.28,7886.79,6328.72,7886.33,1118
1116,5209,5291,7670,7778,82,108,5281,0,5281,1.0,0,5251.2,7719.4,5250.71,7719.12,1120
1117,5453,5501,7676,7748,48,72,2370,0,2370,1.0,0,5477.21,7714.95,5476.77,7714.35,1121
1118,8947,9067,7678,7790,120,112,8328,0,8328,1.0,0,9007.37,7736.63,9006.9,7736.05,1124
1119,9483,9543,7678,7729,60,51,2294,0,2294,1.0,0,9510.57,7702.87,9510.13,7702.36,1122
1120,9613,9654,7678,7776,41,98,2609,0,2609,1.0,0,9630.07,7727.99,9629.6,7727.47,1123
1121,9528,9583,7681,7755,55,74,2085,0,2085,1.0,0,9553.35,7720.91,9553.25,7719.92,1125
1122,9288,9443,7684,7796,155,112,10142,0,10142,1.0,0,9381.12,7734.14,9380.26,7733.71,1126
1123,6559,6964,7688,8044,405,356,87696,0,87696,1.0,0,6745.42,7863.68,6744.94,7863.15,1127
1124,9564,9616,7688,7765,52,77,2607,0,2607,1.0,0,9591.7,7722.73,9591.31,7722.42,1128
1125,5385,5456,7692,7760,71,68,3367,0,3367,1.0,0,5418.28,7721.43,5417.85,7721.11,1129
1126,9759,9872,7694,7854,113,160,12944,4177,8767,0.6773022249690976,1,9814.73,7772.28,9814.15,7771.86,1130
1127,8641,8668,7701,7738,27,37,557,0,557,1.0,0,8652.43,7721.44,8651.94,7720.8,1133
1128,10974,11281,7701,7966,307,265,37221,0,37221,1.0,0,11100.28,7854.9,11099.99,7854.17,1132
1129,4131,4427,7702,7943,296,241,48538,1293,47245,0.973361077918332,1,4268.63,7812.47,4268.19,7811.97,1131
1130,9640,9744,7704,7757,104,53,2537,0,2537,1.0,0,9686.14,7727.87,9685.73,7727.24,1134
1131,9157,9489,7706,7944,332,238,46345,0,46345,1.0,0,9317.24,7824.48,9316.7,7823.85,1135
1132,9038,9199,7707,7846,161,139,14126,0,14126,1.0,0,9123.31,7776.5,9122.73,7775.99,1136
1133,5554,5654,7709,7849,100,140,7395,0,7395,1.0,0,5596.49,7776.49,5596.22,7776.13,1137
1134,5607,5782,7712,7845,175,133,8616,0,8616,1.0,0,5688.27,7777.77,5688.19,7777.16,1139
1135,5768,5902,7713,7877,134,164,16480,0,16480,1.0,0,5835.12,7795.35,5834.73,7794.88,1140
1136,11604,12214,7713,8076,610,363,125379,0,125379,1.0,0,11902.39,7908.45,11901.81,7907.93,1138
1137,9661,9770,7714,7856,109,142,10546,0,10546,1.0,0,9717.81,7790.32,9717.34,7789.88,1141
1138,10630,11044,7716,8049,414,333,88869,2510,86359,0.9717561804453747,1,10845.46,7896.84,10844.82,7896.4,1142
1139,873,1187,7719,8211,314,492,96385,0,96385,1.0,0,1035.64,7946.54,1035.19,7946.28,1143
1140,6335,6383,7721,7791,48,70,1301,0,1301,1.0,0,6356.73,7749.53,6356.91,7750.15,1144
1141,9470,9551,7722,7837,81,115,6555,0,6555,1.0,0,9511.39,7780.64,9510.98,7780.07,1145
1142,9441,9492,7724,7782,51,58,1721,0,1721,1.0,0,9460.82,7752.48,9460.86,7751.67,1146
1143,5886,6035,7728,7907,149,179,19036,0,19036,1.0,0,5958.83,7813.96,5958.35,7813.51,1147
1144,8608,8857,7728,7894,249,166,26409,0,26409,1.0,0,8734.44,7808.04,8733.95,7807.64,1148
1145,5417,5493,7734,7818,76,84,4273,0,4273,1.0,0,5455.27,7774.98,5454.72,7774.53,1149
1146,10547,10732,7736,7994,185,258,26829,3872,22957,0.8556785567855678,1,10617.99,7848.32,10617.76,7847.96,1150
1147,5490,5533,7738,7800,43,62,2162,0,2162,1.0,0,5510.25,7770.24,5509.82,7769.76,1151
1148,5377,5420,7742,7783,43,41,1209,0,1209,1.0,0,5398.22,7763.4,5397.72,7762.85,1152
1149,8328,8644,7743,8043,316,300,60589,0,60589,1.0,0,8477.95,7894.2,8477.51,7893.68,1153
1150,9545,9636,7743,7838,91,95,5471,0,5471,1.0,0,9590.06,7791.16,9589.56,7790.63,1154
1151,8820,9021,7750,7988,201,238,31869,0,31869,1.0,0,8918.87,7873.82,8918.44,7873.28,1155
1152,9628,9673,7750,7817,45,67,2001,0,2001,1.0,0,9651.24,7784.12,9650.74,7783.66,1156
1153,5262,5323,7758,7846,61,88,3328,0,3328,1.0,0,5296.46,7797.71,5295.89,7797.32,1157
1154,5318,5391,7762,7863,73,101,4523,0,4523,1.0,0,5352.99,7814.24,5352.71,7813.58,1159
1155,12167,12694,7762,8200,527,438,159450,0,159450,1.0,0,12437.83,7982.38,12437.17,7982.03,1158
1156,5668,5838,7768,7990,170,222,22242,0,22242,1.0,0,5742.53,7883.01,5741.99,7882.53,1160
1157,8992,9109,7777,7905,117,128,9156,0,9156,1.0,0,9046.39,7840.15,9046.01,7839.67,1161
1158,5383,5436,7779,7835,53,56,1898,0,1898,1.0,0,5409.56,7805.42,5409.12,7804.99,1162
1159,2718,2999,7786,8136,281,350,50326,0,50326,1.0,0,2872.87,7947.16,2872.28,7946.7,1163
1160,2929,3338,7790,8497,409,707,171469,0,171469,1.0,0,3129.36,8148.74,3128.82,8148.08,1164
1161,5525,5568,7792,7849,43,57,1581,0,1581,1.0,0,5545.64,7818.93,5545.09,7818.58,1165
1162,5461,5493,7796,7866,32,70,1712,0,1712,1.0,0,5479.2,7829.69,5478.69,7829.26,1166
1163,5486,5533,7796,7866,47,70,1985,0,1985,1.0,0,5509.34,7827.81,5508.75,7827.6,1167
1164,9515,9589,7798,7929,74,131,5947,0,5947,1.0,0,9551.94,7870.1,9551.49,7869.38,1168
1165,2377,2968,7801,8345,591,544,202707,0,202707,1.0,0,2635.52,8090.09,2635.21,8089.57,1169
1166,6853,7367,7802,8189,514,387,136669,0,136669,1.0,0,7104.78,8001.96,7104.22,8001.33,1170
1167,713,885,7803,8090,172,287,36919,0,36919,1.0,0,800.07,7955.49,799.56,7954.87,1171
1168,13001,13672,7805,8167,671,362,178994,0,178994,1.0,0,13349.38,7995.89,13348.8,7995.36,1172
1169,13632,13968,7809,8085,336,276,54826,1979,52847,0.963903987159377,1,13798.44,7955.94,13797.92,7955.26,1174
1170,9613,9677,7810,7886,64,76,3205,0,3205,1.0,0,9646.99,7849.18,9646.4,7848.59,1173
1171,5351,5422,7813,7896,71,83,3313,0,3313,1.0,0,5388.76,7858.42,5388.18,7857.82,1176
1172,8584,8691,7814,7911,107,97,6150,0,6150,1.0,0,8630.33,7864.4,8630.03,7863.95,1175
1173,5418,5470,7816,7883,52,67,2646,0,2646,1.0,0,5443.75,7849.82,5443.26,7849.33,1177
1174,5640,5689,7816,7868,49,52,1751,0,1751,1.0,0,5668.28,7840.54,5667.67,7840.13,1178
1175,4011,4219,7819,7984,208,165,15037,0,15037,1.0,0,4130.97,7917.35,4130.12,7916.66,1179
1176,5529,5580,7825,7871,51,46,1351,0,1351,1.0,0,5557.0,7851.61,5556.39,7850.92,1181
1177,7970,8404,7826,8345,434,519,150413,0,150413,1.0,0,8196.58,8073.0,8196.09,8072.6,1180
1178,9447,9500,7829,7897,53,68,2060,0,2060,1.0,0,9473.27,7867.02,9473.02,7866.2,1182
1179,9582,9641,7834,7904,59,70,2638,0,2638,1.0,0,9607.71,7869.87,9607.39,7869.46,1183
1180,9497,9533,7836,7880,36,44,1193,0,1193,1.0,0,9514.32,7855.51,9513.9,7855.06,1184
1181,9665,9760,7836,7943,95,107,5949,0,5949,1.0,0,9712.89,7889.52,9712.45,7889.01,1185
1182,5606,5675,7837,7958,69,121,5563,0,5563,1.0,0,5640.33,7898.16,5639.67,7897.8,1186
1183,9076,9227,7838,7991,151,153,15839,0,15839,1.0,0,9154.31,7911.58,9153.76,7911.11,1187
1184,11170,11769,7840,8348,599,508,195345,0,195345,1.0,0,11433.26,8080.17,11432.89,8079.66,1188
1185,9741,9842,7841,7936,101,95,5645,0,5645,1.0,0,9789.34,7884.92,9788.88,7884.44,1189
1186,7270,7714,7844,8190,444,346,112634,0,112634,1.0,0,7499.11,8024.76,7498.53,8024.28,1190
1187,5486,5618,7845,7974,132,129,9739,0,9739,1.0,0,5559.6,7899.38,5559.23,7899.03,1191
1188,5277,5377,7846,7976,100,130,8774,0,8774,1.0,0,5326.31,7916.66,5325.83,7916.02,1192
1189,3426,4322,7853,8468,896,615,318367,0,318367,1.0,0,3876.97,8157.36,3876.56,8157.0,1193
1190,8621,8902,7861,8148,281,287,50500,0,50500,1.0,0,8747.76,8002.3,8747.42,8001.81,1194
1191,5459,5491,7864,7930,32,66,1506,0,1506,1.0,0,5476.75,7895.4,5476.24,7895.01,1195
1192,5825,5942,7868,8009,117,141,12507,0,12507,1.0,0,5881.62,7934.8,5881.16,7934.36,1196
1193,6098,6223,7868,7968,125,100,7149,0,7149,1.0,0,6158.0,7918.17,6157.5,7917.71,1197
1194,5368,5443,7872,7949,75,77,3819,0,3819,1.0,0,5408.98,7913.01,5408.4,7912.51,1198
1195,9423,9524,7874,7973,101,99,6440,0,6440,1.0,0,9475.73,7925.13,9475.28,7924.63,1199
1196,5919,6118,7880,8098,199,218,29206,0,29206,1.0,0,6017.15,7986.93,6016.67,7986.46,1200
1197,5438,5467,7881,7919,29,38,760,0,760,1.0,0,5450.59,7900.34,5450.19,7899.87,1201
1198,9616,9689,7885,7972,73,87,4670,0,4670,1.0,0,9652.72,7927.49,9652.22,7927.04,1202
1199,8947,9122,7890,8067,175,177,19451,0,19451,1.0,0,9036.16,7980.68,9035.61,7980.16,1203
1200,9474,9625,7890,8010,151,120,7845,1749,6096,0.777055449330784,1,9552.52,7950.43,9551.87,7949.98,1204
1201,9170,9375,7896,8072,205,176,20126,0,20126,1.0,0,9271.36,7977.74,9270.98,7977.37,1205
1202,4213,4377,7902,8064,164,162,15126,0,15126,1.0,0,4296.95,7970.44,4296.55,7970.25,1206
1203,7681,7754,7907,7965,73,58,2019,0,2019,1.0,0,7717.79,7932.2,7717.22,7931.66,1208
1204,9761,9841,7907,8079,80,172,8197,0,8197,1.0,0,9803.37,8004.23,9803.0,8003.32,1207
1205,6103,6256,7912,8080,153,168,14821,0,14821,1.0,0,6183.95,8002.6,6183.46,8001.98,1211
1206,9728,9794,7914,7983,66,69,3271,0,3271,1.0,0,9759.87,7949.75,9759.38,7949.17,1209
1207,5435,5506,7915,7979,71,64,2780,0,2780,1.0,0,5468.0,7948.38,5467.62,7947.93,1210
1208,5489,5538,7920,7982,49,62,2072,0,2072,1.0,0,5514.98,7947.18,5514.46,7946.8,1212
1209,5585,5707,7934,8103,122,169,11666,0,11666,1.0,0,5644.16,8019.81,5643.63,8019.28,1214
1210,9672,9736,7934,7992,64,58,2081,0,2081,1.0,0,9704.54,7960.8,9703.96,7960.41,1213
1211,5517,5617,7937,8070,100,133,8696,0,8696,1.0,0,5565.91,8001.19,5565.39,8000.82,1215
1212,5351,5419,7939,8000,68,61,2711,0,2711,1.0,0,5385.28,7967.72,5384.82,7967.36,1216
1213,5399,5448,7939,8002,49,63,1188,0,1188,1.0,0,5427.96,7962.72,5426.57,7963.54,1217
1214,7307,7340,7940,7999,33,59,786,0,786,1.0,0,7320.78,7975.26,7320.94,7973.72,1222
1215,9310,9489,7940,8044,179,104,10608,0,10608,1.0,0,9402.98,7993.51,9402.28,7993.2,1218
1216,10948,11216,7940,8183,268,243,38690,0,38690,1.0,0,11085.36,8047.6,11084.75,8047.2,1219
1217,9529,9629,7947,8057,100,110,6033,1193,4840,0.8022542681916128,1,9575.61,8004.63,9575.29,8003.94,1220
1218,5699,5863,7948,8083,164,135,13906,0,13906,1.0,0,5773.0,8008.49,5772.58,8008.06,1221
1219,1373,2052,7957,8682,679,725,311313,0,311313,1.0,0,1727.34,8355.92,1726.78,8355.17,1223
1220,4193,4584,7960,8335,391,375,98689,0,98689,1.0,0,4404.82,8151.07,4404.34,8150.74,1224
1221,1380,1592,7963,8188,212,225,22802,0,22802,1.0,0,1485.66,8063.51,1485.37,8063.08,1228
1222,9609,9649,7963,8033,40,70,1527,208,1319,0.8637851997380485,0,9628.3,7998.76,9627.85,7998.15,1225
1223,9642,9716,7963,8042,74,79,3904,0,3904,1.0,0,9676.28,8005.9,9675.88,8005.35,1226
1224,12680,13122,7963,8476,442,513,155547,0,155547,1.0,0,12900.71,8189.85,12900.17,8189.44,1227
1225,5402,5520,7968,8074,118,106,8190,0,8190,1.0,0,5467.41,8017.06,5466.75,8016.57,1229
1226,4153,4260,7970,8131,107,161,9501,4251,5250,0.5525734133249132,1,4208.58,8043.24,4207.96,8042.83,1230
1227,1919,2430,7972,8441,511,469,151943,0,151943,1.0,0,2174.22,8195.25,2173.7,8194.84,1231
1228,5295,5434,7972,8129,139,157,13485,3864,9621,0.7134593993325917,1,5365.86,8046.8,5365.32,8046.34,1232
1229,9702,9777,7975,8037,75,62,3128,0,3128,1.0,0,9742.04,8003.11,9741.41,8002.71,1233
1230,1104,1486,7980,8383,382,403,93036,0,93036,1.0,0,1292.21,8186.0,1291.55,8185.48,1234
1231,9085,9198,7981,8102,113,121,9163,0,9163,1.0,0,9140.8,8042.25,9140.29,8041.75,1235
1232,8584,8627,7983,8034,43,51,1724,0,1724,1.0,0,8607.46,8007.68,8606.93,8007.23,1236
1233,8821,9007,7983,8200,186,217,27166,0,27166,1.0,0,8919.98,8095.37,8919.43,8094.83,1237
1234,6189,6915,7990,8427,726,437,179401,0,179401,1.0,0,6594.7,8217.33,6593.95,8216.85,1238
1235,8373,8435,7993,8146,62,153,6618,0,6618,1.0,0,8403.19,8068.53,8402.62,8068.44,1239
1236,9479,9529,7996,8035,50,39,1255,0,1255,1.0,0,9504.63,8013.03,9504.03,8012.68,1240
1237,6359,6385,7999,8030,26,31,440,0,440,1.0,0,6374.59,8012.84,6373.96,8012.54,1241
1238,5654,5877,8003,8298,223,295,27902,0,27902,1.0,0,5760.49,8148.32,5760.01,8147.97,1242
1239,5852,5983,8006,8132,131,126,11847,0,11847,1.0,0,5912.27,8074.44,5911.86,8073.87,1243
1240,6187,6445,8006,8187,258,181,31048,0,31048,1.0,0,6308.72,8098.57,6308.27,8098.05,1244
1241,8423,8469,8006,8059,46,53,1207,0,1207,1.0,0,8443.55,8031.0,8443.02,8030.49,1246
1242,10622,11039,8007,8320,417,313,102124,2260,99864,0.9778700403431123,0,10815.2,8165.74,10814.76,8165.25,1245
1243,9258,9417,8008,8125,159,117,11133,0,11133,1.0,0,9346.95,8071.58,9346.27,8071.2,1247
1244,11602,12287,8008,8554,685,546,278149,0,278149,1.0,0,11951.86,8282.46,11951.14,8281.89,1248
1245,7695,7736,8012,8068,41,56,1403,0,1403,1.0,0,7712.85,8043.05,7712.59,8042.47,1250
1246,812,1120,8013,8450,308,437,89204,630,88574,0.9929375364333438,0,951.74,8229.88,951.39,8229.43,1249
1247,9621,9673,8014,8089,52,75,2544,0,2544,1.0,0,9645.88,8052.33,9645.44,8051.73,1251
1248,9411,9497,8016,8084,86,68,3215,0,3215,1.0,0,9461.77,8052.19,9461.09,8051.48,1252
1249,9708,9766,8020,8090,58,70,2729,0,2729,1.0,0,9736.97,8055.27,9736.4,8054.68,1253
1250,8423,8663,8021,8202,240,181,27093,0,27093,1.0,0,8557.9,8120.3,8557.15,8119.77,1255
1251,9492,9529,8021,8059,37,38,902,0,902,1.0,0,9511.56,8041.44,9511.13,8040.77,1254
1252,9579,9626,8026,8082,47,56,1686,0,1686,1.0,0,9604.98,8050.58,9604.47,8050.29,1256
1253,5512,5554,8031,8109,42,78,2401,0,2401,1.0,0,5533.51,8068.54,5533.01,8068.1,1257
1254,5533,5721,8031,8208,188,177,17674,1398,16276,0.9209007581758515,1,5625.91,8125.86,5625.46,8125.13,1258
1255,8427,8519,8032,8121,92,89,6230,0,6230,1.0,0,8472.02,8079.17,8471.56,8078.55,1259
1256,6028,6221,8036,8225,193,189,23745,0,23745,1.0,0,6131.2,8135.15,6130.59,8134.57,1260
1257,9657,9765,8040,8161,108,121,7078,1365,5713,0.8071489121220684,1,9698.16,8100.09,9698.16,8099.58,1261
1258,9477,9635,8042,8212,158,170,14010,177,13833,0.9873661670235546,0,9533.92,8127.97,9533.89,8127.53,1263
1259,9157,9263,8043,8145,106,102,7208,0,7208,1.0,0,9213.25,8089.96,9212.6,8089.59,1262
1260,3249,3743,8044,8557,494,513,147435,0,147435,1.0,0,3466.91,8342.25,3466.44,8341.55,1264
1261,9569,9606,8044,8091,37,47,898,216,682,0.7594654788418709,0,9584.51,8069.01,9584.14,8068.42,1265
1262,8998,9118,8047,8185,120,138,11486,0,11486,1.0,0,9053.38,8114.88,9052.98,8114.41,1266
1263,9409,9458,8047,8099,49,52,1135,0,1135,1.0,0,9430.61,8080.52,9429.86,8079.01,1268
1264,5424,5458,8048,8089,34,41,905,0,905,1.0,0,5439.9,8070.07,5439.37,8069.46,1267
1265,5458,5520,8054,8120,62,66,2688,0,2688,1.0,0,5490.58,8085.43,5490.14,8085.02,1269
1266,7665,7736,8060,8147,71,87,4148,0,4148,1.0,0,7700.47,8105.39,7700.06,8104.85,1270
1267,13513,13848,8060,8344,335,284,67174,0,67174,1.0,0,13689.75,8214.14,13689.3,8213.59,1271
1268,9758,9842,8070,8135,84,65,3490,0,3490,1.0,0,9801.72,8097.0,9801.11,8096.56,1272
1269,9582,9633,8078,8152,51,74,2327,1816,511,0.21959604641168887,1,9605.24,8117.46,9605.0,8116.88,1273
1270,9616,9660,8079,8137,44,58,1583,71,1512,0.9551484523057486,0,9639.01,8102.01,9638.72,8101.95,1274
1271,9269,9492,8080,8333,223,253,27381,542,26839,0.9802052518169534,0,9374.41,8192.98,9374.15,8192.5,1275
1272,5944,6096,8084,8245,152,161,15726,0,15726,1.0,0,6012.84,8174.49,6012.42,8173.91,1276
1273,5431,5463,8087,8131,32,44,957,0,957,1.0,0,5447.85,8106.47,5447.31,8106.17,1277
1274,8659,8698,8089,8132,39,43,1004,0,1004,1.0,0,8675.0,8111.06,8674.55,8110.59,1278
1275,5301,5383,8093,8209,82,116,5971,0,5971,1.0,0,5343.36,8153.68,5342.74,8153.08,1279
1276,12603,12735,8095,8228,132,133,9492,0,9492,1.0,0,12685.46,8164.99,12684.67,8164.45,1280
1277,9064,9200,8100,8236,136,136,12097,0,12097,1.0,0,9136.46,8172.25,9135.84,8171.69,1281
1278,5428,5496,8101,8207,68,106,4623,0,4623,1.0,0,5462.86,8158.33,5462.38,8157.64,1283
1279,5489,5550,8101,8183,61,82,3175,0,3175,1.0,0,5517.33,8142.09,5516.93,8141.56,1282
1280,5380,5443,8104,8240,63,136,5304,0,5304,1.0,0,5408.57,8161.92,5408.23,8162.07,1284
1281,10867,11204,8104,8440,337,336,42330,0,42330,1.0,0,11042.81,8260.45,11042.06,8260.21,1285
1282,9748,9811,8108,8197,63,89,3508,0,3508,1.0,0,9781.4,8154.88,9780.76,8154.28,1286
1283,9194,9316,8109,8229,122,120,9865,0,9865,1.0,0,9261.4,8164.2,9260.82,8163.8,1287
1284,9711,9763,8111,8162,52,51,1525,21,1504,0.9862295081967213,0,9737.59,8137.62,9737.2,8136.89,1288
1285,8630,8934,8116,8340,304,224,46311,0,46311,1.0,0,8767.84,8229.44,8767.52,8228.79,1289
1286,13054,13555,8118,8437,501,319,107156,0,107156,1.0,0,13297.33,8281.07,13296.83,8280.5,1290
1287,9627,9658,8119,8155,31,36,709,0,709,1.0,0,9640.78,8136.66,9640.27,8136.21,1291
1288,12244,12765,8123,8767,521,644,216555,0,216555,1.0,0,12502.81,8410.81,12502.3,8410.45,1292
1289,5760,5949,8125,8253,189,128,11556,0,11556,1.0,0,5849.73,8186.66,5849.34,8186.16,1293
1290,8118,8667,8129,8496,549,367,114378,0,114378,1.0,0,8427.8,8334.39,8426.95,8333.89,1294
1291,7650,7744,8139,8192,94,53,3172,0,3172,1.0,0,7700.6,8165.54,7699.98,8164.92,1295
1292,6837,7847,8143,8551,1010,408,242509,0,242509,1.0,0,7345.62,8310.06,7345.26,8309.48,1296
1293,9630,9700,8144,8203,70,59,2815,0,2815,1.0,0,9662.31,8172.52,9661.9,8172.05,1297
1294,9698,9755,8149,8226,57,77,2837,0,2837,1.0,0,9725.54,8185.97,9724.88,8185.56,1298
1295,9538,9640,8156,8242,102,86,5378,0,5378,1.0,0,9590.3,8200.05,9589.84,8199.5,1300
1296,8868,9103,8159,8389,235,230,37335,0,37335,1.0,0,8987.74,8281.83,8987.24,8281.25,1301
1297,7774,8161,8161,8431,387,270,65531,0,65531,1.0,0,7941.47,8295.04,7941.21,8294.49,1302
1298,13799,14059,8163,8494,260,331,46710,0,46710,1.0,0,13924.28,8345.66,13923.57,8344.89,1303
1299,5673,6072,8168,8540,399,372,79853,0,79853,1.0,0,5890.14,8352.52,5889.38,8351.86,1304
1300,9738,9807,8171,8257,69,86,3313,15,3298,0.9954723815273167,0,9775.68,8216.8,9775.0,8216.06,1307
1301,5429,5511,8172,8255,82,83,3771,0,3771,1.0,0,5471.64,8219.47,5471.23,8218.67,1306
1302,5501,5574,8172,8267,73,95,5031,0,5031,1.0,0,5537.2,8222.18,5536.66,8221.61,1305
1303,9652,9707,8175,8228,55,53,1597,0,1597,1.0,0,9686.28,8205.65,9685.49,8204.92,1308
1304,0,917,8178,9022,917,844,434939,968,433971,0.9977744005481228,0,386.79,8567.91,387.32,8567.33,1309
1305,9371,9553,8181,8345,182,164,18874,1143,17731,0.9394405001589489,0,9457.37,8260.42,9456.86,8259.8,1310
1306,5571,5646,8184,8281,75,97,4422,0,4422,1.0,0,5608.28,8224.86,5607.75,8224.73,1311
1307,9173,9281,8188,8292,108,104,7226,0,7226,1.0,0,9228.49,8241.39,9227.88,8240.82,1312
1308,11547,11700,8188,8446,153,258,21618,0,21618,1.0,0,11628.96,8319.43,11628.41,8318.86,1313
1309,5416,5439,8190,8238,23,48,538,0,538,1.0,0,5426.0,8212.46,5425.61,8212.31,1315
1310,8627,8647,8192,8241,20,49,640,0,640,1.0,0,8637.83,8218.49,8637.22,8217.66,1316
1311,5318,5446,8193,8351,128,158,11878,3031,8847,0.7448223606667789,1,5388.33,8270.94,5387.72,8270.43,1314
1312,9631,9674,8198,8237,43,39,914,0,914,1.0,0,9651.22,8219.3,9650.81,8218.76,1317
1313,5617,5687,8200,8281,70,81,3132,0,3132,1.0,0,5652.91,8249.28,5652.37,8248.42,1318
1314,9530,9712,8211,8331,182,120,13023,0,13023,1.0,0,9618.14,8271.99,9617.77,8271.5,1319
1315,6066,6244,8213,8384,178,171,22172,0,22172,1.0,0,6147.18,8300.42,6146.76,8299.93,1320
1316,9707,9769,8213,8299,62,86,3311,3004,307,0.09272123225611598,1,9737.02,8255.66,9736.55,8255.16,1321
1317,9088,9215,8227,8350,127,123,10443,0,10443,1.0,0,9151.34,8286.5,9150.9,8286.12,1322
1318,2570,3104,8231,8807,534,576,216299,0,216299,1.0,0,2862.1,8536.92,2861.5,8536.37,1323
1319,5564,5599,8237,8285,35,48,1037,0,1037,1.0,0,5581.31,8261.47,5580.78,8260.93,1324
1320,5435,5520,8238,8307,85,69,3657,0,3657,1.0,0,5478.04,8273.19,5477.45,8272.74,1325
1321,9745,9807,8254,8301,62,47,1883,374,1509,0.8013807753584705,0,9781.56,8279.59,9780.74,8279.22,1326
1322,10892,11297,8261,8619,405,358,83491,0,83491,1.0,0,11117.57,8433.8,11116.88,8433.41,1327
1323,5501,5589,8263,8358,88,95,6160,0,6160,1.0,0,5547.48,8309.09,5546.96,8308.61,1328
1324,4257,4534,8264,8661,277,397,52551,0,52551,1.0,0,4411.41,8427.55,4411.05,8427.56,1330
1325,10391,10554,8264,8399,163,135,16730,0,16730,1.0,0,10462.98,8328.3,10462.64,8327.82,1329
1326,10525,10887,8265,8637,362,372,88704,0,88704,1.0,0,10704.57,8437.95,10704.11,8437.49,1331
1327,5332,5365,8266,8327,33,61,1158,0,1158,1.0,0,5348.6,8293.82,5348.13,8293.52,1332
1328,9617,9741,8273,8411,124,138,8972,148,8824,0.9835042353990192,0,9674.44,8346.89,9674.18,8346.13,1333
1329,5581,5682,8277,8370,101,93,6394,0,6394,1.0,0,5634.71,8318.75,5634.23,8318.42,1334
1330,5677,5737,8280,8323,60,43,1786,0,1786,1.0,0,5705.9,8301.5,5705.43,8301.0,1335
1331,9193,9310,8282,8397,117,115,9307,0,9307,1.0,0,9251.37,8338.51,9250.85,8338.06,1336
1332,11296,11661,8288,8875,365,587,121383,1423,119960,0.9882767768138866,0,11467.32,8545.0,11466.7,8544.76,1337
1333,2239,2686,8293,8620,447,327,99896,0,99896,1.0,0,2472.4,8442.8,2471.85,8442.31,1338
1334,9309,9405,8293,8342,96,49,2394,0,2394,1.0,0,9365.85,8320.86,9364.71,8320.55,1339
1335,730,1006,8295,8586,276,291,41423,0,41423,1.0,0,854.4,8458.89,854.02,8458.16,1342
1336,9742,9805,8297,8341,63,44,2099,36,2063,0.9828489757027156,0,9771.41,8317.44,9770.97,8316.89,1340
1337,5436,5507,8298,8381,71,83,4460,0,4460,1.0,0,5470.68,8335.9,5470.2,8335.51,1341
1338,1059,1454,8299,8612,395,313,75877,0,75877,1.0,0,1252.9,8457.64,1252.38,8457.29,1343
1339,9710,9754,8299,8384,44,85,2240,61,2179,0.9727678571428572,0,9731.69,8341.79,9731.36,8341.17,1344
1340,9482,9637,8303,8445,155,142,11573,0,11573,1.0,0,9563.65,8376.36,9563.09,8375.92,1345
1341,8663,8693,8304,8342,30,38,661,0,661,1.0,0,8674.84,8323.73,8674.44,8323.2,1346
1342,13400,13746,8309,8663,346,354,89019,0,89019,1.0,0,13571.56,8496.13,13571.03,8495.56,1347
1343,9416,9542,8312,8393,126,81,7129,0,7129,1.0,0,9481.42,8349.74,9480.86,8349.23,1348
1344,9737,9819,8320,8414,82,94,4792,0,4792,1.0,0,9779.48,8376.18,9779.03,8375.29,1349
1345,13706,13862,8320,8592,156,272,32622,0,32622,1.0,0,13780.7,8450.1,13780.24,8449.67,1350
1346,8994,9245,8322,8589,251,267,44567,0,44567,1.0,0,9112.83,8448.68,9112.38,8448.27,1351
1347,8181,8906,8325,8845,725,520,147635,4607,143028,0.9687946625122769,1,8515.47,8553.47,8515.44,8552.76,1352
1348,6399,6875,8327,8777,476,450,130061,4774,125287,0.9632941465927526,2,6658.41,8528.99,6657.89,8528.45,1353
1349,5352,5459,8329,8464,107,135,8752,0,8752,1.0,0,5403.18,8398.9,5402.7,8398.29,1354
1350,9300,9427,8334,8451,127,117,10093,0,10093,1.0,0,9369.96,8386.17,9369.31,8385.72,1355
1351,1029,1112,8336,8468,83,132,5975,0,5975,1.0,0,1078.93,8411.62,1078.45,8410.8,1358
1352,7967,8119,8337,8435,152,98,4078,0,4078,1.0,0,8034.57,8379.27,8034.67,8378.82,1356
1353,3967,4497,8338,8731,530,393,108969,0,108969,1.0,0,4216.51,8544.08,4216.15,8543.61,1359
1354,5482,5617,8338,8432,135,94,6654,0,6654,1.0,0,5544.85,8387.18,5544.56,8386.74,1357
1355,12955,13169,8339,8512,214,173,22514,0,22514,1.0,0,13057.87,8437.86,13057.49,8437.17,1362
1356,5625,5766,8340,8454,141,114,10545,0,10545,1.0,0,5695.67,8396.69,5695.16,8396.26,1360
1357,6262,6424,8340,8550,162,210,23890,0,23890,1.0,0,6338.57,8434.79,6338.07,8434.46,1361
1358,5570,5636,8342,8399,66,57,2845,0,2845,1.0,0,5603.53,8368.9,5603.01,8368.4,1364
1359,6531,6573,8342,8385,42,43,1141,0,1141,1.0,0,6548.34,8367.26,6548.03,8366.63,1363
1360,5718,6222,8346,9055,504,709,161215,0,161215,1.0,0,5979.48,8705.45,5979.07,8704.86,1365
1361,6143,6265,8353,8514,122,161,14557,0,14557,1.0,0,6206.43,8432.23,6205.91,8431.77,1366
1362,7875,8236,8356,8555,361,199,44847,0,44847,1.0,0,8049.46,8478.69,8049.05,8478.11,1367
1363,11201,11364,8359,8873,163,514,54853,1419,53434,0.974130858840902,0,11294.75,8623.18,11294.22,8622.56,1372
1364,9627,9744,8362,8484,117,122,7925,0,7925,1.0,0,9686.55,8430.59,9686.2,8429.78,1368
1365,1997,2367,8364,8726,370,362,76966,0,76966,1.0,0,2159.21,8551.35,2158.74,8550.81,1369
1366,5436,5560,8368,8471,124,103,6685,1451,5234,0.7829468960359013,1,5495.34,8423.15,5494.78,8422.5,1370
1367,7658,8433,8372,9003,775,631,233152,177,232975,0.9992408385945649,0,8002.25,8709.94,8001.58,8709.25,1371
1368,9226,9356,8372,8509,130,137,12125,0,12125,1.0,0,9288.81,8440.58,9288.42,8440.09,1373
1369,3674,4520,8373,9127,846,754,290757,0,290757,1.0,0,4050.49,8771.55,4049.95,8770.86,1374
1370,6965,7298,8374,8691,333,317,48768,0,48768,1.0,0,7132.4,8498.38,7131.91,8498.14,1376
1371,8798,9002,8374,8601,204,227,29092,0,29092,1.0,0,8903.74,8482.43,8903.23,8482.02,1375
1372,9393,9579,8378,8532,186,154,14712,0,14712,1.0,0,9484.01,8460.49,9483.47,8459.95,1377
1373,8970,9008,8384,8431,38,47,1279,0,1279,1.0,0,8989.54,8403.22,8989.05,8402.94,1378
1374,10329,10557,8391,8598,228,207,25984,0,25984,1.0,0,10452.32,8496.92,10451.66,8496.5,1379
1375,9555,9646,8394,8480,91,86,5092,0,5092,1.0,0,9598.01,8440.94,9597.59,8440.46,1380
1376,12581,13117,8396,8836,536,440,123717,0,123717,1.0,0,12836.98,8617.92,12836.71,8617.42,1381
1377,5602,5646,8397,8458,44,61,1625,0,1625,1.0,0,5625.61,8430.75,5625.03,8430.1,1382
1378,6624,7340,8400,9080,716,680,256087,0,256087,1.0,0,6968.65,8780.53,6968.23,8780.07,1383
1379,9715,9771,8405,8537,56,132,4017,0,4017,1.0,0,9747.76,8466.04,9747.27,8465.94,1384
1380,13077,13438,8407,8732,361,325,93024,0,93024,1.0,0,13258.47,8573.15,13257.96,8572.54,1385
1381,9758,9832,8408,8545,74,137,5742,0,5742,1.0,0,9791.16,8469.04,9790.6,8468.95,1386
1382,7626,7670,8409,8445,44,36,959,0,959,1.0,0,7650.02,8429.79,7649.43,8429.21,1387
1383,5732,5771,8417,8464,39,47,1427,0,1427,1.0,0,5751.82,8440.54,5751.29,8440.03,1388
1384,5560,5628,8426,8502,68,76,3349,0,3349,1.0,0,5594.17,8461.36,5593.7,8460.97,1389
1385,7419,7690,8431,8658,271,227,38056,0,38056,1.0,0,7571.32,8533.09,7570.62,8532.66,1390
1386,909,1104,8440,8797,195,357,45821,0,45821,1.0,0,1002.33,8626.06,1001.94,8625.31,1391
1387,10776,10960,8440,8687,184,247,22734,0,22734,1.0,0,10872.64,8560.5,10871.92,8560.29,1393
1388,8344,8430,8441,8496,86,55,3490,0,3490,1.0,0,8389.38,8467.08,8388.78,8466.57,1392
1389,5651,5741,8442,8538,90,96,4565,0,4565,1.0,0,5699.23,8478.49,5698.77,8478.38,1394
1390,3059,3652,8444,9124,593,680,242165,0,242165,1.0,0,3334.17,8786.75,3333.69,8786.17,1395
1391,9321,9419,8449,8572,98,123,8463,0,8463,1.0,0,9373.09,8509.73,9372.5,8509.25,1396
1392,5604,5683,8454,8534,79,80,3535,0,3535,1.0,0,5646.97,8497.24,5646.35,8496.76,1397
1393,11931,12415,8456,8955,484,499,150099,0,150099,1.0,0,12182.02,8698.56,12181.35,8697.99,1400
1394,5528,5576,8457,8498,48,41,1212,0,1212,1.0,0,5551.93,8476.71,5551.42,8476.26,1398
1395,5620,5829,8457,8854,209,397,35054,0,35054,1.0,0,5742.86,8680.6,5742.5,8679.39,1399
1396,5716,5780,8461,8619,64,158,6328,0,6328,1.0,0,5743.62,8541.89,5743.04,8541.27,1401
1397,3444,3766,8467,8908,322,441,79134,0,79134,1.0,0,3641.2,8665.17,3640.55,8664.76,1402
1398,9547,9667,8468,8555,120,87,5919,0,5919,1.0,0,9619.34,8511.35,9618.43,8510.88,1403
1399,9594,9767,8469,8685,173,216,17849,0,17849,1.0,0,9686.63,8574.8,9686.05,8574.57,1404
1400,6186,6323,8474,8602,137,128,12747,0,12747,1.0,0,6254.46,8543.92,6254.0,8543.33,1405
1401,9188,9339,8481,8674,151,193,20022,0,20022,1.0,0,9261.36,8572.3,9260.85,8571.87,1406
1402,5511,5610,8484,8652,99,168,8527,0,8527,1.0,0,5562.14,8551.65,5561.89,8551.76,1407
1403,9790,9851,8487,8557,61,70,2616,0,2616,1.0,0,9823.71,8522.47,9823.32,8521.9,1409
1404,9409,9496,8488,8595,87,107,5969,0,5969,1.0,0,9451.44,8537.61,9450.99,8537.28,1408
1405,8985,9030,8494,8550,45,56,1376,0,1376,1.0,0,9006.5,8526.69,9006.02,8525.93,1410
1406,10467,10778,8496,8803,311,307,55856,0,55856,1.0,0,10607.69,8653.5,10607.3,8653.05,1411
1407,6098,6217,8497,8612,119,115,6652,0,6652,1.0,0,6158.3,8553.22,6157.94,8552.95,1412
1408,1352,1660,8505,8848,308,343,54102,0,54102,1.0,0,1507.3,8680.18,1506.77,8679.56,1413
1409,5791,5880,8509,8791,89,282,14914,0,14914,1.0,0,5838.85,8649.25,5838.18,8648.66,1415
1410,6307,6555,8510,8737,248,227,34871,0,34871,1.0,0,6437.63,8624.72,6437.08,8624.2,1414
1411,7186,7570,8516,8787,384,271,71693,0,71693,1.0,0,7366.95,8656.84,7366.59,8656.32,1416
1412,5678,5726,8519,8663,48,144,3946,0,3946,1.0,0,5699.42,8576.29,5698.8,8576.95,1417
1413,5578,5687,8520,8697,109,177,14804,0,14804,1.0,0,5635.08,8607.43,5634.46,8606.91,1418
1414,9456,9556,8520,8631,100,111,6603,0,6603,1.0,0,9511.61,8575.53,9510.89,8575.17,1419
1415,9544,9649,8523,8639,105,116,6810,0,6810,1.0,0,9594.68,8575.69,9594.06,8575.18,1420
1416,11468,12033,8523,9001,565,478,193461,0,193461,1.0,0,11758.42,8750.66,11757.91,8750.2,1421
1417,8642,8796,8530,8682,154,152,16996,0,16996,1.0,0,8717.35,8598.79,8716.83,8598.38,1422
1418,8912,9068,8531,8750,156,219,25070,0,25070,1.0,0,8987.17,8638.02,8986.7,8637.41,1423
1419,9166,9194,8533,8585,28,52,906,0,906,1.0,0,9183.03,8558.0,9182.46,8557.55,1424
1420,8795,8830,8535,8581,35,46,1034,0,1034,1.0,0,8809.69,8558.86,8809.32,8558.23,1425
1421,9743,9841,8539,8657,98,118,7753,0,7753,1.0,0,9794.88,8595.29,9794.43,8594.89,1426
1422,10669,11286,8540,9095,617,555,226324,0,226324,1.0,0,10974.51,8828.63,10974.01,8828.11,1427
1423,966,1582,8546,9050,616,504,179318,0,179318,1.0,0,1223.11,8813.66,1222.91,8813.15,1428
1424,9277,9464,8549,8729,187,180,21663,0,21663,1.0,0,9378.67,8643.77,9378.06,8643.26,1429
1425,9057,9216,8552,8728,159,176,18662,0,18662,1.0,0,9129.96,8638.92,9129.58,8638.46,1430
1426,8765,8916,8553,8746,151,193,20105,0,20105,1.0,0,8848.38,8649.6,8847.78,8649.11,1431
1427,13526,13856,8578,8983,330,405,77524,0,77524,1.0,0,13704.78,8772.22,13704.3,8771.65,1432
1428,10241,10534,8589,8967,293,378,74633,0,74633,1.0,0,10390.11,8793.96,10389.61,8793.36,1434
1429,692,1017,8590,8984,325,394,80182,167,80015,0.9979172382829063,0,843.14,8808.94,842.89,8808.45,1433
1430,5859,6817,8593,9493,958,900,450565,8785,441780,0.9805022582757205,3,6411.66,9061.21,6410.73,9060.58,1435
1431,2107,2852,8597,9304,745,707,352049,0,352049,1.0,0,2467.72,8929.8,2467.27,8929.36,1436
1432,9461,9595,8602,8695,134,93,7932,0,7932,1.0,0,9534.41,8645.92,9533.7,8645.53,1437
1433,9690,9788,8604,8692,98,88,4866,0,4866,1.0,0,9740.15,8647.58,9739.7,8647.23,1438
1434,13238,13573,8611,8997,335,386,82752,0,82752,1.0,0,13418.09,8813.05,13417.56,8812.48,1441
1435,7531,7860,8612,9046,329,434,100488,0,100488,1.0,0,7686.55,8819.92,7686.08,8819.43,1439
1436,1593,2173,8613,9228,580,615,203768,0,203768,1.0,0,1884.56,8859.85,1883.92,8859.73,1440
1437,8453,8683,8633,8851,230,218,29184,0,29184,1.0,0,8590.55,8748.8,8589.76,8748.41,1442
1438,9658,9719,8636,8701,61,65,2049,0,2049,1.0,0,9690.79,8674.34,9690.14,8673.65,1443
1439,9567,9644,8647,8740,77,93,4751,0,4751,1.0,0,9604.97,8698.25,9604.46,8697.6,1445
1440,9135,9269,8649,8765,134,116,8988,0,8988,1.0,0,9204.84,8710.13,9204.31,8709.56,1444
1441,9778,9898,8651,8792,120,141,10423,5476,4947,0.4746234289551952,1,9832.85,8726.84,9832.31,8726.2,1446
1442,12824,13298,8651,9094,474,443,136204,0,136204,1.0,0,13072.77,8878.61,13072.2,8878.12,1447
1443,8674,8834,8652,8824,160,172,19524,0,19524,1.0,0,8747.16,8743.38,8746.77,8742.81,1448
1444,12254,12896,8652,9301,642,649,231039,0,231039,1.0,0,12598.76,8982.9,12598.0,8982.29,1449
1445,9468,9572,8661,8769,104,108,6133,0,6133,1.0,0,9522.47,8714.37,9521.62,8713.71,1450
1446,9411,9483,8664,8737,72,73,3004,0,3004,1.0,0,9450.07,8705.12,9449.51,8704.47,1451
1447,9207,9342,8671,8875,135,204,16283,1160,15123,0.9287600565006449,0,9275.75,8777.86,9275.25,8777.25,1452
1448,9691,9792,8674,8819,101,145,10547,0,10547,1.0,0,9739.31,8743.72,9738.77,8743.28,1453
1449,9625,9696,8682,8771,71,89,3861,0,3861,1.0,0,9664.11,8725.95,9663.68,8725.52,1454
1450,8955,9145,8691,8838,190,147,16529,0,16529,1.0,0,9046.0,8766.71,9045.59,8766.18,1455
1451,8800,8962,8711,8860,162,149,14391,0,14391,1.0,0,8883.55,8785.56,8883.01,8785.09,1456
1452,9424,9524,8717,8808,100,91,5963,0,5963,1.0,0,9472.32,8767.65,9471.86,8766.95,1458
1453,9324,9433,8718,8834,109,116,9781,0,9781,1.0,0,9379.88,8777.4,9379.37,8776.87,1457
1454,9510,9643,8731,8835,133,104,8234,287,7947,0.9651445227107117,0,9572.91,8782.48,9572.54,8781.92,1459
1455,10215,10735,8742,9141,520,399,103910,0,103910,1.0,0,10526.28,8971.69,10525.3,8971.11,1460
1456,9076,9224,8749,8884,148,135,13369,0,13369,1.0,0,9152.31,8820.0,9151.74,8819.45,1461
1457,9583,9699,8753,8864,116,111,7745,421,7324,0.9456423499031633,0,9642.96,8809.49,9642.35,8809.04,1462
1458,7295,7547,8763,9174,252,411,49179,0,49179,1.0,0,7395.44,8909.9,7394.93,8910.07,1463
1459,9724,9832,8774,8901,108,127,7625,3710,3915,0.5134426229508197,1,9774.75,8832.0,9774.33,8831.6,1464
1460,9780,9908,8776,8914,128,138,7663,347,7316,0.9547174735743181,0,9841.03,8838.79,9840.6,8838.44,1465
1461,2746,3279,8783,9292,533,509,167700,0,167700,1.0,0,3002.3,9015.98,3001.88,9015.7,1466
1462,8616,8718,8784,8889,102,105,6624,0,6624,1.0,0,8669.28,8840.89,8668.72,8840.27,1467
1463,9395,9549,8793,8916,154,123,10202,31,10171,0.9969613801215448,0,9458.53,8851.04,9458.56,8850.42,1468
1464,8863,9004,8799,8924,141,125,10430,0,10430,1.0,0,8932.91,8862.59,8932.44,8862.06,1469
1465,9653,9740,8805,8906,87,101,5310,1773,3537,0.6661016949152543,1,9695.65,8855.99,9695.21,8855.41,1470
1466,9299,9407,8813,8922,108,109,6861,130,6731,0.9810523247340038,0,9356.13,8866.01,9355.73,8865.55,1471
1467,8704,8819,8816,8902,115,86,6153,0,6153,1.0,0,8756.41,8853.15,8756.04,8852.76,1472
1468,8997,9083,8823,8897,86,74,4560,0,4560,1.0,0,9039.44,8857.26,9038.93,8856.83,1473
1469,9492,9676,8829,8972,184,143,15013,1767,13246,0.8823020049290615,0,9587.76,8902.12,9587.1,8901.63,1474
1470,8430,8645,8830,8938,215,108,14879,0,14879,1.0,0,8539.71,8878.27,8539.3,8877.78,1475
1471,8747,8867,8839,8957,120,118,8433,0,8433,1.0,0,8808.16,8899.5,8807.64,8898.96,1476
1472,9117,9251,8839,8942,134,103,7365,0,7365,1.0,0,9188.43,8895.66,9187.84,8895.13,1477
1473,4415,4744,8843,9302,329,459,93926,453,93473,0.9951770542767711,0,4579.07,9049.24,4578.58,9048.89,1478
1474,1309,1777,8848,9350,468,502,156670,0,156670,1.0,0,1534.08,9095.62,1533.53,9095.17,1479
1475,7648,8440,8852,9710,792,858,436023,10512,425511,0.9758911800524285,5,8080.57,9247.4,8080.08,9246.91,1480
1476,9454,9520,8853,8931,66,78,3402,0,3402,1.0,0,9489.43,8890.42,9488.81,8890.09,1481
1477,9196,9325,8854,8952,129,98,5489,2085,3404,0.6201493896884679,0,9267.09,8905.96,9266.34,8905.54,1482
1478,7445,7591,8856,9017,146,161,15553,0,15553,1.0,0,7525.19,8942.5,7524.65,8941.91,1483
1479,8994,9133,8862,8993,139,131,9805,0,9805,1.0,0,9064.81,8926.21,9064.18,8925.81,1484
1480,11097,11805,8863,9485,708,622,335016,0,335016,1.0,0,11450.74,9180.69,11450.31,9180.14,1485
1481,8608,8755,8874,9003,147,129,12348,0,12348,1.0,0,8680.03,8938.9,8679.55,8938.38,1486
1482,8290,8658,8875,9587,368,712,115520,4996,110524,0.9567520775623268,1,8472.68,9321.13,8472.14,9319.77,1489
1483,8916,9021,8875,8968,105,93,6786,0,6786,1.0,0,8971.1,8928.09,8970.63,8927.42,1487
1484,11735,12357,8875,9473,622,598,283979,0,283979,1.0,0,12054.22,9182.3,12053.83,9181.74,1488
1485,9673,9804,8879,8992,131,113,8239,0,8239,1.0,0,9739.95,8932.49,9739.42,8932.11,1490
1486,3500,4100,8885,9513,600,628,237535,0,237535,1.0,0,3830.15,9184.8,3829.51,9184.28,1491
1487,13466,13772,8888,9248,306,360,77573,0,77573,1.0,0,13624.83,9069.47,13624.27,9068.94,1492
1488,8455,8627,8891,9038,172,147,15492,989,14503,0.9361605990188484,0,8535.92,8967.45,8535.42,8966.92,1493
1489,9295,9402,8898,8961,107,63,3797,36,3761,0.9905188306557808,0,9355.01,8925.06,9354.38,8924.68,1494
1490,8792,8918,8899,9002,126,103,8764,0,8764,1.0,0,8858.49,8957.55,8857.93,8956.93,1495
1491,9773,9827,8900,8955,54,55,1615,0,1615,1.0,0,9801.34,8921.78,9800.81,8921.51,1496
1492,7220,7305,8914,9146,85,232,15259,0,15259,1.0,0,7266.55,9025.77,7266.14,9025.4,1497
1493,9398,9472,8915,8956,74,41,2212,0,2212,1.0,0,9431.88,8934.13,9431.56,8933.63,1498
1494,4084,4537,8918,9306,453,388,111024,0,111024,1.0,0,4310.22,9139.32,4309.84,9138.71,1500
1495,9246,9382,8924,8995,136,71,5670,477,5193,0.9158730158730158,0,9309.08,8959.32,9308.77,8958.9,1499
1496,9400,9522,8928,9014,122,86,6437,0,6437,1.0,0,9460.74,8972.99,9460.25,8972.29,1501
1497,9020,9274,8929,9081,254,152,24910,0,24910,1.0,0,9154.46,9003.88,9153.83,9003.41,1502
1498,13119,13507,8935,9304,388,369,68161,0,68161,1.0,0,13332.62,9099.72,13331.68,9099.5,1503
1499,9564,9738,8938,9068,174,130,15802,5086,10716,0.678142007340843,1,9646.71,8999.12,9646.26,8998.65,1504
1500,8607,8794,8940,9147,187,207,23920,0,23920,1.0,0,8709.4,9052.56,8709.01,9051.7,1505
1501,7017,7151,8949,9070,134,121,10645,0,10645,1.0,0,7084.63,9016.65,7084.08,9016.04,1506
1502,9508,9573,8949,8987,65,38,1772,0,1772,1.0,0,9536.97,8969.25,9536.72,8968.78,1507
1503,8910,9020,8956,9011,110,55,3467,0,3467,1.0,0,8965.92,8987.44,8965.15,8986.79,1508
1504,9332,9431,8956,9053,99,97,5056,0,5056,1.0,0,9377.74,9008.99,9377.34,9008.46,1509
1505,6719,7048,8962,9174,329,212,43192,0,43192,1.0,0,6892.3,9065.77,6891.67,9065.27,1510
1506,8843,8967,8973,9093,124,120,8792,0,8792,1.0,0,8903.94,9036.71,8903.41,9036.19,1511
1507,9273,9337,8977,9015,64,38,1642,0,1642,1.0,0,9305.92,8996.41,9305.38,8995.88,1512
1508,7347,7678,8980,9213,331,233,50419,0,50419,1.0,0,7492.45,9093.45,7492.15,9092.93,1513
1509,1828,2222,8983,9313,394,330,72280,0,72280,1.0,0,2022.37,9141.17,2021.89,9140.78,1515
1510,9482,9574,8983,9048,92,65,3677,1245,2432,0.661408757138972,0,9525.59,9009.54,9525.01,9009.22,1514
1511,8765,8860,8987,9077,95,90,5909,0,5909,1.0,0,8811.62,9033.5,8811.07,9032.92,1516
1512,9252,9346,8990,9135,94,145,7556,0,7556,1.0,0,9294.59,9059.42,9294.34,9058.68,1517
1513,8955,9063,9001,9098,108,97,7272,0,7272,1.0,0,9009.64,9051.0,9009.05,9050.49,1518
1514,10118,10276,9004,9157,158,153,17869,0,17869,1.0,0,10190.18,9081.99,10189.79,9081.46,1519
1515,8481,8658,9008,9184,177,176,15705,788,14917,0.9498248965297675,0,8581.97,9092.18,8581.25,9091.43,1520
1516,9440,9492,9008,9062,52,54,1636,155,1481,0.9052567237163814,0,9469.58,9032.5,9468.99,9032.05,1521
1517,12769,13217,9010,9489,448,479,155222,0,155222,1.0,0,13002.3,9262.01,13001.74,9261.44,1522
1518,9396,9471,9013,9079,75,66,3192,0,3192,1.0,0,9428.13,9049.51,9427.73,9048.99,1523
1519,9471,9614,9018,9100,143,82,6510,490,6020,0.9247311827956989,0,9542.23,9061.79,9541.77,9061.45,1524
1520,10929,11121,9019,9268,192,249,32527,0,32527,1.0,0,11033.69,9144.0,11033.22,9143.37,1525
1521,1058,1509,9023,9453,451,430,94114,0,94114,1.0,0,1251.58,9227.7,1251.58,9227.56,1526
1522,12304,12466,9037,9241,162,204,23128,0,23128,1.0,0,12379.58,9141.53,12379.1,9141.01,1527
1523,9296,9402,9041,9160,106,119,4106,0,4106,1.0,0,9340.68,9088.95,9340.22,9088.72,1528
1524,9129,9220,9052,9147,91,95,5616,0,5616,1.0,0,9172.35,9092.5,9171.84,9092.16,1529
1525,8994,9090,9055,9168,96,113,4383,199,4184,0.9545973077800594,0,9042.54,9111.89,9042.04,9111.4,1531
1526,10550,10989,9055,9505,439,450,132105,0,132105,1.0,0,10746.97,9261.71,10746.61,9261.27,1530
1527,6981,7343,9062,9278,362,216,53691,0,53691,1.0,0,7148.38,9171.21,7148.01,9170.67,1532
1528,9203,9271,9063,9147,68,84,4071,0,4071,1.0,0,9237.38,9109.29,9236.89,9108.7,1534
1529,8848,9018,9065,9219,170,154,16002,2390,13612,0.8506436695413073,0,8927.56,9136.55,8927.13,9136.1,1533
1530,8773,8871,9067,9150,98,83,5458,0,5458,1.0,0,8822.2,9109.62,8821.73,9109.05,1535
1531,9058,9137,9068,9150,79,82,3172,0,3172,1.0,0,9098.65,9110.0,9098.2,9109.41,1536
1532,9296,9415,9069,9196,119,127,7945,0,7945,1.0,0,9359.85,9132.95,9359.18,9132.65,1537
1533,10222,10565,9071,9393,343,322,86892,3331,83561,0.9616650554711595,1,10392.62,9227.76,10392.1,9227.3,1538
1534,3046,3789,9081,9783,743,702,367896,0,367896,1.0,0,3403.24,9441.71,3402.73,9441.14,1539
1535,4616,5075,9085,9723,459,638,144236,2987,141249,0.9792908843839263,1,4852.37,9365.27,4852.05,9365.19,1540
1536,7452,7935,9107,9830,483,723,203433,0,203433,1.0,0,7655.78,9533.98,7655.32,9533.17,1541
1537,9104,9168,9111,9168,64,57,1692,0,1692,1.0,0,9132.41,9139.83,9132.07,9139.41,1542
1538,6789,7182,9113,9334,393,221,40518,0,40518,1.0,0,6936.9,9246.1,6936.83,9245.48,1543
1539,9170,9222,9122,9173,52,51,1610,0,1610,1.0,0,9198.32,9146.55,9197.79,9146.15,1544
1540,8692,8797,9123,9223,105,100,6074,0,6074,1.0,0,8745.16,9169.86,8744.65,9169.43,1545
1541,9005,9080,9127,9226,75,99,4136,0,4136,1.0,0,9046.8,9180.33,9046.26,9179.73,1546
1542,9219,9302,9131,9222,83,91,4377,0,4377,1.0,0,9266.75,9171.3,9266.07,9170.94,1547
1543,8647,8707,9134,9198,60,64,2508,0,2508,1.0,0,8671.85,9164.76,8671.54,9164.18,1548
1544,9073,9139,9138,9177,66,39,1492,0,1492,1.0,0,9104.23,9161.25,9103.87,9160.71,1549
1545,9137,9176,9147,9214,39,67,1801,0,1801,1.0,0,9157.89,9182.52,9157.41,9181.92,1552
1546,10046,10228,9147,9298,182,151,20173,0,20173,1.0,0,10144.09,9223.39,10143.47,9222.91,1550
1547,8760,8871,9148,9302,111,154,9614,11,9603,0.9988558352402745,0,8813.87,9209.86,8813.28,9209.84,1551
1548,9172,9215,9150,9219,43,69,1753,0,1753,1.0,0,9189.29,9185.27,9188.85,9184.6,1553
1549,2510,3126,9156,9711,616,555,248014,0,248014,1.0,0,2842.87,9438.38,2842.26,9437.84,1554
1550,8974,9028,9157,9203,54,46,1808,639,1169,0.646570796460177,0,8999.2,9179.05,8998.74,9178.58,1555
1551,1428,1992,9165,9740,564,575,223200,0,223200,1.0,0,1736.36,9485.94,1735.79,9485.34,1560
1552,9191,9256,9167,9247,65,80,3177,0,3177,1.0,0,9225.42,9211.04,9224.96,9210.44,1556
1553,9059,9152,9170,9259,93,89,4559,1644,2915,0.639394604079842,1,9101.47,9209.53,9101.01,9209.18,1557
1554,7291,7496,9172,9614,205,442,66943,0,66943,1.0,0,7383.36,9394.83,7382.99,9394.39,1558
1555,1960,2521,9173,9668,561,495,203049,0,203049,1.0,0,2214.88,9423.23,2214.44,9422.73,1559
1556,12276,12680,9181,9696,404,515,141113,0,141113,1.0,0,12466.34,9446.04,12465.84,9445.45,1562
1557,8586,8718,9182,9282,132,100,8788,0,8788,1.0,0,8645.31,9224.81,8644.92,9224.54,1561
1558,4076,4614,9184,9550,538,366,104688,0,104688,1.0,0,4317.69,9387.74,4317.26,9386.95,1563
1559,8922,8983,9190,9223,61,33,1234,0,1234,1.0,0,8953.81,9203.62,8953.26,9203.23,1564
1560,13217,13367,9199,9352,150,153,16528,0,16528,1.0,0,13298.88,9281.19,13298.29,9280.71,1565
1561,8958,9022,9201,9245,64,44,1886,0,1886,1.0,0,8988.91,9224.59,8988.46,9224.09,1566
1562,8814,8909,9208,9283,95,75,3313,1454,1859,0.5611228493812255,1,8858.2,9242.73,8857.75,9242.29,1567
1563,8906,8958,9209,9255,52,46,1590,0,1590,1.0,0,8929.64,9230.7,8929.22,9230.26,1568
1564,9081,9216,9211,9356,135,145,9460,286,9174,0.9697674418604652,0,9140.24,9269.8,9139.71,9269.64,1570
1565,8716,8779,9212,9273,63,61,2516,0,2516,1.0,0,8751.59,9242.2,8750.93,9241.63,1569
1566,9016,9062,9217,9255,46,38,1233,0,1233,1.0,0,9039.62,9236.24,9039.15,9235.71,1571
1567,8685,8737,9224,9279,52,55,1769,0,1769,1.0,0,8710.77,9254.02,8710.31,9253.47,1572
1568,9959,10087,9225,9381,128,156,11776,0,11776,1.0,0,10020.34,9305.88,10019.9,9305.34,1573
1569,7085,7517,9227,9807,432,580,123402,2964,120438,0.9759809403413234,2,7278.72,9569.76,7278.3,9569.07,1574
1570,9045,9093,9232,9286,48,54,1573,0,1573,1.0,0,9070.59,9261.52,9070.01,9260.82,1575
1571,8922,8963,9235,9271,41,36,788,0,788,1.0,0,8946.61,9255.39,8945.9,9254.69,1576
1572,12605,12895,9237,9618,290,381,67235,0,67235,1.0,0,12748.94,9451.72,12748.39,9451.09,1577
1573,8858,8922,9240,9291,64,51,2386,52,2334,0.9782062028499581,0,8887.74,9265.5,8887.36,9264.97,1578
1574,8895,9017,9241,9335,122,94,6518,0,6518,1.0,0,8961.02,9285.85,8960.35,9285.24,1579
1575,10727,11261,9244,9843,534,599,213427,0,213427,1.0,0,10992.99,9544.71,10992.52,9544.18,1580
1576,7659,8064,9245,9786,405,541,38521,303,38218,0.9921341605877314,0,7879.24,9547.6,7877.59,9545.61,1581
1577,972,1214,9248,9455,242,207,30337,0,30337,1.0,0,1087.41,9348.14,1087.01,9347.7,1582
1578,9007,9063,9250,9311,56,61,2247,0,2247,1.0,0,9032.77,9280.63,9032.35,9280.11,1583
1579,8590,8720,9253,9379,130,126,9788,0,9788,1.0,0,8650.89,9315.11,8650.43,9314.56,1584
1580,8723,8777,9270,9301,54,31,1265,0,1265,1.0,0,8750.8,9284.32,8750.23,9283.85,1585
1581,8801,8862,9276,9326,61,50,2100,0,2100,1.0,0,8830.86,9300.3,8830.37,9299.79,1586
1582,8680,8801,9279,9397,121,118,6783,0,6783,1.0,0,8730.78,9337.94,8730.63,9337.03,1588
1583,9886,10344,9281,9555,458,274,85064,3857,81207,0.9546576695194207,1,10137.3,9426.1,10136.58,9425.55,1587
1584,9050,9088,9284,9334,38,50,1369,0,1369,1.0,0,9070.78,9306.73,9070.2,9306.39,1589
1585,8844,8937,9288,9374,93,86,4556,0,4556,1.0,0,8894.63,9331.17,8893.98,9330.6,1590
1586,4331,4869,9303,9746,538,443,84079,0,84079,1.0,0,4588.7,9520.43,4587.97,9520.17,1591
1587,8935,9080,9305,9382,145,77,7113,0,7113,1.0,0,9007.52,9340.89,9007.11,9340.61,1592
1588,8756,8815,9310,9378,59,68,2162,0,2162,1.0,0,8785.0,9342.93,8784.44,9342.51,1593
1589,13116,13421,9311,9591,305,280,48464,0,48464,1.0,0,13271.58,9446.95,13271.01,9446.45,1594
1590,6837,7127,9315,9450,290,135,22496,0,22496,1.0,0,6970.89,9364.51,6970.54,9364.09,1595
1591,8811,8890,9319,9400,79,81,3970,0,3970,1.0,0,8847.49,9358.53,8847.09,9358.09,1596
1592,9070,9100,9330,9383,30,53,866,0,866,1.0,0,9083.41,9356.2,9082.92,9355.73,1597
1593,10296,10574,9347,9602,278,255,42338,743,41595,0.9824507534602485,0,10431.22,9464.61,10430.73,9464.23,1598
1594,11584,11931,9350,9608,347,258,44133,0,44133,1.0,0,11765.76,9491.99,11765.18,9491.28,1600
1595,8765,8854,9353,9427,89,74,3711,0,3711,1.0,0,8803.45,9391.49,8803.3,9391.12,1599
1596,8631,8684,9358,9413,53,55,1580,0,1580,1.0,0,8662.19,9380.92,8661.4,9380.67,1601
1597,8835,8989,9358,9479,154,121,12098,1590,10508,0.8685733179037858,1,8916.33,9421.0,8915.88,9420.44,1602
1598,8971,9080,9368,9430,109,62,4865,0,4865,1.0,0,9020.06,9395.92,9019.71,9395.45,1603
1599,8710,8777,9372,9430,67,58,2424,0,2424,1.0,0,8741.2,9398.99,8740.86,9398.69,1604
1600,1117,1523,9380,9633,406,253,65721,0,65721,1.0,0,1306.56,9510.74,1306.15,9510.24,1605
1601,8658,8726,9395,9445,68,50,2490,0,2490,1.0,0,8689.53,9418.83,8689.16,9418.4,1606
1602,8720,8867,9415,9497,147,82,6549,0,6549,1.0,0,8791.39,9451.01,8790.67,9450.85,1607
1603,3964,4424,9426,9932,460,506,119804,0,119804,1.0,0,4232.19,9683.33,4231.24,9682.53,1610
1604,8674,8743,9426,9492,69,66,2591,0,2591,1.0,0,8711.28,9456.18,8710.6,9455.7,1608
1605,2283,2752,9427,9847,469,420,117084,0,117084,1.0,0,2508.47,9655.57,2508.03,9655.0,1609
1606,8593,8680,9429,9514,87,85,3606,0,3606,1.0,0,8638.37,9472.85,8637.82,9472.35,1611
1607,11013,11702,9429,10093,689,664,289877,0,289877,1.0,0,11378.41,9785.99,11377.78,9785.43,1613
1608,11808,12294,9430,9955,486,525,172126,0,172126,1.0,0,12049.92,9663.61,12049.47,9663.2,1612
1609,13383,13572,9436,9637,189,201,29859,0,29859,1.0,0,13476.13,9536.57,13475.65,9536.12,1614
1610,10379,10780,9450,9926,401,476,119161,0,119161,1.0,0,10573.84,9669.23,10573.39,9668.88,1615
1611,8630,8730,9469,9593,100,124,6901,0,6901,1.0,0,8671.19,9527.29,8670.96,9526.67,1617
1612,8675,8811,9469,9624,136,155,10237,2163,8074,0.7887076291882388,1,8740.61,9547.09,8740.19,9546.57,1616
1613,8786,8873,9470,9525,87,55,2635,0,2635,1.0,0,8820.63,9491.94,8820.62,9491.48,1618
1614,12808,13126,9481,9859,318,378,79926,0,79926,1.0,0,12994.91,9646.77,12994.31,9646.42,1619
1615,11571,11707,9485,9668,136,183,12069,0,12069,1.0,0,11629.11,9573.51,11628.8,9573.15,1620
1616,3538,4094,9486,9948,556,462,155027,0,155027,1.0,0,3844.18,9709.29,3843.46,9708.86,1621
1617,13120,13425,9491,9826,305,335,57448,0,57448,1.0,0,13286.35,9659.67,13285.83,9659.14,1622
1618,8268,8636,9492,9636,368,144,19612,0,19612,1.0,0,8496.81,9564.42,8494.33,9564.38,1623
1619,9810,10338,9506,9858,528,352,114330,0,114330,1.0,0,10038.25,9653.18,10038.06,9652.81,1624
1620,10265,10442,9550,9759,177,209,19653,1942,17711,0.9011855696331349,0,10358.45,9671.93,10358.09,9671.02,1625
1621,13509,13665,9553,9738,156,185,19682,0,19682,1.0,0,13593.19,9642.52,13592.52,9642.09,1626
1622,4221,5104,9562,10403,883,841,452737,1218,451519,0.9973096963579297,1,4664.74,9962.83,4664.2,9962.41,1627
1623,13099,13216,9566,9705,117,139,10845,0,10845,1.0,0,13151.29,9630.58,13150.78,9630.16,1628
1624,12509,12925,9581,9952,416,371,117822,0,117822,1.0,0,12713.24,9772.13,12712.76,9771.58,1629
1625,8617,8714,9585,9657,97,72,4425,0,4425,1.0,0,8659.12,9625.45,8658.86,9624.88,1630
1626,11669,11829,9586,9791,160,205,21995,0,21995,1.0,0,11748.64,9688.31,11748.18,9687.75,1631
1627,9575,9833,9620,9872,258,252,46132,0,46132,1.0,0,9703.03,9742.12,9702.6,9741.64,1632
1628,12017,12606,9636,10143,589,507,188796,0,188796,1.0,0,12347.87,9925.16,12347.09,9924.66,1633
1629,1961,2368,9648,10027,407,379,101873,0,101873,1.0,0,2135.36,9806.81,2134.99,9806.49,1634
1630,2329,3103,9684,10305,774,621,272002,0,272002,1.0,0,2780.59,9956.93,2779.56,9956.49,1635
1631,3062,3262,9694,10057,200,363,35910,0,35910,1.0,0,3133.08,9849.87,3132.81,9849.73,1636
1632,1579,1972,9696,9979,393,283,73473,2416,71057,0.9671171722945844,1,1758.77,9832.69,1758.47,9832.08,1637
1633,10006,10267,9707,10008,261,301,41193,0,41193,1.0,0,10131.25,9836.6,10130.53,9836.43,1638
1634,10180,10435,9739,10283,255,544,93373,0,93373,1.0,0,10306.97,10007.37,10306.34,10006.93,1640
1635,3808,4273,9740,10224,465,484,149534,0,149534,1.0,0,4055.49,10005.81,4054.95,10005.17,1639
1636,13049,13253,9752,10007,204,255,31051,0,31051,1.0,0,13158.01,9876.28,13157.43,9875.8,1642
1637,5102,5536,9754,10019,434,265,66335,0,66335,1.0,0,5291.57,9894.75,5291.44,9894.43,1641
1638,11429,12067,9756,10302,638,546,182783,0,182783,1.0,0,11800.87,10041.44,11800.08,10040.99,1643
1639,3093,3870,9768,10487,777,719,361593,0,361593,1.0,0,3497.84,10098.66,3497.31,10098.26,1644
1640,9653,10022,9775,10237,369,462,115094,0,115094,1.0,0,9835.59,9990.42,9835.12,9990.02,1645
1641,10389,11646,9775,10480,1257,705,534979,0,534979,1.0,0,10921.45,10149.27,10921.51,10148.9,1646
1642,9464,9690,9805,10090,226,285,47831,0,47831,1.0,0,9572.75,9951.24,9572.3,9950.63,1648
1643,12823,13136,9807,10114,313,307,58334,0,58334,1.0,0,12991.35,9966.76,12990.73,9966.21,1649
1644,1610,2632,9817,10524,1022,707,418079,0,418079,1.0,0,2142.55,10169.36,2141.77,10168.79,1650
1645,4947,5269,9817,10410,322,593,103568,0,103568,1.0,0,5096.13,10137.39,5095.69,10136.59,1651
1646,11976,12124,9908,10006,148,98,9467,0,9467,1.0,0,12050.62,9953.71,12050.07,9953.21,1652
1647,9222,9494,9929,10267,272,338,60273,0,60273,1.0,0,9355.75,10101.76,9355.32,10101.2,1653
1648,9784,10228,9931,10494,444,563,146085,0,146085,1.0,0,10021.95,10227.48,10021.39,10226.93,1654
1649,12567,12958,9942,10299,391,357,96133,0,96133,1.0,0,12764.69,10107.68,12764.17,10107.26,1655
1650,5191,5862,9993,10597,671,604,287337,0,287337,1.0,0,5519.47,10288.04,5519.19,10287.47,1656
1651,13076,13202,10025,10218,126,193,15335,0,15335,1.0,0,13141.55,10144.01,13140.99,10143.01,1657
1652,8995,9239,10046,10336,244,290,41644,0,41644,1.0,0,9128.68,10171.93,9128.11,10171.7,1658
1653,2504,3332,10059,10672,828,613,309820,0,309820,1.0,0,2958.42,10399.86,2957.76,10399.36,1659
1654,9416,9650,10077,10252,234,175,23904,0,23904,1.0,0,9521.5,10157.77,9521.08,10157.3,1660
1655,12050,12349,10088,10391,299,303,62494,0,62494,1.0,0,12189.99,10226.93,12189.44,10226.61,1661
1656,9428,9841,10089,10516,413,427,108005,0,108005,1.0,0,9637.65,10326.72,9636.99,10326.04,1662
1657,12885,13147,10093,10354,262,261,45571,0,45571,1.0,0,13015.86,10235.78,13015.35,10235.28,1663
1658,1621,1749,10114,10315,128,201,16698,4082,12616,0.7555395855791113,1,1679.64,10206.34,1679.14,10206.05,1664
1659,12300,12729,10126,10418,429,292,87175,0,87175,1.0,0,12519.14,10262.9,12518.56,10262.5,1665
1660,3631,4513,10152,10846,882,694,438545,0,438545,1.0,0,4060.37,10500.79,4059.92,10500.27,1666
1661,8724,9083,10165,10384,359,219,54951,0,54951,1.0,0,8906.41,10272.04,8905.86,10271.56,1667
1662,4513,5003,10181,10653,490,472,134358,0,134358,1.0,0,4799.11,10420.9,4798.4,10420.45,1668
1663,8609,8730,10191,10282,121,91,8547,0,8547,1.0,0,8669.56,10241.66,8669.03,10241.07,1669
1664,10032,10534,10199,10630,502,431,92309,0,92309,1.0,0,10274.02,10386.75,10273.5,10386.19,1670
1665,11402,12089,10210,10760,687,550,230689,0,230689,1.0,0,11718.19,10472.78,11717.91,10472.27,1671
1666,9108,9473,10217,10568,365,351,88294,0,88294,1.0,0,9281.72,10388.79,9281.3,10388.14,1672
1667,6256,6665,10222,10647,409,425,122703,0,122703,1.0,0,6465.26,10437.77,6464.72,10437.33,1673
1668,11918,12102,10225,10398,184,173,18802,0,18802,1.0,0,12024.1,10309.69,12023.43,10309.2,1674
1669,1659,1969,10227,10559,310,332,47851,0,47851,1.0,0,1788.1,10420.78,1787.8,10420.04,1675
1670,6757,7274,10244,10570,517,326,111735,2296,109439,0.9794513804985009,0,6997.89,10398.14,6997.52,10397.69,1676
1671,8512,8870,10270,10523,358,253,57789,0,57789,1.0,0,8674.48,10391.07,8674.12,10390.59,1677
1672,12712,13041,10272,10528,329,256,53685,0,53685,1.0,0,12882.85,10394.4,12882.16,10393.85,1678
1673,12097,12568,10326,10732,471,406,131279,0,131279,1.0,0,12351.76,10518.86,12351.11,10518.34,1679
1674,8785,9128,10329,10572,343,243,47730,0,47730,1.0,0,8985.99,10444.51,8985.17,10444.08,1680
1675,10214,10956,10331,11022,742,691,331436,0,331436,1.0,0,10566.25,10680.09,10565.79,10679.58,1681
1676,11341,11454,10335,10493,113,158,14346,0,14346,1.0,0,11397.6,10411.74,11397.11,10411.26,1682
1677,2290,2587,10343,10754,297,411,64678,0,64678,1.0,0,2425.86,10550.37,2425.66,10549.74,1683
1678,7518,7979,10345,10804,461,459,119585,1915,117670,0.9839862859054229,1,7785.58,10545.32,7784.82,10544.92,1684
1679,4970,5612,10350,10970,642,620,253668,0,253668,1.0,0,5291.3,10663.03,5290.77,10662.51,1685
1680,10835,11358,10372,10740,523,368,110699,0,110699,1.0,0,11117.7,10548.95,11117.06,10548.41,1686
1681,12006,12127,10382,10530,121,148,11133,0,11133,1.0,0,12075.69,10472.68,12075.06,10471.99,1688
1682,1817,2385,10384,10918,568,534,192111,1271,190840,0.9933840331891458,0,2104.9,10655.24,2104.37,10654.78,1687
1683,12525,12925,10386,10701,400,315,84760,0,84760,1.0,0,12720.33,10541.34,12719.92,10540.85,1689
1684,9635,10012,10399,10854,377,455,90284,0,90284,1.0,0,9823.05,10616.95,9822.51,10616.38,1690
1685,4419,4703,10403,10775,284,372,58243,0,58243,1.0,0,4551.58,10630.31,4551.15,10629.4,1691
1686,7032,7515,10406,10994,483,588,149286,0,149286,1.0,0,7271.66,10703.23,7271.27,10702.67,1692
1687,8297,8956,10406,10790,659,384,137198,0,137198,1.0,0,8649.54,10592.54,8648.76,10591.94,1693
1688,5554,6085,10421,11004,531,583,202912,0,202912,1.0,0,5831.1,10743.03,5830.54,10742.31,1695
1689,3206,3709,10426,10993,503,567,189692,0,189692,1.0,0,3465.44,10690.08,3464.96,10689.68,1694
1690,9320,9573,10436,10577,253,141,17543,0,17543,1.0,0,9437.2,10511.97,9436.99,10511.52,1696
1691,9982,10163,10453,10592,181,139,18913,0,18913,1.0,0,10079.09,10525.68,10078.4,10525.15,1697
1692,6835,7212,10483,10904,377,421,100868,0,100868,1.0,0,7012.22,10669.22,7011.77,10668.91,1698
1693,7360,7727,10490,10961,367,471,113075,0,113075,1.0,0,7547.3,10753.7,7546.77,10752.96,1699
1694,11200,11747,10492,11077,547,585,170223,0,170223,1.0,0,11488.31,10806.55,11487.64,10805.83,1700
1695,8842,9236,10495,10934,394,439,87963,0,87963,1.0,0,9033.82,10692.83,9033.19,10692.59,1701
1696,6389,6879,10496,10900,490,404,132021,0,132021,1.0,0,6655.68,10701.18,6655.07,10700.66,1702
1697,9438,9844,10503,10879,406,376,74457,0,74457,1.0,0,9598.84,10693.83,9598.85,10693.69,1703
1698,11704,12277,10526,11010,573,484,187542,0,187542,1.0,0,12012.11,10776.32,12011.39,10775.93,1704
1699,8958,9663,10540,11300,705,760,333686,0,333686,1.0,0,9304.56,10947.66,9304.07,10947.06,1705
1700,6042,6407,10557,10897,365,340,82873,0,82873,1.0,0,6220.87,10720.77,6220.25,10720.28,1706
1701,2463,3346,10560,11249,883,689,371672,0,371672,1.0,0,2860.02,10862.04,2859.45,10861.77,1707
1702,7903,8602,10575,11105,699,530,252995,0,252995,1.0,0,8288.58,10825.2,8287.96,10824.65,1708
1703,4649,5272,10579,11158,623,579,188607,0,188607,1.0,0,4935.37,10832.08,4935.02,10831.91,1709
1704,9852,10306,10583,10988,454,405,104560,0,104560,1.0,0,10057.09,10816.39,10056.67,10815.77,1710
1705,10007,10234,10584,10714,227,130,17160,0,17160,1.0,0,10136.21,10639.45,10135.34,10638.88,1711
1706,12498,12814,10603,10888,316,285,53952,0,53952,1.0,0,12667.78,10751.63,12667.02,10751.01,1712
1707,10912,11158,10679,10849,246,170,23689,0,23689,1.0,0,11030.16,10750.73,11029.77,10750.34,1713
1708,12218,12575,10707,11120,357,413,87475,0,87475,1.0,0,12388.03,10869.87,12387.49,10869.67,1714
1709,4123,4708,10714,11186,585,472,162440,0,162440,1.0,0,4387.58,10911.63,4387.16,10911.25,1715
1710,7678,8099,10717,11150,421,433,118469,19,118450,0.9998396204914366,0,7887.87,10925.24,7887.55,10924.89,1716
1711,10952,11353,10733,11277,401,544,127870,0,127870,1.0,0,11155.21,10982.51,11154.65,10982.19,1717
1712,10752,11047,10745,11028,295,283,47074,0,47074,1.0,0,10902.1,10887.78,10901.65,10887.29,1718
1713,2374,2546,10747,10949,172,202,20744,0,20744,1.0,0,2465.37,10825.46,2465.01,10825.37,1719
1714,8504,8978,10760,11249,474,489,161019,0,161019,1.0,0,8734.49,10997.86,8734.0,10997.42,1720
1715,2220,2536,10766,11110,316,344,57195,578,56617,0.9898942215228604,0,2384.0,10960.49,2383.57,10959.84,1721
1716,3562,4261,10792,11410,699,618,233855,0,233855,1.0,0,3980.43,11061.19,3979.61,11060.76,1722
1717,6190,6912,10797,11389,722,592,296800,0,296800,1.0,0,6548.94,11084.69,6548.44,11084.13,1723
1718,9630,9932,10839,11192,302,353,80245,0,80245,1.0,0,9789.83,11013.47,9789.29,11012.94,1724
1719,5915,6390,10842,11373,475,531,125336,0,125336,1.0,0,6132.63,11107.58,6132.34,11107.33,1725
1720,12384,12756,10847,11378,372,531,114809,2013,112796,0.9824665313694919,1,12578.83,11094.25,12578.5,11094.06,1727
1721,6826,7240,10854,11191,414,337,67055,0,67055,1.0,0,7039.97,11010.76,7039.53,11010.32,1728
1722,10174,10463,10883,11172,289,289,54767,0,54767,1.0,0,10309.81,11036.74,10309.39,11036.09,1729
1723,1996,2218,10897,11166,222,269,34968,1874,33094,0.9464081445893389,1,2091.7,11029.89,2091.57,11029.22,1730
1724,3107,3623,10899,11417,516,518,182094,0,182094,1.0,0,3365.48,11157.43,3364.94,11156.98,1731
1725,11961,12315,10900,11240,354,340,75134,0,75134,1.0,0,12150.7,11079.04,12150.16,11078.47,1732
1726,7187,7777,10902,11490,590,588,182063,0,182063,1.0,0,7468.64,11140.15,7468.25,11139.88,1733
1727,2149,2305,10918,11135,156,217,23091,0,23091,1.0,0,2224.45,11021.61,2224.0,11021.22,1735
1728,5265,5947,10918,11283,682,365,155436,0,155436,1.0,0,5602.25,11085.93,5601.85,11085.38,1734
1729,4379,4913,10920,11439,534,519,209897,0,209897,1.0,0,4655.65,11191.66,4655.1,11191.15,1736
1730,9916,10298,10944,11453,382,509,118772,0,118772,1.0,0,10118.15,11177.26,10117.66,11176.94,1737
1731,11651,12010,10949,11357,359,408,110319,0,110319,1.0,0,11823.73,11153.51,11823.32,11152.98,1738
1732,10403,11029,10956,11413,626,457,190896,0,190896,1.0,0,10745.66,11167.88,10745.07,11167.43,1739
1733,11112,11669,10974,11463,557,489,169281,0,169281,1.0,0,11387.24,11223.75,11386.7,11223.23,1740
1734,4844,5398,11008,11621,554,613,240258,0,240258,1.0,0,5103.22,11300.37,5102.77,11299.91,1741
1735,3483,4044,11020,11867,561,847,267567,0,267567,1.0,0,3768.52,11449.8,3767.85,11449.22,1742
1736,8076,8600,11042,11399,524,357,132466,0,132466,1.0,0,8319.06,11228.72,8318.58,11228.14,1743
1737,6769,7238,11057,11573,469,516,155239,0,155239,1.0,0,6998.52,11302.84,6997.93,11302.45,1745
1738,2665,3170,11059,11441,505,382,131978,0,131978,1.0,0,2902.87,11247.48,2902.56,11246.88,1744
1739,2246,2539,11073,11315,293,242,35294,0,35294,1.0,0,2353.54,11183.03,2353.62,11182.28,1746
1740,7565,8148,11077,11664,583,587,247095,0,247095,1.0,0,7861.0,11352.69,7860.52,11352.27,1747
1741,12125,12454,11092,11386,329,294,52457,0,52457,1.0,0,12321.66,11239.54,12320.83,11239.06,1748
1742,8582,9122,11104,11557,540,453,147001,351,146650,0.9976122611410807,0,8857.59,11320.38,8857.13,11320.06,1749
1743,9069,10168,11109,11686,1099,577,392635,0,392635,1.0,0,9579.93,11402.16,9579.76,11401.71,1750
1744,2293,2699,11112,11516,406,404,92684,0,92684,1.0,0,2495.17,11322.13,2494.63,11321.62,1751
1745,5669,6247,11112,11696,578,584,192260,0,192260,1.0,0,5949.19,11393.15,5948.84,11392.72,1752
1746,4212,4435,11149,11538,223,389,53687,0,53687,1.0,0,4330.99,11330.77,4330.33,11330.31,1753
1747,10286,10617,11151,11387,331,236,52886,0,52886,1.0,0,10421.2,11281.57,10420.98,11281.04,1754
1748,11976,12100,11178,11276,124,98,7113,0,7113,1.0,0,12026.64,11226.22,12026.41,11225.7,1755
1749,7220,7589,11190,11643,369,453,72781,0,72781,1.0,0,7362.69,11424.66,7362.52,11424.37,1756
1750,10980,11157,11194,11474,177,280,30141,0,30141,1.0,0,11056.74,11339.21,11056.28,11338.68,1757
1751,5209,6092,11220,11866,883,646,302324,0,302324,1.0,0,5596.33,11570.5,5596.12,11570.04,1758
1752,11990,12291,11226,11674,301,448,83751,0,83751,1.0,0,12139.4,11444.76,12138.87,11444.18,1759
1753,11317,11849,11253,11621,532,368,113914,0,113914,1.0,0,11599.23,11451.02,11598.55,11450.48,1760
1754,8467,8718,11258,11599,251,341,37540,0,37540,1.0,0,8594.98,11448.74,8594.35,11447.78,1762
1755,3236,3720,11259,11726,484,467,93809,0,93809,1.0,0,3487.26,11492.81,3486.75,11492.31,1761
1756,11751,12040,11279,11653,289,374,64707,0,64707,1.0,0,11922.23,11483.44,11921.57,11482.94,1763
1757,12266,12638,11280,11599,372,319,77266,287,76979,0.9962855589780757,0,12462.68,11433.59,12462.07,11433.15,1764
1758,10496,10840,11301,11564,344,263,53788,0,53788,1.0,0,10671.35,11439.18,10670.75,11438.55,1765
1759,2860,3207,11341,11597,347,256,55950,0,55950,1.0,0,3037.04,11452.83,3036.52,11452.44,1766
1760,6101,6391,11343,11671,290,328,42494,0,42494,1.0,0,6254.28,11506.78,6253.58,11506.27,1767
1761,3183,3402,11360,11567,219,207,28231,0,28231,1.0,0,3284.82,11454.11,3284.38,11453.59,1768
1762,6332,6878,11361,11818,546,457,162554,0,162554,1.0,0,6609.72,11546.98,6609.38,11546.68,1769
1763,3865,4372,11374,11991,507,617,220528,0,220528,1.0,0,4126.22,11710.1,4125.75,11709.44,1770
1764,10063,10634,11377,11923,571,546,196797,0,196797,1.0,0,10320.72,11628.08,10320.29,11627.71,1771
1765,10790,11046,11383,11617,256,234,32554,0,32554,1.0,0,10904.89,11494.19,10904.56,11493.72,1772
1766,7944,8646,11390,12082,702,692,354438,5173,349265,0.9854050637911285,1,8288.38,11726.12,8287.99,11725.74,1773
1767,10858,11426,11399,11780,568,381,134375,0,134375,1.0,0,11168.32,11608.39,11167.66,11607.92,1774
1768,2470,2704,11404,11521,234,117,18760,0,18760,1.0,0,2600.92,11462.98,2600.13,11462.49,1775
1769,8863,9183,11407,11820,320,413,73793,1584,72209,0.9785345493474991,1,9019.91,11600.3,9019.41,11599.95,1776
1770,4319,4925,11420,11967,606,547,259703,0,259703,1.0,0,4623.35,11672.45,4622.86,11672.03,1777
1771,6807,7514,11446,12101,707,655,326397,0,326397,1.0,0,7136.73,11767.72,7136.33,11767.24,1778
1772,9463,10166,11474,12091,703,617,310965,0,310965,1.0,0,9829.06,11806.61,9828.48,11806.11,1779
1773,2928,3285,11482,12047,357,565,121592,1320,120272,0.989144022633068,0,3124.19,11777.53,3123.59,11776.95,1780
1774,7492,7957,11492,12015,465,523,151823,0,151823,1.0,0,7722.4,11751.91,7721.85,11751.41,1781
1775,2869,3011,11509,11685,142,176,17604,0,17604,1.0,0,2936.05,11597.96,2935.56,11597.44,1782
1776,8586,8895,11518,11829,309,311,55714,0,55714,1.0,0,8732.06,11650.81,8731.39,11650.56,1783
1777,12135,12483,11518,12042,348,524,122512,0,122512,1.0,0,12330.58,11780.42,12329.75,11779.97,1784
1778,10348,10977,11522,12015,629,493,172744,0,172744,1.0,0,10665.75,11782.49,10665.22,11782.0,1785
1779,11408,12271,11548,12237,863,689,325085,0,325085,1.0,0,11836.92,11835.26,11836.41,11834.79,1786
1780,4838,5424,11575,12188,586,613,233005,0,233005,1.0,0,5130.69,11860.66,5130.19,11860.24,1787
1781,6086,6870,11589,12585,784,996,484579,0,484579,1.0,0,6488.17,12036.38,6487.59,12035.99,1788
1782,12439,12627,11591,11980,188,389,50323,0,50323,1.0,0,12538.88,11806.34,12538.31,11805.73,1789
1783,3229,3575,11608,11986,346,378,78723,0,78723,1.0,0,3389.18,11811.39,3388.66,11810.75,1791
1784,9061,9502,11645,12004,441,359,102756,0,102756,1.0,0,9283.39,11815.18,9282.68,11814.78,1792
1785,8635,9077,11683,12255,442,572,198648,0,198648,1.0,0,8857.27,11958.41,8856.8,11957.96,1793
1786,10901,11380,11710,12163,479,453,141570,0,141570,1.0,0,11140.68,11920.48,11140.24,11919.97,1794
1787,5778,6163,11725,12381,385,656,157406,0,157406,1.0,0,5964.31,12042.32,5963.93,12041.88,1795
1788,3534,4193,11750,12321,659,571,199588,0,199588,1.0,0,3894.25,12062.58,3893.28,12061.48,1796
1789,11260,11695,11772,12257,435,485,142701,0,142701,1.0,0,11485.21,12034.77,11484.69,12034.27,1797
1790,5270,5844,11787,12325,574,538,205629,0,205629,1.0,0,5565.82,12026.95,5565.31,12026.56,1798
1791,7285,7797,11831,12463,512,632,213091,0,213091,1.0,0,7559.25,12135.86,7558.72,12135.41,1799
1792,7738,8193,11834,12411,455,577,159509,0,159509,1.0,0,7950.62,12167.62,7950.2,12166.92,1800
1793,4179,4593,11846,12339,414,493,142610,0,142610,1.0,0,4368.15,12101.93,4367.72,12101.31,1801
1794,2886,3110,11847,12147,224,300,36743,0,36743,1.0,0,2988.04,12036.87,2987.42,12035.77,1802
1795,10702,11074,11871,12185,372,314,60245,0,60245,1.0,0,10886.63,12023.01,10886.22,12022.65,1803
1796,3469,3721,11900,12153,252,253,31223,0,31223,1.0,0,3585.29,12023.46,3585.03,12023.26,1804
1797,9913,10500,11900,12380,587,480,189107,0,189107,1.0,0,10233.38,12156.27,10232.73,12155.69,1805
1798,9051,9613,11906,12442,562,536,211224,0,211224,1.0,0,9333.59,12154.54,9333.03,12154.12,1806
1799,4494,5080,11915,12503,586,588,229392,0,229392,1.0,0,4780.5,12199.27,4780.03,12198.81,1807
1800,8117,8764,11923,12490,647,567,240320,0,240320,1.0,0,8454.45,12221.95,8453.88,12221.39,1808
1801,3104,3593,11931,12154,489,223,54862,200,54662,0.9963544894462469,0,3324.43,12046.42,3324.26,12046.2,1809
1802,10457,10953,11989,12418,496,429,143525,0,143525,1.0,0,10676.35,12193.48,10675.96,12193.08,1810
1803,9531,9983,12007,12497,452,490,130823,0,130823,1.0,0,9745.17,12231.82,9744.66,12231.44,1811
1804,6819,7364,12026,12399,545,373,145173,0,145173,1.0,0,7089.11,12214.48,7088.59,12213.97,1812
1805,3243,3666,12065,12257,423,192,42876,1601,41275,0.9626597630375968,1,3443.37,12162.86,3443.01,12162.32,1813
1806,3637,3898,12132,12399,261,267,43278,0,43278,1.0,0,3742.02,12277.69,3741.71,12277.11,1814
1807,10943,11268,12143,12449,325,306,67523,0,67523,1.0,0,11113.35,12276.38,11113.01,12276.03,1815
1808,5928,6434,12147,12577,506,430,141435,0,141435,1.0,0,6180.73,12381.45,6180.12,12380.97,1816
1809,4884,5596,12155,12763,712,608,284194,0,284194,1.0,0,5228.43,12446.61,5228.01,12446.15,1817
1810,8736,9237,12157,12534,501,377,92755,0,92755,1.0,0,9018.59,12345.28,9017.76,12344.68,1818
1811,11215,11484,12169,12452,269,283,50604,2775,47829,0.9451624377519564,1,11337.62,12300.83,11337.18,12300.37,1819
1812,5491,5979,12177,12773,488,596,185066,0,185066,1.0,0,5735.81,12505.81,5735.35,12505.12,1820
1813,7275,7678,12204,12544,403,340,59530,0,59530,1.0,0,7459.42,12419.46,7458.96,12418.58,1821
1814,6650,7292,12213,12865,642,652,246035,0,246035,1.0,0,6941.03,12567.02,6940.53,12566.32,1822
1815,3412,3670,12224,12452,258,228,43807,1804,42003,0.9588193667678682,0,3539.11,12331.94,3538.69,12331.62,1823
1816,11625,11800,12227,12354,175,127,17323,0,17323,1.0,0,11711.97,12291.46,11711.5,12290.94,1824
1817,10749,11066,12276,12556,317,280,54640,0,54640,1.0,0,10900.18,12420.75,10899.87,12420.17,1825
1818,4207,4721,12285,12664,514,379,141594,0,141594,1.0,0,4463.79,12481.47,4463.31,12480.99,1826
1819,3947,4243,12287,12504,296,217,32774,0,32774,1.0,0,4117.57,12369.27,4117.05,12369.05,1827
1820,10193,10625,12291,12562,432,271,55214,0,55214,1.0,0,10392.72,12414.08,10392.26,12413.72,1828
1821,8633,9146,12299,12703,513,404,113678,0,113678,1.0,0,8868.3,12526.79,8867.91,12526.18,1829
1822,3651,3956,12301,12496,305,195,32270,0,32270,1.0,0,3822.19,12414.22,3821.57,12413.61,1830
1823,9639,10251,12304,12769,612,465,195534,0,195534,1.0,0,9961.51,12544.42,9960.92,12543.87,1831
1824,9150,9753,12332,12963,603,631,185759,0,185759,1.0,0,9485.42,12616.98,9484.85,12616.59,1832
1825,7663,8351,12336,12787,688,451,224842,0,224842,1.0,0,8007.76,12573.54,8007.27,12572.96,1833
1826,10406,10839,12352,12677,433,325,81826,1656,80170,0.9797619338596534,1,10639.56,12532.85,10639.06,12532.28,1834
1827,10986,11256,12393,12518,270,125,21255,0,21255,1.0,0,11104.9,12462.82,11104.67,12462.28,1835
1828,3900,4122,12399,12649,222,250,35240,0,35240,1.0,0,4026.48,12507.57,4025.79,12507.12,1836
1829,3548,3711,12411,12608,163,197,19075,778,18297,0.9592136304062909,0,3636.84,12505.82,3636.18,12505.24,1837
1830,8271,8817,12413,12827,546,414,129204,0,129204,1.0,0,8541.08,12635.02,8540.47,12634.36,1838
1831,4016,4421,12421,12874,405,453,87530,0,87530,1.0,0,4229.81,12686.71,4228.99,12685.75,1839
1832,7104,7750,12449,13051,646,602,260502,0,260502,1.0,0,7420.12,12756.72,7419.62,12756.24,1840
1833,6389,6732,12463,13115,343,652,147018,0,147018,1.0,0,6568.31,12800.02,6567.57,12799.39,1841
1834,3834,3980,12468,12638,146,170,17924,0,17924,1.0,0,3910.21,12553.28,3909.73,12552.8,1842
1835,3711,4146,12482,12828,435,346,67916,0,67916,1.0,0,3908.59,12685.42,3907.88,12684.54,1843
1836,9992,10569,12490,13044,577,554,178707,0,178707,1.0,0,10276.07,12792.76,10275.69,12792.1,1844
1837,4701,5047,12497,12831,346,334,77743,0,77743,1.0,0,4845.02,12678.01,4844.7,12677.45,1845
1838,8732,9309,12507,13176,577,669,231590,0,231590,1.0,0,9015.81,12860.36,9015.41,12859.72,1846
1839,5857,6464,12539,12979,607,440,188000,0,188000,1.0,0,6166.82,12728.33,6166.26,12727.97,1847
1840,5290,6105,12580,13270,815,690,357833,0,357833,1.0,0,5685.14,12975.42,5684.5,12974.71,1848
1841,4388,4756,12621,12964,368,343,83223,0,83223,1.0,0,4567.4,12770.98,4567.03,12770.61,1849
1842,7896,8395,12671,13242,499,571,147002,2925,144077,0.9801023115331764,1,8200.97,12945.8,8200.16,12945.06,1850
1843,9616,10019,12703,13022,403,319,59275,0,59275,1.0,0,9797.96,12838.01,9797.29,12837.77,1851
1844,4988,5332,12720,13163,344,443,98086,0,98086,1.0,0,5171.33,12910.04,5170.66,12909.91,1852
1845,7563,8078,12731,13410,515,679,221038,0,221038,1.0,0,7839.69,13061.35,7839.1,13060.9,1854
1846,8286,8769,12733,13323,483,590,200683,0,200683,1.0,0,8532.05,13053.41,8531.58,13052.69,1855
1847,9218,9647,12733,13162,429,429,113978,0,113978,1.0,0,9428.24,12976.02,9427.7,12975.38,1853
1848,6702,7208,12776,13270,506,494,178793,0,178793,1.0,0,6946.05,13041.03,6945.68,13040.41,1856
1849,4595,5097,12796,13227,502,431,159693,3670,156023,0.9770184040627955,2,4857.28,13015.82,4856.74,13015.38,1857
1850,4202,4607,12831,13109,405,278,66831,0,66831,1.0,0,4374.5,12968.47,4374.3,12967.95,1858
1851,3831,4666,12851,13631,835,780,316445,0,316445,1.0,0,4241.27,13289.38,4240.67,13288.42,1859
1852,9647,10098,12879,13096,451,217,67559,0,67559,1.0,0,9886.89,12991.06,9886.21,12990.61,1860
1853,6056,6564,12892,13717,508,825,253654,1272,252382,0.9949852949293132,1,6339.19,13240.17,6338.69,13240.26,1861
1854,8967,9389,12990,13403,422,413,119920,0,119920,1.0,0,9190.66,13208.15,9190.12,13207.66,1862
1855,7064,7660,13002,13409,596,407,178493,2239,176254,0.987456090715042,1,7365.24,13207.09,7364.73,13206.66,1863
1856,5188,5472,13007,13413,284,406,86597,0,86597,1.0,0,5330.76,13213.03,5330.3,13212.58,1864
1857,9629,9808,13042,13170,179,128,14765,0,14765,1.0,0,9705.95,13099.16,9705.65,13098.77,1865
1858,6476,6770,13045,13624,294,579,94399,0,94399,1.0,0,6622.38,13344.59,6621.89,13344.17,1866
1859,8695,9015,13088,13388,320,300,47997,0,47997,1.0,0,8828.94,13237.47,8828.78,13236.69,1867
1860,9378,9677,13126,13340,299,214,44849,0,44849,1.0,0,9515.45,13233.84,9515.13,13233.26,1868
1861,4967,5227,13150,13356,260,206,33641,393,33248,0.9883178264617579,0,5116.2,13253.53,5115.52,13252.99,1869
1862,7875,8404,13181,13641,529,460,175032,2972,172060,0.9830202477261301,1,8151.56,13427.23,8150.99,13426.63,1870
1863,4762,5046,13190,13425,284,235,41270,0,41270,1.0,0,4914.37,13299.11,4913.78,13298.67,1871
1864,5878,6316,13226,13593,438,367,105578,0,105578,1.0,0,6082.6,13415.47,6082.17,13414.98,1872
1865,5445,5905,13240,13497,460,257,83042,0,83042,1.0,0,5695.53,13352.69,5694.78,13352.17,1873
1866,6665,7142,13243,13711,477,468,151992,0,151992,1.0,0,6893.78,13457.28,6893.23,13456.95,1874
1867,7447,7897,13256,13655,450,399,119445,0,119445,1.0,0,7669.24,13464.88,7668.73,13464.42,1875
1868,8352,8743,13275,13639,391,364,102546,0,102546,1.0,0,8564.5,13459.85,8563.89,13459.34,1876
1869,8733,9023,13282,13618,290,336,65842,0,65842,1.0,0,8888.84,13451.85,8888.36,13451.32,1877
1870,4929,5260,13325,13665,331,340,69494,0,69494,1.0,0,5080.68,13489.6,5080.2,13489.09,1878
1871,8983,9238,13331,13530,255,199,34234,0,34234,1.0,0,9106.99,13416.24,9106.65,13415.99,1879
1872,5300,6092,13376,13766,792,390,157890,0,157890,1.0,0,5718.42,13568.63,5717.64,13568.02,1880
1873,7083,7483,13382,13628,400,246,84319,0,84319,1.0,0,7280.59,13505.12,7280.1,13504.61,1881
1874,5309,5491,13501,13701,182,200,18252,0,18252,1.0,0,5397.2,13619.18,5396.76,13618.37,1882
1875,6038,6366,13557,13864,328,307,62191,0,62191,1.0,0,6197.19,13704.13,6196.68,13703.72,1883
1876,6277,6699,13596,13912,422,316,80648,0,80648,1.0,0,6509.51,13759.43,6508.97,13758.95,1884
1877,5463,5799,13644,13905,336,261,62551,0,62551,1.0,0,5631.06,13772.26,5630.58,13771.76,1885
1878,5781,6115,13722,13918,334,196,46200,696,45504,0.9849350649350649,0,5942.67,13814.44,5942.1,13814.17,1886
